fecitconstantin᷒	fecit constantin᷒
celebrariꝯciliumExpliciunttitulilibripͥmiIncip̃lib̃	celebrari ꝯcilium Expliciunt tituli libri pͥmi Incip̃ lib̃
IOratioallocutoriasozomeniadtheodosiũĩꝑatorAiunt	I Oratio allocutoria sozomeni ad theodosiũ ĩꝑator Aiunt
antiquispͥncipib	antiquis pͥncipib
diligentiestudiumfuisseuteisamatoresqͥdemornam̃toꝝpurpuramatq	diligentie studium fuisse ut eis amatores qͥdem ornam̃toꝝ purpuram atq
coronamethissimiliapararent	coronam et his similia pararent
Libroꝝuͦh̃ntesintentionemcircaquasdãfabulasoccupaticonscͥptionesagerent	Libroꝝ uͦ h̃ntes intentionem circa quasdã fabulas occupati conscͥptiones agerent
queaudientiumcordamulc̃entPorrobellasectantes	que audientium corda mulc̃ent Porro bella sectantes
utsagittamoportunedirigerent	ut sagittam oportune dirigerent
bestiamꝓsternerentlanceãbñ	bestiam ꝓsternerent lanceã bñ
iacularent᷑autequũdecent̃	iacularent᷑ aut equũ decent̃
ascenderentPresentabãt᷑enimsingl̃iregalibeoꝝstudentesrebillis	ascenderent Presentabãt᷑ enim singl̃i regalib eoꝝ studentes reb illis
q̃forentgratissimedñatuiAuusitaq̃lapides	q̃ forent gratissime dñatui Auus itaq̃ lapides
ciososdifficilecomꝑtosofferebatalt̃tincturam	ciosos difficile comꝑtos offerebat alt̃ tincturam
purpuraclariorẽplurimipoemataautdiũsasconscͥptionesinsinuabantalius	purpura clariorẽ plurimi poemata aut diũsas conscͥptiones insinuabant alius
bonacingl̃autoptimũarmoꝝpandebatusum	bona cingl̃ aut optimũ armoꝝ pandebat usum
maximauͦetimꝑialisputabat᷑h᷒popularisAntoninirequire	maxima uͦ et imꝑialis putabat᷑ h᷒ popularis Antonini req uire
agapitiuiragiulphirequiremalcelli	agapiti uir agiulphi req uire malcelli
Uigl̃sc̃iBertiniutinuigl̃sc̃iiacobiIndie	Uigl̃ sc̃i Bertini ut in uigl̃ sc̃i iacobi In die
s̃BertiniOM̃IPS̃sempiternedeusquimirabiliterfulgesin	s̃ Bertini OM̃IPS̃ sempiterne deus qui mirabiliter fulges in
electistuisquostehabitatoreglorificareuoluisticoncedenos	electis tuis quos te habitatore glorificare uoluisti concede nos
qs̃beatipatrisnr̃iBertiniitasollempniauenerari	qs̃ beati patris nr̃i Bertini ita sollempnia uenerari
utei᷒suffragantibmeritistemplũtuummereamurfieriPer	ut ei᷒ suffragantib meritis templũ tuum mereamur fieri Per
SecretaMuneranr̃atibidñe	Secreta Munera nr̃a tibi dñe
d̃sbeatiBertiniAURELIIAUGUSTINIDOCTORISLIBERI᷒HYPPONIENSISEP̃I	d̃s beati Bertini AURELII AUGUSTINI DOCTORIS LIBER I᷒ HYPPONIENSIS EP̃I
DECIUITATED̃IINCIP̃CONTR[A]	DE CIUITATE D̃I INCIP̃ CONTR [ A ]
PAGANOSGL̃IOSISSIMAM	PAGANOS GL̃IOSISSIMAM
CIUITATEMDEISIUEINHOCTẼPORŨCURSUCŨINTERimpios	CIUITATEM DEI SIUE IN HOC TẼPORŨ CURSU CŨ INTER impios
peregrinaturexfideuiuenssiue	peregrinatur exfide uiuens siue
inillastabilitatesedis	in illa stabilitate sedis
ęternęquamnuncexpectat	ęternę quam nunc expectat
ꝑpacientiãquoadusqiustitiac̃uertat᷑in	ꝑ pacientiã quoadusq iustitia c̃uertat᷑ in
iudiciũdeincepsadepturaꝑexcellentiãuictoriaultima&paceꝑfecta	iudiciũ deinceps adeptura ꝑ excellentiã uictoria ultima & pace ꝑfecta
hocoꝑeadteinstituto&meaꝓmissione	hoc oꝑe ad te instituto & mea ꝓmissione
debitodefendere	debito defendere
aduersuseosquic̃ditoriei᷒deossuosferunt	aduersus eos qui c̃ditori ei᷒ deos suos ferunt
filikm̃eMARcelliNEsuscepiMagnũopus	fili km̃e MARcelliNE suscepi Magnũ opus
&arduũsedd̃sadiutornr̃Namscioquib	& arduũ sed d̃s adiutor nr̃ Nam scio quib
EXPLIC̃TERCIAꝓpositio	EXPLIC̃ TERCIA ꝓpositio
INCIPITQUARTAQUARTA	INCIPIT QUARTA QUARTA
PROPOSITIOESTADŨsariiquę&extrema	PROPOSITIO EST ADŨsarii quę & extrema
duoseẽordinesouium&hircoꝝalterũiustoꝝalterum	duos eẽ ordines ouium & hircoꝝ alterũ iustoꝝ alterum
peccatoꝝaliosstareadextrisaliosasinistris	peccatoꝝ alios stare a dextris alios a sinistris
&audireiustosVenitebenedictipatͥsmei	& audire iustos Venite benedicti patͥs mei
possideteparatũuob̃regnũaconstitutionemundiPeccatorib	possidete paratũ uob̃ regnũ a constitutione mundi Peccatorib
uͦdiciDiscediteamemaledicti	uͦ dici Discedite a me maledicti
inignẽęt̃nũqui	in ignẽ ęt̃nũ qui
parat᷒ẽdiabolo&angelisei᷒	parat᷒ ẽ diabolo & angelis ei᷒
Arborẽbonãnonpossefruct᷒malos	Arborẽ bonã non posse fruct᷒ malos
fac͛enecmalãbonosUñ&saluatorloqͥt᷑adiudeos	fac͛e nec malã bonos Uñ & saluator loqͥt᷑ ad iudeos
Uosdepatre	Uos de patre
diaboloestis&concuQVIALARGIENTEDÑOmissarumsollempniater	diabolo estis & concu QVIA LARGIENTE DÑO missarum sollempnia ter
hodiecelebraturisum᷒loquidiude	hodie celebraturi sum᷒ loqui diu de
euangelicalectionenonpossumussed	euangelica lectione non possumus sed
nosaliquiduelbreuiterdicere	nos aliquid uel breuiter dicere
redemptorisnr̃inatiuitasipsacõpellitQuidestqͦdnascituro	redemptoris nr̃i natiuitas ipsa cõpellit Quid est qͦd nascituro
dñomundusdescribiturnisihocquodaꝑtemonstratur	dño mundus describitur nisi hoc quod aꝑte monstratur
quiailleueniebatincarneqͥelectossuosascriber&in	quia ille ueniebat in carne qͥ electos suos ascriber& in
ęternitateCuicontradereꝓbisꝑproph̃amdiciturDeleantur	ęternitate Cui contra de reꝓbis ꝑ proph̃am dicitur Deleantur
delibrouiuentiũ&cumiustisnonscribanturQui	de libro uiuentiũ & cum iustis non scribantur Qui
bene&iaminb&hleemnascitur	bene &iam in b&hleem nascitur
B&hleemquippe	B&hleem quippe
domuspanis	domus panis
interpretat᷑Ipse	interpretat᷑ Ipse
namqestqͥ	namq est qͥ
aitEgosumpanisuiuusqͥdecęlodescendiLocus	ait Ego sum panis uiuus qͥ de cęlo descendi Locus
ergoinqͦdñsnascereturdomuspanisanteuocatusest	ergo in qͦ dñs nasceretur domus panis ante uocatus est
quiafuturũꝓfectoeratutilleibiꝑmateriã	quia futurũ ꝓfecto erat ut ille ibi ꝑ materiã
carnisapparer&quielectoꝝ	carnis apparer& qui electoꝝ
m̃tesinterna	m̃tes interna
satietatereficer&Qui	satietate reficer& Qui
noninparentũmentisiudicans&uulnerabilipaternęconsolationisadhibens	non in parentũ mentis iudicans & uulnerabili paternę consolationis adhibens
medicinamSicillereuersusadse	medicinam Sic ille reuersus ad se
susceptionemquamdilatam	susceptionem quam dilatam
doluitpacient̃expectauitMortemquoqWillelmiiuniorisquimagnoac	doluit pacient̃ expectauit Mortem quoq Willelmi iunioris qui magno ac
triumphatorianglorũWillelmopatrisuosuccesserateuidentiuaticinioindicauit	triumphatori anglorũ Willelmo patri suo successerat euidenti uaticinio indicauit
Eratilled̃iseruusgl̃oseopinionis	Erat ille d̃i seruusgl̃ose opinionis
anselm᷒cantuꝓmisit	anselm᷒ cantu ꝓmisit
fueratPrescriptussiquinationis	fuerat Prescriptus siqui nationis
insistercui᷒dãmilitis	insister cui᷒dã militis
instatimqsubitaexpirauit	in statimq subita expirauit
Siciterminataeta	Sic i terminata et a
claruit&cantquiꝑsequenti	claruit & cant qui ꝑsequenti
sredeundifaculcessitIdemd̃iseruusNonoportet	s redeundi facul cessit Idem d̃i seruus Non oportet
aLXXmausqinoct̃pasche&	a LXXma usq in oct̃ pasche &
abaduentudñiusqp᷒theophaniãnupciascelebrari	ab aduentu dñi usq p᷒ theophaniã nupcias celebrari
Conuenientib᷒eisqͥhocsacram̃tũcelebraredesiderantpͥmocauendũ	Conuenientib᷒ eis qͥ hoc sacram̃tũ celebrare desiderant pͥmo cauendũ
&diligentissimeẽinqͥrend̃ne	& diligentissime ẽ inqͥrend̃ ne
sitint̃eosaliqͥdq̃dtantosacram̃topoᷤsiteẽcontrariũ	sit int̃ eos aliqͥd q̃d tanto sacram̃to poᷤsit eẽ contrariũ
Reqͥenduᷤẽętiãdiligent̃	Reqͥenduᷤ ẽ ętiã diligent̃
asac̃doteamboꝝid÷	a sac̃dote amboꝝ id÷
uirietmulierisassensusQ̃dsiuota	uiri et mulieris assensus Q̃d si uota
amboꝝconuenerintsacerdos	amboꝝ conuenerint sacerdos
lectacartasponsaliciibñdicat	lecta carta sponsalicii bñdicat
arrasdicensBENEDICdñehasarras	arras dicens BENEDIC dñe has arras
quashodietradetfamulustuusin	quas hodie tradet famulus tuus in
manuancillętuęquem	manu ancillę tuę quem
admodũbenedixistiabraam	admodũ benedixisti abraam
cumsairaysaaccũRebecaiacobcũrachelDona	cum saira ysaac cũ Rebeca iacob cũ rachel Dona
suꝑeosdñe	suꝑ eos dñe
gr̃ambenedicPAPAVRBISROME	gr̃am benedic PAPA VRBIS ROME
EDITVSSCRIPTORISLIBRILECTORMEMOR	EDITVS SCRIPTORIS LIBRI LECTOR MEMOR
ESTOSICARDIOrdoqualit̃inCatholicaeccl̃amissacelebretur	ESTO SICARDI Ordo qualit̃ in Catholica eccl̃a missa celebretur
Inpͥmisantiph̃aadintroitũDeindekiriel̃IIIͦxp̃el̃IIIͦ	In pͥmis antiph̃a ad introitũ Deinde kiriel̃ IIIͦ xp̃el̃ IIIͦ
kiriel̃IIIͦPosteaGl̃ain	kiriel̃ IIIͦ Postea Gl̃a in
excelsisd̃odieb᷒	excelsis d̃o dieb᷒
festistantũmͦIndeor̃oSeqͥturEpl̃aDeindeGradal̃siue	festis tantũmͦ Inde or̃o Seqͥtur Epl̃a Deinde Gradal̃ siue
all̃aPostea	all̃a Postea
Eugl̃mIndeOffertoriũPostomodũseqͥturor̃o	Eugl̃m Inde Offertoriũ Postomodũ seqͥtur or̃o
suꝑobl̃aQuasubsilentiocompletasacerdosexpansis	suꝑ obl̃a Qua sub silentio completa sacerdos expansis
manib᷒excelsauocereuerenterdicat	manib᷒ excelsa uoce reuerenter dicat
SUPEROBLATAOblataconfessoristuicolumbani	SUPER OBLATA Oblata confessoris tui columbani
honoresinttibinr̃agratalibamina&nr̃arumapud	honore sint tibi nr̃a grata libamina & nr̃arum apud
tesupplicationumeffectumobtineãt*	te supplicationum effectum obtineãt *
P*ADCOMPLENDṼFacnosquesumusdominebeaticonfessoris	P * AD COMPLENDṼ Fac nos quesumus domine beati confessoris
tuicolumbanidignesollempniacelebrarequilargitatis	tui columbani digne sollempnia celebrare qui largitatis
tuaepreuent᷒munere	tuae preuent᷒ munere
laudabilisuitęcursum	laudabilis uitę cursum
gloriosofinecompleuit*P	glorioso fine compleuit * P
*EODEMDIEVIGILIASC̃ECECILIAE	* EODEM DIE VIGILIA SC̃E CECILIAE
VIRGINISSANctęCECILIAEmr̃istuęquesumusdomineintercessionibusnos	VIRGINIS SANctę CECILIAE mr̃is tuę quesumus domine intercessionibus nos
foueas&cuiusuenerabilemsollempnitatemnostribuis	foueas & cuius uenerabilem sollempnitatem nos tribuis
preuenireobIncipit	preuenire ob Incipit
secund᷒Postmortem	secund᷒ Post mortem
uͦysaacfiliieiusinuicem	uͦ ysaac filii eius inuicem
habitaculadiuiseruntnoneaqueacceperant&tenuerant	habitacula diuiserunt non ea que acceperant & tenuerant
sesauquidem	s esau quidem
ebronciuitatemfratridanshabitauitinseir&	ebron ciuitatem fratri dans habitauit in seir &
inidumearegnabatquamregionemasemetipsoitauocauit	in idumea regnabat quam regionem a semetipso ita uocauit
EdomenimnominatusestQuamnuncupationemhuiusmodiuenationiscausasortitus	Edom enim nominatus est Quam nuncupationem huiusmodi uenationis causa sortitus
estAliquandolaboreuenationisesuriensredibatdumadhucpuereẽt	est Aliquando labore uenationis esuriens redibat dum adhuc puer eẽt
etateInueniensq	etate Inueniensq
fratremlentemsibipreparantemadprandium	fratrem lentem sibi preparantem ad prandium
rubeumcoloremnimishabentem&proptereapotiusincitatusrogabatut	rubeum colorem nimis habentem & propterea potius incitatus rogabat ut
eipreberetadcibumQuiuenderesibi	ei preberet ad cibum Qui uendere sibi
primatumpropt̃cibumꝑeiusesuriem	primatum propt̃ cibum ꝑ eius esuriem
cimpulitfratrẽSICVTINDIVINISLITTERISdiuersalegunturcantica	cimpulit fratrẽ SICVT IN DIVINIS LITTERIS diuersa leguntur cantica
ita&sp̃usc̃o	ita & sp̃u sc̃o
lam̃tationesdiuersęEtsic̃ꝓpͥeappellaturlibersalomoniscantica	lam̃tationes diuersę Et sic̃ ꝓpͥe appellatur liber salomonis cantica
canticoꝝita&appellariqͤũtthreniiheremię	canticoꝝ ita & appellari qͤũtthreni iheremię
lamentationeslam̃tationũsic̃omnino	lamentationes lam̃tationũ  sic̃ omnino
celluntillainquib	cellunt illa in quib
sponsusacsponsadulvibfruunturamplexibusita	sponsus ac sponsa dulvib fruuntur amplexibus ita
&lam̃tationesistęhocĩ	& lam̃tationes istę hoc ĩ
nõedñiadmonem᷒qͣntũposum᷒&	nõe dñi admonem᷒ qͣntũ posum᷒ &
cipim᷒ut	cipim᷒ ut
qnͦauditisexponisacͣm̃tũscͥpt᷑ęnarrantiᷤquę	qnͦ auditis exponi sacͣm̃tũ scͥpt᷑ę narrantiᷤ quę
gestas̃	gesta s̃
priusilludq̃dlectũ	prius illud q̃d lectũ
ẽcredatissic	ẽ credatis sic
gestũqͦmͦlectũẽ	gestũ qͦmͦ lectũ ẽ
nesubtracto	ne subtracto
fundam̃toreigestęqͣsiinaerequaeratiᷤedificare	fundam̃to rei gestę qͣsi in aere quaeratiᷤ edificare
Abrahãpat̃nr̃homoeratillis	Abrahã pat̃ nr̃ homo erat illis
tẽporibfid̃liᷤcredensd̃oiustificat᷒exfidesic̃script᷑adic̃	tẽporib fid̃liᷤ credens d̃o iustificat᷒ ex fide sic̃ script᷑a dic̃
&uet᷒&nouaSuscep̃filiũdesarauxoreiã	& uet᷒ & noua Suscep̃ filiũ de sara uxore iã
insenectuteutͥsqc̃stitutiᷤex	in senectute utͥsq c̃stitutiᷤ ex
magnadesꝑatiõe,	magna desꝑatiõe ,
sscd̃mhominẽ	s scd̃m hominẽ
Qͥdaut̃de	Qͥd aut̃ de
deoñsꝑandũcui	deo ñ sꝑandũ cui
nichildifficileẽqͥsic	nichil difficile ẽ qͥ sic
fac̃magnaquomͦparuasicsuscitatmortuoᷤ	fac̃ magna quomͦ parua sic suscitat mortuoᷤ
qͦmͦcreatuiuosSipictoreadẽarte	qͦmͦ creat uiuos Si pictor eadẽ arte
fac̃muremsudario	fac̃ murem sudario
porrigit᷑adaltareq̃dsudariũponiturincornualtaCalix	porrigit᷑ ad altare q̃d sudariũ ponitur in cornu alta Calix
inlatereoblatain	in latere oblata in
altaricõponit᷑	altari cõponit᷑
ñposttergũLętanięitacęlebraᷠt᷑inuigiliispaschęut	ñ post tergũ Lętanię ita cęlebraᷠt᷑ in uigiliis paschę ut
nr̃mosolimobtinuit	nr̃ mos olim obtinuit
idestpostbaptismũ	id est post baptismũ
ꝑsepnariũ&quinariũ&ternariũnumerumOFFICIALISLIBERGLORIOSISSIME	ꝑ sepnariũ & quinariũ & ternariũ numerum OFFICIALIS LIBER GLORIOSISSIME
IMPERATORETMAGNIFICENsimeac	IMPERATOR ET MAGNIFICEN sime ac
centiesinuictissimead̃ocoronatenec	centies inuictissime a d̃o coronate nec
n&conseruateatqconseruandeseruusegour̃A	n & conseruate atq conseruande seruus ego ur̃ A
LARIUSquãuisminimus	LARIUS quãuis minimus
om̃iũAfficiebarolidesiderioutscirẽ	om̃iũ Afficiebar oli desiderio ut scirẽ
rationẽaliquãdeordinenr̃ęmissęquãconsuętomore	rationẽ aliquã de ordine nr̃ę missę quã consuęto more
cęlebram᷒&ampliusexdiuersitateqsolet	cęlebram᷒ & amplius ex diuersitate q solet
fieriineahocestq̃d	fieri in ea hoc est q̃d
aliquotiensunaepistolalegit᷑	aliquotiens una epistola legit᷑
aliqͦtiensduę&cęterataliasimulqdeceteris	aliqͦtiens duę & cętera talia simulq de ceteris
officiisPręteritaꝓxim	officiis Pręterita ꝓxim
priiseoꝝuerbisutensquęaptaerantmeostudiotemperaui	priis eoꝝ uerbis utens quę apta erant meo studio temperaui
Interdumautẽquęmanifestanondubiũuidebanturuerarationefirmaui	Interdum autẽ quę manifesta non dubiũ uidebantur uera ratione firmaui
Etcontraquęq.ineiusdemlibrimarginelitterasdoctoꝝ	Et contra quęq. in eiusdem libri margine litteras doctoꝝ
quospremisiexinitio	quos premisi ex initio
nominiseregione	nominis e regione
figerecurauiPropterquodlegesecurus&ꝑficequęmonui	figere curaui Propter quod lege securus & ꝑfice quę monui
deuotusExplicitPROLOG᷒INCIPIVNTCAPITVLAIxp̃icõmunionẽ	deuotus Explicit PROLOG᷒ INCIPIVNT CAPITVLA I xp̃i cõmunionẽ
uerũcorpus	uerũ corpus
ei᷒&sanguinẽesseIIQ̃dhocmysteriũxp̃i	ei᷒ & sanguinẽ esse II Q̃d hoc mysteriũ xp̃i
nullusfideliũdebeatignorareIIIQuidsint	nullus fideliũ debeat ignorare III Quid sint
sacramentauelquaredicanturIIIIVtrũsub	sacramenta uel quare dicantur IIII Vtrũ sub
figuraaninueritatehocmysticũfiat	figura an in ueritate hoc mysticũ fiat
sacramentũV	sacramentũ V
Quidsitinterimmolationesueterũfigurasq.legaliũ	Quid sit inter immolationes ueterũ figurasq. legaliũ
&int̃sacramentũ	& int̃ sacramentũ
dñicicorporis&sanguinispuritatecelesisdesid̃iigaudentErateneũ	dñici corporis & sanguinis puritate celesis desid̃ii gaudent Erat eneũ
quiamultisũtqͥ	quia multi sũt qͥ
dicuntmente	dicunt mente
seruiuim᷒legideicarneaut̃legipeccatiEratantetempli	seruiuim᷒ legi dei carne aut̃ legi peccati Erat ante templi
forespositumquiapaucisuntquirenuntiant	fores positum quia pauci sunt qui renuntiant
om̃ibq̃possidentutadostium	om̃ib q̃ possident ut ad ostium
portic᷒appropinquentPortic᷒siqͥd̃templiẽut	portic᷒ appropinquent Portic᷒ siqͥd̃ templi ẽ ut
suꝑi᷒dixim᷒renuntiatõmundiInhac	suꝑi᷒ dixim᷒ renuntiatõ mundi In hac
porticudue	porticu due
erigunt᷑colũpneunacastitatisalt̃a	erigunt᷑ colũpne una castitatis alt̃a
sobͥetatisutqͥmundorenuntiãtsobrie⁊castedeo	sobͥetatis ut qͥ mundo renuntiãt sobrie ⁊ caste deo
uiuantPostporticumrenuntiatõnisseqͥt᷑templũrecte	uiuant Post porticum renuntiatõnis seqͥt᷑ templũ recte
ꝯuconuersionisDealtariaureo⁊	ꝯu conuersionis De altari aureo ⁊
mensaaurea⁊candelabro	mensa aurea ⁊ candelabro
INhoctemplo	IN hoc templo
ẽaltareaureũest	ẽ altare aureũ est
m̃saaurea	m̃sa aurea
sunt⁊candelabra	sunt ⁊ candelabra
deauropurissimo	de auro purissimo
factaInaltariaccendebant᷑thimiamatainm̃sa	facta In altari accendebant᷑ thimiamata in m̃sa
panesponebant᷑incandelabris	panes ponebant᷑ in candelabris
lucerneAltareaureũsuntcordaelectoꝝthimiamata	lucerne Altare aureũ sunt corda electoꝝ thimiamata
bonaoꝑaodorthimiamatũbonioꝑisexemplumFum᷒thimiamatũqͥ	bona oꝑa odor thimiamatũ boni oꝑis exemplum Fum᷒ thimiamatũ qͥ
suꝑi᷒ascenditẽ	suꝑi᷒ ascendit ẽ
intentõoratõnisq̃exaffectu	intentõ oratõnis q̃ ex affectu
cordisaddesid̃anda	cordis ad desid̃anda
celestiatendit	celestia tendit
m̃sauͦaureaẽdiuinascͥpturapanessuntapostolisiue	m̃sa uͦ aurea ẽ diuina scͥptura panes sunt apostoli siue
eoꝝsuccessoresexquoꝝ	eoꝝ successores ex quoꝝ
actibtanqͣm	actib tanqͣm
expanibreficiunt᷑fideliũ	ex panib reficiunt᷑ fideliũ
mentesQuipanesꝓpositõnis	mentes Qui panes ꝓpositõnis
ꝯuenient̃possunt	ꝯuenient̃ possunt
appellarquia	appellar quia
adimitandũꝓponunt᷑	ad imitandũ ꝓponunt᷑
uniũsoorbiDecẽcandelabrasũtdecemlegiscepta	uniũso orbi Decẽ candelabra sũt decem legis cepta
luc̃nelumendoctͥnePossunthec⁊alit̃dici	luc̃ne lumen doctͥne Possunt hec ⁊ alit̃ dici
Sitgͥaltare	Sit gͥ altare
dilectõmensa	dilectõ mensa
lectõcandeINCIPITPROLOG᷒INVITÃSC̃IAGERICI	lectõ cande INCIPIT PROLOG᷒ IN VITÃ SC̃I AGERICI
Impellitismeactrahitisuiolentiaamabilifr̃skm̃iut	Impellitis me ac trahitis uiolentia amabili fr̃s km̃i ut
indiefestiuitatisSc̃iacuenerabilispatrisnr̃i	in die festiuitatis Sc̃i ac uenerabilis patris nr̃i
AGERICIde	AGERICI de
hortouirtutumipsiusfecundissimoquosdamflosculosetuirentia	horto uirtutum ipsius fecundissimo quosdam flosculos et uirentia
quęlibetodoramentadecerpameaq.	quęlibet odoramenta decerpam eaq.
admensamleticięcõmunis	ad mensam leticię cõmunis
ferculolitterarumcõposita	ferculo litterarum cõposita
offeramsicq.repleamdesideriiur̃iappetitumparticulãq.bonamacceptama	offeram sicq. repleam desiderii ur̃i appetitum particulãq. bonam acceptam a
dñouobisex	dño uobis ex
caritatecõmunicem	caritate cõmunicem
BonaẽaclaudabilisplutimũintentioEXPLICIT	Bona ẽ ac laudabilis plutimũ intentio EXPLICIT
DIESQUART᷒INCIP̃LIB̃QͥNT᷒	DIES QUART᷒ INCIP̃ LIB̃ QͥNT᷒
QVIVINDEMIAM	QVI VINDEMIAM
COLLIGITuasapriusquibusuinuminfundit᷑mundareconsueuitne	COLLIGIT uasa prius quibus uinum infundit᷑ mundare consueuit ne
sordesaliquauinigr̃amdecoloretQuidenĩprodestponerę	sordes aliqua uini gr̃am decoloret Quid enĩ prodest ponerę
uitę̃ordinefoderequotannisaut	uitę̃ ordine fodere quot annis aut
aratrissulcosducereputare	aratris sulcos ducere putare
subrigereadiungereulmis&quodam	subrigere adiungere ulmis & quodam
conubiocopularesi	conubio copulare si
tantolabore	tanto labore
uinaquesitainuasecoacescantmatutinosquoq	uina quesita in uase coacescant matutinos quoq
solisort᷒siquis	solis ort᷒ si quis
spectaredesideratemundatocl̃ossuosnequidpulueris	spectare desiderat emundat ocl̃os suos nequid pulueris
neqͥdpurgam̃toꝝocl̃isei᷒insideat	neqͥd purgam̃toꝝ ocl̃is ei᷒ insideat
quotuendishebetet᷑optut᷒neuealiquacaligonebulosacorporeos	quo tuendis hebetet᷑ optut᷒ neue aliqua caligonebulosa corporeos
uisusspectantisobuestrę	uisus spectantis ob uestrę
quarehunc	quare hunc
sermonẽnecesse	sermonẽ necesse
habuiuob̃ꝓmereExquohic	habui uob̃ ꝓmere Ex quo hic
sumuseuntesadęccl̃am&redeuntespauperes	sumus euntes ad ęccl̃am & redeuntes pauperes
int̃pellantnos&dicuntutdicam᷒uob̃ut	int̃pellant nos & dicunt ut dicam᷒ uob̃ ut
aliqͥdaccipiantauob̃Nos	aliqͥd accipiant a uob̃ Nos
nouer̃l̃r̃tloquiuob̃&se	nouer̃ l̃ r̃t loqui uob̃ & se
uidentñaccipereauob̃	uident ñ accipere a uob̃
Inanit̃nosarbitrantur	Inanit̃ nos arbitrantur
laborareinuob̃Expectantaliquid&	laborare in uob̃ Expectant aliquid &
anob̃damusquãtumhabem᷒damussicutpossumus	a nob̃ damus quãtum habem᷒ damus sicut possumus
Nũquidtam̃adeorũnecessitatẽsupplendãidoneisumus	Nũquid tam̃ ad eorũ necessitatẽ supplendã idonei sumus
Quiagͦadeorumnecessitatẽimplendãidoneinon	Quia gͦ ad eorum necessitatẽ implendã idonei non
sumusuel	sumus uel
aduoslegatiipsorũsumusAudistislaudastis	ad uos legati ipsorũ sumus Audistis laudastis
d̃ogr̃as	d̃o gr̃as
egistisSem̃accepistisũbareddidistis	egistis Sem̃ accepistis ũba reddidistis
Laudesistaeur̃ęgrauantnospotius&	Laudes istae ur̃ę grauant nos potius &
inpericulũmittuntToleram᷒illas&	in periculũ mittunt Toleram᷒ illas &
tremimusint̃illasTam̃fr̃s	tremimus int̃ illas Tam̃ fr̃s
meiistelaudesur̃ęfoliasuntarborũfructusquęriturEXPLICIT	mei iste laudes ur̃ę folia sunt arborũ fructus quęritur EXPLICIT
ITEMEIUSDEMDEVERBISDÑIINEUGL̃O	ITEM EIUSDEM DE VERBIS DÑI IN EUGL̃O
SCD̃MMATH̃MDEPVEROCENTVRIONIS&VERBISEI᷒	SCD̃M MATH̃M DE PVERO CENTVRIONIS & VERBIS EI᷒
INDIGNṼSEPRESENTIADÑIdebitanr̃a	INDIGNṼ SE PRESENTIA DÑI debita nr̃a
sic̃&nosdimittim᷒debitorib	sic̃ & nos dimittim᷒ debitorib
nSꝑateresurrecturũ&tc̃futurũom̃imͦsin	n Sꝑa te resurrecturũ & tc̃ futurũ om̃i mͦ sin
peccatoQͥailleresurrex̃qͥpͥm᷒fuit	peccato Qͥa ille resurrex̃ qͥ pͥm᷒ fuit
sinepeccatoAuigmatutinasꝑanolidicereego	sine peccato A uig matutina sꝑa noli dicere ego
ñsũdign᷒ꝓpt̃peccata	ñ sũ dign᷒ ꝓpt̃ peccata
ñesmultaapudillũredẽptioEt	ñ e s multa apud illũ redẽptio Et
ipseredimetisr̃lexom̃ibiniqͥtatibei᷒EXPLIC̃DEPSA	ipse redimet isr̃l ex om̃ib iniqͥtatib ei᷒ EXPLIC̃ DE PSA
MOCENTESIMOVICESIMO	MO CENTESIMO VICESIMO
NONOINCIPITDEPSALMOCENTESIMOTRICESIMOINISTOPSALMO	NONO INCIPIT DE PSALMO CENTESIMO TRICESIMO IN ISTO PSALMO
cõm̃dat᷑nob̃humilitasseuid̃i&	cõm̃dat᷑ nob̃ humilitas seui d̃i &
fideliscui᷒uocecantat᷑q̃dẽ	fidelis cui᷒ uoce cantat᷑ q̃d ẽ
uniuersũcorp᷒xp̃i	uniuersũ corp᷒ xp̃i
Sepeenĩadmonuim᷒caritatẽ	Sepe enĩ admonuim᷒ caritatẽ
ur̃amñ	ur̃am ñ
qͣsiuni᷒hominis	qͣsi uni᷒ hominis
cantantisucẽaccipideberesedom̃iũqͥ	cantantis u cẽ accipi debere sed om̃iũ qͥ
s̃tinxp̃icorporeEtqͥainilli᷒corpores̃t	s̃t in xp̃i corpore Et qͥa in illi᷒ corpore s̃t
om̃stãquãi	om̃s tãquã i
homoloqͥt᷑Et	homo loqͥt᷑ Et
ipseẽun᷒qͥ&multis̃tMtienĩs̃t	ipse ẽ un᷒ qͥ & multi s̃t Mti enĩ s̃t
inseipsisun᷒s̃tinilloqͥun᷒	in seipsis un᷒ s̃t in illo qͥ un᷒
ẽIpsũẽetiãtẽplũ	ẽ Ipsũ ẽ etiã tẽplũ
d̃ideqͦ	d̃i de qͦ
apl̃sdicitTẽpenĩd̃isc̃mẽq̃destisuos	apl̃s dicit Tẽp enĩ d̃i sc̃m ẽ q̃d estis uos
Om̃sqͥcredd̃t	Om̃s qͥ credd̃t
inxp̃m&siccred̃tutdiligant	in xp̃m & sic cred̃t ut diligant
hocẽcredeinxp̃mdiligerexp̃m	hoc ẽ crede in xp̃m diligere xp̃m
NONqͦmͦdemonesfontẽuenirentnͥaliqͣdielauarent᷑Istũ	NON qͦmͦ demones fontẽ uenirent nͥ aliqͣ die lauarent᷑ Istũ
aut̃diempoti᷒adhoc	aut̃ diem poti᷒ ad hoc
electũqͦcenadñicaanniuersarie	electũ qͦ cena dñica anniuersarie
celebͣt᷑&qͥa	celebͣt᷑ & qͥa
concessũẽhocbaptismũaccept᷑is,multi	concessũ ẽ hoc baptismũ accept᷑is , multi
cũhislauareuoluer̃ieiuniũqlaxarehisꝓut	cũ his lauare uoluer̃ ieiuniũq laxare his ꝓut
potuidisputati	potui disputati
moneoeaquęlocut᷒	moneo ea quę locut᷒
sũseruesqͣntũpotesutęccl̃ęd	sũ serues qͣntũ potes ut ęccl̃ę d
prudentẽacpacificũfiliũ	prudentẽ ac pacificũ filiũ
Aliaquęquę	Aliaquę quę
int̃rogastisidñsuolueritaliotẽporeexpediamEXPLIC̃LIB̃	int̃rogasti si dñs uoluerit alio tẽpore expediam EXPLIC̃ LIB̃
INCIPITII᷒	INCIPIT II᷒
ADEVNDẼIAÑDEC̃SVETVDINE	AD EVNDẼ IAÑ DE C̃SVETVDINE
ĘCCL̃ĘDILECTISSIMOfilioIanuario	ĘCCL̃Ę DILECTISSIMO filio Ianuario
AUgUSTINUSLectislitt͛istuis	AUgUSTINUS Lectis litt͛is tuis
ubimecõmonuistiutdebitũ	ubi me cõmonuisti ut debitũ
redderẽde	redderẽ de
residuisenodandisquestionib᷒qͣsiãlongeañquesiuerasgͣtissimũmͥ	residuis enodandis questionib᷒ qͣs iã longe añ quesiueras gͣtissimũ mͥ
atqkarissimũdesideriũIncipitsũmamagistͥ	atq karissimũ desideriũ Incipit sũma magistͥ
alanideꝯfessioneet	alani de ꝯfessione et
penitenciaQuoniamcircaconfessionesaĩaꝝꝑicl̃asuntet	penitencia Quoniam circa confessiones aĩaꝝ ꝑicl̃a sunt et
difficultatesqñemerguntId̃oadhonoremd̃isc̃iqNicholaiad	difficultates qñ emergunt Id̃o ad honorem d̃i sc̃iq Nicholai ad
fr̃mutilitatematqconfitentiũsalutemtractatumbreuem	fr̃m utilitatem atq confitentiũ salutem tractatum breuem
deconfessione	de confessione
conpilauisubcertistitulis	conpilaui sub certis titulis
singl̃aq̃	singl̃a q̃
circaꝯfessionemrequirũt᷑etincidũtcõcludensutfacili᷒lector	circa ꝯfessionem requirũt᷑ et incidũt cõcludens ut facili᷒ lector
q̃uelitualeatinuenireCui᷒tͣctat᷒rubrice	q̃ uelit ualeat inuenire Cui᷒ tͣctat᷒ rubrice
suntheI	sunt he I
capitulumQͦtemꝑeinceꝑit	capitulum Qͦ temꝑe inceꝑit
ꝯfessioIIQuaresitinstitutaconfessioIIICuifacienda	ꝯfessio II Quare sit instituta confessio III Cui facienda
sitconfessioQuandositconfitendumVQueprecipue	sit confessio Quando sit confitendum V Que precipue
ĩꝯfessiõereqͥrũt᷑VIQ̃sintnecc̃a	ĩ ꝯfessiõe reqͥrũt᷑ VI Q̃ sint necc̃a
aduerãpeñiamVIIDe	ad uerã peñiam VII De
allocutiõesac͛dotis	allocutiõe sac͛dotis
etĩductiõeadꝯfitẽd̃VIII	et ĩductiõe ad ꝯfitẽd̃ VIII
Decirꝯstanciisquaspcc̃or	De cirꝯstanciis quas pcc̃or
tenet᷑ꝯfiteriIXUtrumcirꝯstancieagrauentpcc̃mX	tenet᷑ ꝯfiteri IX Utrum cirꝯstancie agrauent pcc̃m X
Deint̃rogationibasac̃dotefaciendisXI	De int̃rogationib a sac̃dote faciendis XI
DegeneribusabusionumXII	De generibus abusionum XII
Deofficioetdebitosac̃dotisergapenitẽtesXIIIQͥspcc̃a	De officio et debito sac̃dotis erga penitẽtes XIII Qͥs pcc̃a
dimͭtatetꝑq̃mortaliasiueuenialiadimittãt᷑XIIII	dimͭtat et ꝑ q̃ mortalia siue uenialia dimittãt᷑ XIIII
Demodopenitencie	De modo penitencie
ꝓquolibetpeccatoXVQuedebentconsiderariininposionepenitencie	ꝓ quolibet peccato XV Que debent considerari in inposione penitencie
Non·H·nosmip̃osdicamussih̃mxp̃m	Non ·H· nosm ip̃os dicamus s ih̃m xp̃m
dominũnr̃mnoᷤaũseruosur̃osꝑih̃mqm̃	dominũ nr̃m noᷤ aũ seruos ur̃os ꝑ ih̃m qm̃
d̃sqͥdixitdetenebrislucẽsplendesc̃eipse	d̃s qͥ dixit de tenebris lucẽ splendesc̃e ipse
illux̃incordibnr̃is	illux̃ in cordib nr̃is
adilluminacionẽscĩeclaritatisd̃i	ad illuminacionẽscĩe claritatis d̃i
infaciexͥ	in facie xͥ
ih̃unedicogl̃iexp̃inon	ih̃u nedico gl̃ie xp̃i non
·H·⁊c̃l̃itaꝯtinuaꝯm̃dam᷒nos	·H· ⁊ c̃ l̃ ita ꝯtinua ꝯm̃dam᷒ nos
inmanifestacioneũitatis⁊	in manifestacione ũitatis ⁊
cet̃aͭaliafacimus⁊h̃ꝓp̃xp̃mñ·H·di.	cet̃a ͭalia facimus ⁊ h̃ ꝓp̃ xp̃m ñ ·H· di.
nosmip̃ossih̃m	nosm ip̃os s ih̃m
xp̃mdo.nos..i.dicacio	xp̃m do. nos. .i. dicacio
nr̃anon	nr̃a non
tenditadgl̃iamnr̃aml̃adlucranr̃asad	tendit ad gl̃iam nr̃am l̃ ad lucra nr̃a s ad
gl̃iamxͥꝙ̃predicamus	gl̃iam xͥ ꝙ̃ predicamus
saluatorem⁊dñmnr̃meẽillũdicam᷒	saluatorem ⁊ dñm nr̃m eẽ illũ dicam᷒
eẽdñmNosaũdñiseẽseruos.i.minisstros	eẽ dñm Nos aũ dñis eẽ seruos .i. minisstros
ur̃os⁊h̃ꝑxp̃mquinobis	ur̃os ⁊ h̃ ꝑ xp̃m qui nobis
h̃iniunx̃hocaut̃facimusqm̃d̃sip.	h̃ iniunx̃ hoc aut̃ facimus qm̃ d̃s ip.
illux̃incor.no..i.seqͥ	illux̃ in cor. no. .i. se qͥ
ẽlumennobisinfunditqͥ	ẽ lumen nobis infu n dit qͥ
dixit.i.ceptosolofecitlucemsplend̃edetenebris	dixit .i. cepto solo fecit lucem splend̃e de tenebris
q̃dfuitĩseꝑacioneelem̃toꝝceꝑunt	q̃d fuit ĩ seꝑacione elem̃toꝝ ceꝑunt
·H·tenebreexquoꝯfusa	·H· tenebre ex quo ꝯfusa
molesceli⁊t̃recep̃eẽañqͣmlux	moles celi ⁊ t̃re cep̃ eẽ añqͣm lux
fc̃aeẽtquailluminaret᷑ꝙsñlucefuerattenebrosum	fc̃a eẽt qua illuminaret᷑ ꝙ sñ luce fuerat tenebrosum
p᷒eaeuõaccedenteluceꝙfc̃mest	p᷒ea e uõ accedente luce ꝙ fc̃m est
meliusreddr᷑inqͦꝓficientishõisaffectiosigc̃aturuñ	melius reddr᷑ in qͦ ꝓficientis hõis affectio sigc̃atur uñ
apl̃sloquẽstore&loquutusẽeis	apl̃s loquẽs tore & loquutus ẽ eis
multainparabolisdicensExiit	multa in parabolis dicens Exiit
quiseminat	qui seminat
seminaresemensuumEt	seminare semen suum Et
dumsemiminoressubditiĩeccl̃ia	dum semi minores  subditi ĩ eccl̃ia
intelligunt᷑quiñascenduntinnauimñdum	intelligunt᷑ qui ñ ascendunt in nauim ñdum
celestibmisteriis	celestib misteriis
imbuticumxp̃oin	imbuti cum xp̃o in
ꝑabolisLucasꝑsimilitudinẽq̃didemẽMarcusDicebateis	ꝑabolis Lucas ꝑ similitudinẽ q̃d idem ẽ Marcus Dicebat eis
indoctrinasuaCap̃lxxiiExiitQuidiscipl̃isloq̃bat᷑	in doctrina sua Cap̃ lxxii Exiit Qui discipl̃is loq̃bat᷑
sacramentaexiitseminareũbumdeiinturbas	sacramenta exiit seminare ũbum dei in turbas
parabolasutiuxtauariasuoluntatess.sentencias	 parabolas ut iuxta uarias uoluntates s.  sentencias
suasdiũsasrecipiant	suas diũsas recipiant
disciplinass.utuidentesñuideant	disciplinas s. ut uidentes ñ uideant
c̃Nota	 c̃ Nota 
triplexẽsem̃Sem̃seminatumpuluereecogitationisobscuretQuetamen	triplex ẽ sem̃ Sem̃ seminatum pulueree cogitationis obscuret Que tamen
ñpulsarerectoris	ñ pulsare rectoris
animumnequeuntsfestinare	animum nequeunt s festinare
necesseestut	necesse est ut
repugnationeuincantur	repugnatione uincantur
neuitiumquodꝑsuggestionemtemptatmollicie	ne uitium quod ꝑ suggestionem temptat mollicie
delectationissubigat	delectationis subigat
,cumqhecabanimotarde	, cumq hec ab animo tarde
repelliturmucroneconsensusoccidat.xiiiiSit	repellitur mucrone consensus occidat . xiiii Sit
rectoroꝑationecipuusutuiteuiamsubditisuiuendodenunciet	rector oꝑatione cipuus ut uite uiam subditis uiuendo denunciet 
grexquipastorisuocẽmores	grex qui pastoris uocẽ mores
qsequiturꝑ	q sequitur ꝑ
exemplameliusquãꝑu͛ba	exempla melius quã ꝑ u͛ba
gradiaturQuienimlocisuinecessitateexigitursummadic̃e	gradiatur Qui enim loci sui necessitate exigitur summa dic̃e
haceademnecessitateconpellitur	hac eadem necessitate conpellitur
summamonstrareIllanamquox	summa monstrare Illa namq uox
faciemruboreuestietautpalloreconfũdet	faciem rubore uestiet aut pallore confũdet
cui᷒labia	cui᷒ labia
contrahenturautsalienttoxicabit᷑linguagenuatrementmanusꝓt̃uiet	contrahentur aut salient toxicabit᷑ lingua genua trement manus ꝓt̃uiet
seip̃mnugis	se ip̃m nugis
nr̃isconuincetobnoxiumInqͥbfuitꝓpositi	nr̃is conuincet obnoxium In qͥb fuit ꝓpositi
semꝑanugisadbonatransire	semꝑ a nugis ad bona transire
seria⁊adidquod	seria ⁊ ad id quod
decetautꝓdestrestituere	decet aut ꝓdest restituere
uitamQͥaut̃iustũrehensionilocũuid̃iteaexcaritate	uitam Qͥ aut̃ iustũ rehensioni locũ uid̃it ea ex caritate
licent̃utat᷑⁊deem̃datione	licent̃ utat᷑ ⁊ de em̃datione
meaacquiratsibi⁊possideatmiumuiteScio	mea acquirat sibi ⁊ possideat mium uite Scio
enĩquiainmultiloquiopecc̃mñdeest	enĩ quia in multiloquio pecc̃m ñ deest
sinuito⁊incaritatedeiexhortorlectorẽqͦ	s inuito ⁊ in caritate dei exhortor lectorẽ qͦ
meimemorinorationibussuisimpetret	mei memor in orationibus suis impetret
utfiliusdeiuiui⁊uirginisintemeratedeushomo	ut filius dei uiui ⁊ uirginis intemerate deus homo
manifestetseipsũ⁊palamfaciat	manifestet se ipsũ ⁊ palam faciat
uiamquanob̃incedendumẽinbñplacitosuo⁊	uiam qua nob̃ incedendum ẽ in bñplacito suo ⁊
dirigatineo	dirigat in eo
gressusnostrosAMeNQueaũLiber	gressus nostros AMeN Que aũ Liber
sc̃emarie	sc̃e marie
pontiniaciFinitolibroreddanturiuramagistroD̃squihodiernãdiẽ	pontiniaci Finito libro reddantur iura magistro D̃s qui hodiernã diẽ
apl̃orumtuorumpetri&paulimartirioconsecrastidaeccl̃ietue	apl̃orum tuorum petri & pauli martirio consecrasti da eccl̃ie tue
eoruminomnibsequipreceptũꝑquosreligionissumpsit	eorum in omnib sequi preceptũ ꝑ quos religionis sumpsit
exordiũꝑsc̃rHostiasdñequas	exordiũ ꝑ sc̃r Hostias dñe quas
nominituosacrandasofferimusapl̃ica	nomini tuo sacrandas offerimus apl̃ica
ꝓsequaturoratio	ꝓsequatur oratio
ꝑquamnosexpiaINCIPIT	ꝑ quam nos expia INCIPIT
PREFACIOMAGISTRIGAUFRIDIMONEMUTENSISIN	PREFACIO MAGISTRI GAUFRIDI MONEMUTENSIS IN
historiaBRITONUM	historia BRITONUM
CUMmecũmulta⁊demultissepius	CUM mecũ multa ⁊ de multis sepius
animoreuoluensinystoriamregũbritannieincidereminmir̃q̃d	animo reuoluens in ystoriam regũ britannie inciderem in mir̃ q̃d
ĩframentionemquamdeeisGildas⁊bedaluculentotͣctu	ĩfra mentionem quam de eis Gildas ⁊ beda luculento tͣctu
fecerantnichilderegibquianteincarnationẽxp̃i	fecerant nichil de regib qui ante incarnationẽ xp̃i
inhabitaũãtnichil⁊̃	inhabitaũãt nichil ⁊̃
dearturocet̃isqcõpl̃ibquip᷒incarnationẽsucceᷤserũt	de arturo cet̃isq cõpl̃ib qui p᷒ incarnationẽ succeᷤserũt
repperissemetgestaeoꝝdignaet̃nitatislaude	repperissem et gesta eoꝝ digna et̃nitatis laude
cõstarent⁊amultis	cõstarent ⁊ a multis
populisqͧasi	populis qͧasi
inscͥptaiocunde⁊memorit̃dicenturtalia	inscͥpta iocunde ⁊ memorit̃ dicentur tali a
mͥ⁊detalibmultocienscogitantioptulitWalterusoxinefordensis	mͥ ⁊ de talib multociens cogitanti optulit Walterus oxinefordensis
archidiacon᷒uirinoratoria	archidiacon᷒ uir in oratoria
arteatqinexoticisystoriiserudit᷒	arte atq in exoticis ystoriis erudit᷒
quendambritaBRitanniainsularumoctdentaliocceano	quendam brita BRitannia insularum oct dentali occeano
int̃gallniãsitadccc	int̃ gall niã sita dccc
miliainlong	milia in long
inlatũcõtinens	in latũ cõtinens
quicquidusuicongruitindeficientteministrat	quicquid usui congruit in deficient te ministrat
Om̃i⁊enĩgeñcãposlatesparsosh̃t	Om̃i ⁊ enĩ geñ cãpos late sparsos h̃t
⁊collpollenti	⁊ coll pollenti
cultureaptosindiũsitateᷤubertateglebetp̃ribniũt	culture aptos in diũsitateᷤ ubertate glebe tp̃rib niũt
h̃t⁊nemorauniũsisgeñibrepleta	h̃t ⁊ nemora uniũsis geñib repleta
⁊quoꝝin	⁊ quoꝝ in
saltͥnandisanimaliũpastib.ueniũt⁊auolantib.apib.ũsoꝝ	saltͥ nandis animaliũ pastib. ueniũt ⁊ a uolantib. apib. ũsoꝝ
coloꝝmelladistͥbuittasubaeriismontib.amenrentia	coloꝝ mella distͥbuit ta sub aeriis montib. amen rentia
inqͥb.fonteslucidiriuoslenimurmuremann᷒	in qͥb. fontes lucidi riuos leni murmure man n᷒
suauissoporisin	suauis soporis in
ripisuenietisrequiemanimabuestrisIugũenĩmeũ	ripis uenietis requiem animab uestris Iugũ enĩ meũ
suaueestetonusmeum	suaue est et onus meum
leueOm̃ips̃sempiternedeusadestomagnepietatistuemisteriisadesto	leue Om̃ips̃ sempiterne deus adesto magne pietatis tue misteriis adesto
sacramentiisetadcreandosnouospopl̃osquostibi	sacramentiis et ad creandos nouos popl̃os quos tibi
fonsbaptismacisparturitsp̃madoptionisemitte	fons baptismacis parturit sp̃m adoptionis emitte
Utquodnostrehumilitatisgenrendumẽmisteriotueuirtutisinpleatur	Ut quod nostre humilitatis genrendum ẽ misterio tue uirtutis inpleatur
effectuperdominũDñsuobiscumEtcũsp̃u	effectu per dominũ Dñs uobiscum Et cũ sp̃u
tuoSursumcordaHabemusaddominũGr̃as	tuo Sursum corda Habemus ad dominũ Gr̃as
agamusdominodeonostro	agamus domino deo nostro
DignũetiustumestprefatioUeredignũ&iustũ	Dignũ et iustum est prefatio Uere dignũ & iustũ
estequũ&salutareNoᷤtibisemꝑ	est equũ & salutare Noᷤ tibi semꝑ
&ubiqgr̃asageredñesc̃epateromnipotenset̃ned̃s	& ubiq gr̃as agere dñe sc̃e pater omnipotens et̃ne d̃s
Quiinuisibilipotentiasasitcarnissubstãtiatestant᷑sepuᷝchra	Qui inuisibili potentia sa sit carnis substãtia testant᷑ sepuᷝchra
Quisparẽtumamicoꝝfideliũꝙͣlib&dilectisuitangerescaturien	Quis parẽtum amicoꝝ fideliũ ꝙͣlib& dilecti sui tangere scaturien
u͛mibcarnẽpotest	u͛mib carnẽ potest
Caroitaqcũc̃cupiscitpset᷑qͥdsitexanimis	Caro itaq cũ c̃cupiscit p set᷑ qͥd sit exanimis
&intelligit᷑qͥdamat᷑Nichilqͥppesadedomãdũ	& intelligit᷑ qͥd amat᷑ Nichil qͥppe s ad edomãdũ
carnaliũdesid̃ioꝝappetitũual&quãuun᷒qͥsqhoc	carnaliũ desid̃ioꝝ appetitũ ual& quã u un᷒qͥsq hoc
q̃duiuũdiligitquale	q̃d uiuũ diligit quale
sitmortuũ	sit mortuũ
pensetConsid̃ata&enĩcorruptionecarnaliciti᷒cognoscit᷑	penset Consid̃ata &enĩ corruptione carnali citi᷒ cognoscit᷑
qͥaillicitecarocõcupiscit᷑tabesdesid̃at᷑Benegͦ	qͥa illicite caro cõcupiscit᷑ tabes desid̃at᷑ Bene gͦ
deluxriosi	de lux riosi
m̃tedr̃ddulcedoilli᷒ũmis;qͥa	m̃te dr̃d dulcedo illi᷒ ũmis ; qͥa
isqͥindesid̃iocarlis	is qͥ in desid̃io car lis
corruptionisexestuatadfetorẽputredinisanhelHecsic̃in	corruptionis exestuat ad fetorẽ putredinis anhel Hec sic̃ in
hui᷒partist̃cieinitioꝓmisissememenisubbreuitate	hui᷒ partis t̃cie initio ꝓmisisse me me ni sub breuitate
tͣnscurriuteaqueinhocoꝑesectur	tͣnscurri ut ea que in hoc oꝑe sec tur
qͥamagnaobscuritateimplicatas̃topitulantd̃olatiusdisseranturExplicit	qͥa magna obscuritate implicata s̃t opitulant d̃o latius disserantur Explicit
libersext᷒deciparsterciLibermontissanctmarie	liber sext᷒ deci pars terci Liber mon tis sanct marie
uermenuelatõemIsqin	uer men uelatõem Isq in
itinerecumꝓph̃am	itinere cum ꝓph̃am
aGabumrepperissetqͣntaseadu͛sitasiniherosolimismaneretaudiuit	aGabum repperisset qͣnta se adu͛sitas in iherosolimis maneret audiuit
Scriptum÷qͥppe	Scriptum ÷ qͥppe
q̃didemaGabuszonampaulisuispedibinserens	q̃d idem aGabus zonam pauli suis pedib inserens
dixitVirumcui᷒heczonaestsicalligabunt	dixit Virum cui᷒ hec zona est sic alligabunt
iniherusalemApauloaut̃	in iherusalem A paulo aut̃
ꝓtinusrespondeturEgonõ	ꝓtinus respondetur Ego nõ
solumalligarisetiammoriin	solum alligari s etiam mori in
ihrl̃mparatussumꝓnoĩeih̃uNeqenimciosioremfatio	ihrl̃m paratus sum ꝓ noĩe ih̃u Neq enim ciosiorem fatio
aĩammeamqͣmmeꝑceptionegͥreuelationis	aĩam meam qͣm me ꝑceptione gͥ reuelationis
iherosolimamꝑgensadũsacognoscittam̃	iherosolimam ꝑgens adũsa cognoscit  tam̃
heclibent̃appetitAuditquetimeatsadhecardentior	hec libent̃ appetit Audit que timeat s ad hec ardentior
anhelatMoysesitaqadꝓsꝑadesuonilhabet	anhelat Moyses itaq ad ꝓsꝑa de suo nil habet
cibrenititurneisr̃liticeplebipreferat᷑Paulusadadũsa	 cib renititur ne isr̃litice plebi preferat᷑ Paulus ad adũsa
etiamexsuouotoduciturmaloꝝ	etiam ex suo uoto ducitur  maloꝝ
imminentiũcognitionẽꝑcipitsdeuotione	imminentiũ cognitionẽ ꝑcipit s deuotione
sp̃setiamadacrioraferuescitIllesentis	sp̃s etiam ad acriora feruescit Ille sentis
potestatisgl̃amdeouoluitiubentedeclinareiste	potestatis gl̃am deo uoluit iubente declinare iste
deoasꝑa	deo asꝑa 
duradisponentesestuduitadgrauiorapararePreeuntegͦutrorumq	dura disponente se studuit ad grauiora parare Preeunte gͦ utrorumq
ducũinfractauirtuteinstituimurutsiobedientiepalmam	ducũ infracta uirtute instituimur ut si obedientie palmam
apprehend̃eueracit̃nitim᷑ꝓsꝑis	apprehend̃e ueracit̃ nitim᷑ ꝓsꝑis
h᷒scl̃iculualatronibuulñataꝑfidẽ	h᷒ scl̃i culu a latronib uulñata ꝑ fidẽ
trinitatxxiiiiinhocdeẜtoreꝑatuR	trinitat xxiiii in hoc deẜto reꝑatuR
Aliusẜmoeod̃dQUihabitat	Alius ẜmo eod̃ d QUi habitat
inadiutorioaltissiminꝓtectiõedeiceli	in adiutorio altissim in ꝓtectiõe dei celi
cõmorabiturInclinauitaltissim᷒	cõmorabiturInclinauit altissim᷒
celosetdescẽdit	celos et descẽdit
etadeodescẽditq̃dinsil̃itudinẽhoĩum	et adeo descẽdit q̃d in sil̃itudinẽ hoĩum
factusẽethabituinuẽtusuth̃oAdeodescẽdit	factus ẽ et habitu inuẽtus ut h̃o Adeo descẽdit
q̃dsubmanuẜuihũiliauitse	q̃d sub manu ẜui hũiliauit se
baptizandũuñetbaptistacõtremuitcũuid̃etsub	baptizandũ uñ et baptista cõtremuit cũ uid̃et sub
manibsuis	manib suis
inclinricaputtrem̃dũregibetpotestatibadrandũAdeohũiliauit	inclinri caput trem̃dũ regib et potestatib adrandũ Adeo hũiliauit
seutcũieiunassetesuriretaususẽadeũ	se ut cũ ieiunass et esuriret ausus ẽ ad eũ
acced̃etẽptatout	acced̃e tẽptatout
eisdẽiacul̃cofod̃etquibpͥmũhoĩemseuiuũetuuln͛atũ	eisdẽ iacul̃ cofod̃et quib pͥmũ hoĩem se uiuũ et uuln͛atũ
reliq̃ratsuictusẽt	reliq̃rat s uictus ẽ t
ptatoretuiciteũaltissim᷒Squoadiutorio	ptator et uicit eũ altissim᷒ S quo adiutorio
ususẽaltissimusuteũuinc͛et	usus ẽ altissimus ut eũ uinc͛et
neususadiutoriopotẽtiesueNequaPossenĩ	ne usus adiutorio potẽtie sue NequaPoss enĩ
statĩꝯtereresathanãsiuellet	statĩ ꝯterere sathanã si uellet
sumemoriammĩeignorat	su memoriam mĩe ignorat
xliiCeperuntaũaqueminuip᷒centũquinqͣginta	xlii Ceperunt aũ aque minui p᷒ centũ quinqͣginta
dies&requieuitarcha	dies & requieuit archa
suꝑmontesarmenieInepl̃aadysatium	suꝑ montes armenie In epl̃a ad ysatium
Seruataũitatehystorieqͥdẽaliudq̃ddiluuiitemporegen᷒	Seruata ũitate hystorie qͥd ẽ aliud q̃d diluuii tempore gen᷒
human᷒extͣarcham	human᷒ extͣ archam
morituraduitãuͦinarchaseruaturnͥhoc	moritur ad uitã uͦ in archa seruatur nͥ hoc
q̃dnc̃aꝑtecernimusquiainfidelesquosqextraeccl̃iam	q̃d nc̃ aꝑte cernimus quia in fideles quosq extra eccl̃iam
undapeccatisuiꝑimit&fidelessuosinfide&	unda peccati sui ꝑimit & fideles suos in fide &
caritatesc̃eeccl̃ieunitasqͣsiarcheconpagocustodit	caritate sc̃e eccl̃ie unitas qͣsi arche conpago custodit
Queuidelicetarchade	Que uidelicet archa de
lignisinputͥbilibcõpingit᷑	lignis inputͥbilib cõpingit᷑ 
defortibanimab&inbonosuoꝑseũantibARchain	de fortib animab & in bono suo ꝑseũantib ARcha in
quahoĩes	qua hoĩes
&reptilia	& reptilia
temporediluscameccl̃iamfigurauiti	tempore dilu scam eccl̃iam figurauit i
&maliꝯueniuntꝑmixtasitatefilioꝝsicom̃s	& mali ꝯueniunt ꝑmixta sitatefilioꝝ  sic om̃s
adfuttñ	ad f ut tñ
om̃sꝑinmutatõemutemspiritalisgr̃eculpisexig	om̃s ꝑ inmutatõem u tem spiritalis gr̃e culpis exig
ducatViamitaqsentisscgim᷒	ducat Viam itaq sentis sc gim᷒
tc̃aũdiscernem᷑cũacnerim᷒Boniuͦsisñ	tc̃ aũ discernem᷑ cũ ac nerim᷒ Boni uͦ si sñ
malisffectebonieẽñposs̃tmirgant᷑	malis f fecte boni eẽ ñ poss̃t  mir gant᷑
Ip̃aaũsocietasmalotio	Ip̃a aũ societas malo tio
ẽbonoꝝTResfilios	ẽ bonoꝝ TRes filios
noe⁊iaphetarchacontinuitsDominicaprima	noe ⁊ iaphet archa continuit s Dominica prima
inaduentudomini	in aduentu domini
capl̃mcuSuper	capl̃m cu Super
montemexcelsumascendequieuuangelizassyonexaltainfortitudine	montem excelsum ascende qui euuangelizas syon ex alta in fortitudine
uocemtuamquieuuangelyzashierusalemexaltanolitimeredic	uocem tuam qui euuangelyzas hierusalem ex alta noli timere dic
ciuitatibiudeeccedeusuesterEccedies	ciuitatib iude ecce deus uester Ecce dies
ueniuntdicitdominuset	ueniunt dicit dominus et
suscitabodauidgermeniustumetregnabitrexetsapienserit	suscitabo dauid germen iustum et regnabit rex et sapiens erit
etfacietiuditium	et faciet iuditium
etiustitiamin	et iustitiam in
terraethecestnomenquoduocabunteum	terra et hec est nomen quod uocabunt eum
dominusiustus	dominus iustus
nosterIndiebusillissaluabituriudaetisrahelhabitabit	noster In diebus illis saluabitur iuda et israhel habitabit
confidentesEthoc	confidentes Et hoc
estnomenymnus	est nomen ymnus
Conditoralmesyderumeternaluxcredentiumxpiste	Conditor alme syderum eterna lux credentium xpiste
redemptoromniumexaudicessupplicum	redemptor omnium exaudi ces supplicum
Quicondolensinteritumortis	Qui condolens interitu mortis
perireseculumsaluastimundum	perire seculum saluasti mundum
languidumdonansreisremediumVergentemundiuespereutisponsus	languidum donans reis remedium Vergente mundi uespere uti sponsus
dethalamoegressushonestissimauirginismatrisclausula	de thalamo egressus honestissima uirginis matris clausula
Cuiusforti	Cuius forti
potentiegenucuruanturomniacelestiaterrestrianutufatentur	potentie genu curuantur omnia celestia terrestria nutu fatentur
subditaOcasumsolcustodiens	subdita Ocasum sol custodiens
lunapalloremretinenscandorinastris	luna pallorem retinens candor in astris
relucenscertosobseruat	relucens certos obseruat
limitesTedeprecamuragyeuentureiudexseculiconseruanosin	limites Te deprecamur agye uenture iudex seculi conserua nos in
temporehostisateloperfidiLaus	tempore hostis a telo perfidi Laus
honoruirtus	honor uirtus
gloriadeopatriet	gloria deo patri et
filiounacumsanctospiritu	filio una cum sancto spiritu
insempiternaseculaamenHorateceli	in sempiterna secula amen Horate celi
desuperetnubespluantiustumaperiaturcertaetgerminet	desuper et nubes pluant iustum aperiatur certa et germinet
saluatoremIneug̃ãEcce	saluatorem In eug̃ ã Ecce
nomendominiuenitdelonIncipittercius	nomen domini uenit de lon Incipit tercius
liberFictilisintereauasisꝯpage	liber Fictilis interea uasis ꝯpage
solutacarc̃ecorporeocognatisreddit᷒astͥs	soluta carc̃e corporeo cognatis reddit᷒ astͥs
Illeolĩquiꝓpteropẽꝯtͣitala	Ille olĩ qui ꝓpter opẽ ꝯtͣ itala
regnaPetrũlegaratadrianusppͣꝑegitextremosin	regna Petrũ legarat adrianus ppͣ ꝑegit extremos in
pacediesm̃itiqꝓbaticlerusapl̃icafecitsede	pace dies m̃itiq ꝓbati clerus apl̃ica fecit sede
leonemcuisiinsublimiꝯstaretadorsiorerũAd	leonem cui si in sublimi ꝯstaret adorsio rerũ Ad
sacrũfueratfacil̃fortunacacumenSnonblanda	sacrũ fuerat facil̃ fortuna cacumen S non blanda
satisnͨadomnẽꝓsꝑacasũSic	satis nͨ ad omnẽ ꝓsꝑa casũ Sic
inmundanisabsqõiturbinerebnͨmeraleticia	in mundanis absq õi turbine reb nͨ mera leticia
ẽnͨletaoĩouoluptasPaxubinl̃la	ẽ nͨ leta oĩo uoluptas Pax ubi nl̃la
rataẽubigl̃ianl̃laquieta⁊nl̃lussecur᷒	rata ẽ ubi gl̃ia nl̃la quieta ⁊ nl̃lus secur᷒
honosexꝑtusinaltohocleoꝯscensuẽquitutior	honos exꝑtus in alto hoc leo ꝯscensu ẽ qui tutior
imatenebatHuncinequocũiãpõpamducendo	ima tenebat Hunc in equo cũ iã põpam ducendo
sed̃etAppetiitmanuũuiolentainiectiotͣctũNequit̃⁊sacrade	sed̃et Appetiit manuũ uiolenta iniectio tͣctũ Nequit̃ ⁊ sacra de
maiestatereuulsũQuẽ	maiestate reuulsũ Quẽ
predefunctipapeexcecare	predefuncti pape excecare
parentesExcitoꝯtraseducteturbineplebissumpserenͨex	parentes Excito ꝯtra seducte turbine plebis sumpsere nͨ ex
ocl̃isablata	ocl̃is ablata
luc̃naẽsc̃issimiꝯf̃dignat᷒ẽ	luc̃na ẽ sc̃issimi ꝯf̃ dignat᷒ ẽ
multamiracl̃aoꝑariꝓlog᷒CVmuetustatisincõmodonouercante	multa miracl̃a oꝑari ꝓlog᷒ CVm uetustatis in cõmodo nouercante
resferesingulasobsolericõtingatcumnouemleꝓsos	res fere singulas obsoleri cõtingat cum nouem leꝓsos
curationepotitosnõparumreosintellexerimus	curatione potitos nõ parum reos intellexerimus
quiad̃igloriam	quia d̃i gloriam
tacueruntcumdecimoreuertentedñmglorificantes	tacuerunt cum decimo reuertente dñm glorificantes
suꝑhisqueaudiuim᷒⁊uidim᷒queadñofacta	suꝑ his que audiuim᷒ ⁊ uidim᷒ que a dño facta
mirabiliafueruntinoccl̃isur̃isposteDcomitenr̃o	mirabilia fuerunt in occl̃is ur̃is poste D comite nr̃o
Richregeanglieuirouidelninenobilitatis	Rich rege anglie uiro uidel nine nobilitatis
noticuiinegregiaferitatesibicontemporaneũiconparandũ	noti cui in egregia feritate sibi contemporaneũ i conparandũ
ortasunmata⁊infames	orta sun mata ⁊ infames
continterhomineshuiusHacde	cont inter homines huius Hac de
causaquiadercessione⁊assignationeuersasꝑgerent	causa quia de r cessione ⁊ assignatione uersas ꝑgerent
conseꝑsonasQuidãenĩ	conse ꝑsonas Quidã enĩ
abanturioh̃emiamdtiregisfratremregem	a bantur ioh̃em iam d ti regis fratrem regem
siuid̃isnudũoꝑieũ⁊	si uid̃is nudũ oꝑi eũ ⁊
pauꝑẽ⁊absqtectoinducintab̃naculũ	pauꝑẽ ⁊ absq tecto induc in tab̃naculũ
tuumTuncerũpettemporanealuxtua⁊sanitates	tuum Tunc erũpet temporanea lux tua ⁊ sanitates
tuecitoorient᷑Hocqͦqq̃dscͥptumẽinLxx	tue cito orient᷑ Hoc qͦq q̃d scͥptum ẽ in Lxx
misitdebethel	misit de bethel
sarasar⁊ebeserrexnullusnr̃oꝝpotuitexponere	sarasar ⁊ ebeser rex nullus nr̃oꝝ potuit exponere
Neq.enĩq̃dmaleuersũẽexebreo	Neq. enĩ q̃d male uersũ ẽ ex ebreo
ullarationeexplanaripot̃Quisẽ	ulla ratione explanari pot̃ Quis ẽ
enĩistesarasar⁊ebeserrexautcui᷒ꝓuincie	enĩ iste sarasar ⁊ ebeser rex aut cui᷒ ꝓuincie
autinqua	aut in qua
ul̃dequamisitbethelautcui᷒bethel	ul̃ de qua misit bethel aut cui᷒ bethel
rexeẽpoteratebeserqueolim	rex eẽ poterat ebeser que olim
cũiudeafueratdestituta⁊	cũ iudea fuerat destituta ⁊
eotpr̃nequaquãuocabat᷑bethelid	eo tpr̃ nequaquã uocabat᷑ bethel id
ẽdom᷒dñisbetauen.i.dom᷒ydoliHoc	ẽ dom᷒ dñi s betauen .i. dom᷒ ydoli Hoc
qͦqq̃dseqͥringressaẽinm̃seqͥntosc̃ificatio	qͦq q̃d seqͥr ingressa ẽ in m̃se qͥnto sc̃ificatio
sic̃fecerantiamꝑmultosannos	sic̃ fecerant iam ꝑ multos annos
sicconant᷑exponeresc̃ificationẽingressã	sic conant᷑ exponere sc̃ificationẽ ingressã
uasatẽpliq̃anabucodonosorfuerantsublatainillo	uasa tẽpli q̃ a nabucodonosor fuerant sublata in illo
tpr̃restituta	tpr̃ restituta
Dequintiaut̃⁊septimi	De quinti aut̃ ⁊ septimi
ieiuniotemptauer̃referread	ieiunio temptauer̃ referre ad
diesebdomadisSseqͥrdecimiieiuniumcõpulsi	dies ebdomadis S  seqͥr decimi ieiunium cõpulsi
s̃tadm̃sesreferre⁊q̃dsitipsequinti⁊	s̃t ad m̃ses referre ⁊ q̃d sit ipse quinti ⁊
septimidecimũq	septimi decimũq
m̃sisieiuniũ	m̃sis ieiuniũ
omninosiluer̃utdeprioresim᷒explanationeꝯtenti	omnino siluer̃ ut de priore sim᷒ explanatione ꝯtenti
⁊ñindignem᷑adfalsoscommentantiũconatusqͥdeint̃pretationis	⁊ ñ indignem᷑ ad falsos commentantiũ conatus qͥ de int̃pretationis
erroreuener̃Etfactũ	errore uener̃ Et factũ
ẽu͛bumdñi	ẽ u͛bum dñi
adzachariãdicens	ad zachariã dicens
Hecdic̃	Hec dic̃
dñsexercituũdicensIudiciũiustũiudicate	dñs exercituũ dicens Iudiciũ iustũ iudicate
⁊miscdĩam&Sr̃cartã	⁊ miscdĩam & Sr̃ cartã
caritatiᷤAntequã	caritatiᷤ Antequã
abbatiecist̃cien.florereinciperent	abbatie cist̃cien. florere inciperent
domnusstephanusabbasetfr̃ssuiordinaueruntut	domnus stephanus abbas et fr̃s sui ordinauerunt ut
nullomͦabbatie	nullo mͦ abbatie
inalicui᷒antistitisdiocesifundarent᷑anteꝙͣ	in alicui᷒ antistitis diocesi fundarent᷑anteꝙͣ
ip̃edecretumintercisterciensecenobiũ⁊ceteraexeo	ip̃e decretum inter cisterciense cenobiũ ⁊ cetera ex eo
nataexaratũ	nata exaratũ
⁊confirmatũratumhabet	⁊ confirmatũ ratum habet
ꝓpterscandalũinterpontficẽ⁊monachosdeuitandũInhocgͦ	ꝓpter scandalũ inter pontficẽ ⁊ monachos deuitandũ In hoc gͦ
dec͛todictifr̃smutuepacisfutuꝝcauentesnaufragiũelucidaueruntet	dec͛to dicti fr̃s mutue pacis futuꝝ cauentes naufragiũ elucidauerunt et
statuer̃suisqposteris	statuer̃ suisq posteris
reliquer̃quopactoquouemͦimmoquacaritatemonachieoꝝ	reliquer̃ quo pacto quoue mͦ immo qua caritate monachi eoꝝ
ꝑabbatias	ꝑ abbatias
indiu͛sismundipartibcorporibdiuihomiñsubregularidisciplina	in diu͛sis mundi partib corporib diui homiñ sub regulari disciplina
ordinaueritnullãterrenecõmoditatisseureꝝtẽporaliũexactionẽimponimus	ordinauerit nullã terrene cõmoditatis seu reꝝ tẽporaliũ exactionẽ imponimus
Prodesseenĩill̃õibqsc̃eeccl̃iefiliiscupientesnil	Prodesse enĩ ill̃ õibq sc̃e eccl̃ie filiis cupientes nil
quodeosgrauetnilq̃deorũ	quod eos grauet nil q̃d eorũ
substantiãminuatergaeosag̃edisponim᷒nedũnoshabundãtes	substantiã minuat erga eos ag̃e disponim᷒ ne dũ nos habundãtes
deeoꝝpauꝑtateeẽcupim᷒auaricie	de eoꝝ pauꝑtate eẽ cupim᷒ auaricie
malũq̃d	malũ q̃d
scd̃mapl̃mydoloꝝseruituscomꝓbatureuitarenonpossim᷒Curã	scd̃m apl̃m ydoloꝝ seruitus comꝓbatur euitare non possim᷒ Curã
tñaĩaꝝilloꝝgr̃acaritatis	tñ aĩaꝝ illoꝝ gr̃a caritatis
retinereuolumus	retinere uolumus
utsiqnͦasc̃oꝓpositoet	ut si qnͦ a sc̃o ꝓposito et
obseruantiasc̃eregl̃edeclinareq̃dabsittẽptau͛ĩtꝑ	obseruantia sc̃e regl̃e declinare q̃d absit tẽptau͛ĩt ꝑ
nr̃amsollicitudinẽadrecINdominoconfidoquomodo	nr̃am sollicitudinẽ ad rec IN domino confido quomodo
animemeetransmigrainmosicutpasserQuoniam	anime mee transmigra in mo sicut passer Quoniam
eccepeccatoresintenarcumparaueruntsagittas	ecce peccatores inten arcum parauerunt sagittas
suretrautsagittentinobscuroreQuoniamqueꝑfecisti	su retra ut sagittent in obscuro re Quoniam que ꝑfecisti
destruxerustus	destruxeru stus
autemquidfecitDominus	autem quid fecit Dominus
intemplosanctosuo	in templo sancto suo
incelosedeseiusOculieiusinpauꝑemrespiciuntbre	in celo sedes eius Oculi eius in pauꝑem respiciunt bre
eiusinterrogãtfilioshomiDominusinterrogatiustum	eius interrogãt filios homi Dominus interrogat iustum
etquiautem	et qui autem
diligitiniquitateanimamsuamPluetsuꝑpeccatoreslaqueos	diligit iniquitate animam suam Pluet suꝑ peccatores laqueos
ierisdabotͥlicdimidiũregnimeiQͤ	i eris dabo tͥ lic dimidiũ regni mei Qͤ
c̃exissdix̃matͥsueQͥdpetãetilladix̃	c̃ exiss dix̃ matͥ sue Qͥd petã et illa dix̃
cap̃ioh̃isbabtiste	cap̃ ioh̃is babtiste
Cũqĩtͦiss	Cũq ĩtͦiss
statĩc̃festinatiõeaRegẽpetiũdicẽs	statĩ c̃ festinatiõe a Regẽ petiũ dicẽs
Uoloutꝓtin᷒desmͥ	Uolo ut ꝓtin᷒ des mͥ
ĩdiscocaputiohannisbabtisteEt	ĩ disco caput iohannis babtiste Et
ꝯtͥstatu᷒÷Rexꝓpt̃	ꝯtͥstatu᷒ ÷ Rex ꝓpt̃
i᷒iurãdũ⁊ꝓpt̃simulrecũbẽtesnoluiteãꝯtͥstareSmisso	i᷒iurãdũ ⁊ ꝓpt̃ simul recũbẽtes noluit eã ꝯtͥstare S misso
spiculatorecep̃	spiculatore cep̃
afferricap̃ei᷒ĩdiscoEtdecollaũeũĩcarc̃e	afferri cap̃ ei᷒ ĩ disco Et decollaũ eũ ĩ carc̃e
⁊adtulitcap̃ei᷒	⁊ adtulit cap̃ ei᷒
ĩdisco⁊	ĩ disco ⁊
deditillud	dedit illud
puelle⁊puelladeditMatͥsue	puelle ⁊ puella dedit Matͥ sue
Qͦauditodiᷤscipl̃iei᷒uener̃⁊tul̃ũtcorp᷒	Qͦ audito diᷤscipl̃i ei᷒ uener̃ ⁊ tul̃ũt corp᷒
ei᷒⁊posuer̃	ei᷒ ⁊ posuer̃
illd̃ĩ	illd̃ ĩ
monum̃toEtegͤss᷒÷ih̃s	monum̃to Et egͤss᷒ ÷ ih̃s
⁊discipl̃iei᷒ĩcastella	⁊ discipl̃i ei᷒ ĩ castella
cesareephilippi&ĩuiaĩt̃rogabatdiscipl̃oᷤsuoᷤdicẽseis	cesaree philippi & ĩ uia ĩt̃rogabat discipl̃oᷤ suoᷤ dicẽs eis
Qͤmmedicũthoĩneseẽ	Qͤm me dicũt hoĩnes eẽ
Qͥrespõd̃ũtillidicẽtes	Qͥ respõd̃ũt illi dicẽtes
ioh̃mbabtistãAliiheliã	ioh̃m babtistã Alii heliã
Aliiuͦqͣsiunũdeꝓph̃is	Alii uͦ qͣsi unũ de ꝓph̃is
Tc̃dic̃ill̃Vosuͦ	Tc̃ dic̃ ill̃ Vos uͦ
qͤmmedicitiᷤ	qͤm me dicitiᷤ
eẽRespõdẽsPetr᷒	eẽ Respõdẽs Petr᷒
aiteiTuesxp̃sEtꝯminat᷒÷eis	ait ei Tu es xp̃s Et ꝯminat᷒ ÷ eis
necͥdic̃ẽtd̃illo&ĩt̃rogabãt	ne cͥ dic̃ẽt d̃ illo & ĩt̃rogabãt
eũdicẽtesQͥd	eũ dicẽtes Qͥd
gͦdicũtpharisei⁊scͥbe	gͦ dicũt pharisei ⁊ scͥbe
qͥaheliãoꝑtpͥmũvenireQͥRespõdẽsaitill̃Helias	qͥa heliã oꝑt pͥmũ venire Qͥ Respõdẽs ait ill̃ Helias
c̃ueñitpͥmorestituetõia&qͦmͦ	c̃ ueñit pͥmo restituet õia & qͦmͦ
scͥptũ÷ĩfiliũhõiᷤũml̃tapaciat᷑	scͥptũ ÷ ĩ filiũ hõiᷤ ũ ml̃ta paciat᷑
⁊ꝯtẽpnat᷑Sdico	⁊ ꝯtẽpnat᷑ S dico
uob̃qͥa⁊helias	uob̃ qͥa ⁊ helias
veñ⁊fec̃ũtilli	veñ ⁊ fec̃ũt illi
q̃c̃quoluer̃sic̃scͥptũ÷deeo	q̃c̃q uoluer̃ sic̃ scͥptũ ÷ de eo
Explicith̃scͥpsitBarmari᷒	Explicit h̃ scͥpsit B armari᷒
ãnoMͦCCͦXIIIͦint̃dũ⁊	ãno MͦCCͦXIIIͦ int̃dũ ⁊
forteꝗasanitasul̃infirmitas	forte ꝗa sanitas ul̃ infirmitas
cõporisconsistitinquattuor⁊aĩeintͥb	cõporis consistit in quattuor ⁊ aĩe in tͥb
utpredixim᷒Iñẽquodstola	ut predixim᷒ Iñ ẽ quod stola
corpõisdr̃dfut᷑ainquattuorꝓpͥetatibcorpõis	corpõis dr̃d fut᷑a in quattuor ꝓpͥetatib corpõis
gl̃ificati⁊stolaaĩepͥncipalit̃intͥbErũtenĩquattuor	gl̃ificati ⁊ stola aĩe pͥncipalit̃ in tͥb Erũt enĩ quattuor
principalesdotescorpõisgl̃ificatis.subtilitas	principales dotes corpõis gl̃ificati s. subtilitas
⁊agilitas	⁊ agilitas
splendor⁊impassibilitasiux̃illd̃ĩlibro	splendor ⁊ impassibilitas iux̃ illd̃ ĩ libro
sap̃iefulgebũtiusti	sap̃ie fulgebũt iusti
sic̃sol	sic̃ sol
ĩregͦpa.m̃i⁊tãꝙͣscin.	ĩ regͦ pa. m̃i ⁊ tãꝙͣ scin.
ĩa.di.fulgeb̃tꝑsplẽdorẽsic̃solꝑĩmu	ĩ a. di. fulgeb̃t ꝑ splẽdorẽ sic̃ sol ꝑ ĩmu
tabilitatemadueritatẽsiueĩpassibilitatẽ	tabilitatem ad ueritatẽ siue ĩpassibilitatẽ 
solĩsuanat᷑aẽĩmutabilis⁊	sol ĩ sua nat᷑a ẽ ĩmutabilis ⁊
ĩpassibil̃taꝙͣscĩtilleꝑsubtilitatẽ	ĩpassibil̃ taꝙͣ scĩtille ꝑ subtilitatẽ
discũrẽtꝑagilitatẽHasqͣttuoͬꝓͥetatesgl̃ificaticoͬꝑisĩ	discũrẽt ꝑ agilitatẽ Has qͣttuoͬ ꝓͥetates gl̃ificati coͬꝑis ĩ
argum̃tatiõefut᷑egl̃ificatiõis⁊̃ĩcaͬnemoͬtalixᷤost̃ndit	argum̃tatiõe fut᷑e gl̃ificatiõis ⁊̃ ĩ caͬne moͬtali xᷤ ost̃ndit
claritatẽqñsetͣnsfiguraũĩmõte	claritatẽ qñ se tͣnsfiguraũ ĩ mõte
⁊resplẽuntfaciesei᷒	⁊ resplẽunt facies ei᷒
sic̃solSubtilitatẽqñclausosigͣcl̃ouirginalitãꝙͣ	sic̃ sol Subtilitatẽ qñ clauso sigͣcl̃o uirginali tãꝙͣ
spõsusꝓcessitdetha.suoAgilitatẽsiue	spõsus ꝓcessit de tha. suo Agilitatẽ siue
leuitatẽqñaliãlitt̃amubinoshabem᷒quismundũ	leuitatẽ qñ aliã litt̃am ubi nos habem᷒ quis mundũ
deinmundoconceptũinfans	de inmundo conceptũ infans
uniusdieiẽsinepecc̃o⁊pm᷒naturafilii	unius diei ẽ sine pecc̃o ⁊ p m᷒ natura filii
ireabhac	ire ab hac
tñquipͥuilegiati	tñ qui pͥuilegiati
fuer̃mũdatiañnatinut̃is	fuer̃ mũdati añ nat in ut̃is
matrũutIer	matrũ ut Ier
emias⁊Ioannesquiexut̃o	emias ⁊ Io annes qui ex ut̃o
matrisQuoꝝ	matris Quoꝝ
utͥocPͥusquãteformarẽ	utͥ oc Pͥus quã te formarẽ
inut̃onouexires	in ut̃o nou exires
d̃ũntresc̃ificauitequod⁊̃tendũtdeiacob⁊	d̃ ũntre sc̃ificaui te quod ⁊̃ tendũt de iacob ⁊
b̃atauͥgineqhabeat᷑exssumVenialepecca	b̃ata uͥgine q habeat᷑ exssum Veniale pecca
adillicitacitraconsensũratõiseẽnõpossumusꝗa	ad illicita citra consensũ ratõis eẽ nõ possumus ꝗa
semꝑIebuseint̃ranr̃aquenob̃spinas	semꝑ Iebuse in t̃ra nr̃a que nob̃ spinas
⁊tͥbunitg͛minared̃hocaitb̃atusioannes	⁊ tͥbu nit g͛minare d̃ hoc ait b̃atus io annes
Sidix̃imusquodpeccatũñh̃emseducim᷒⁊	Si dix̃imus quod peccatũ ñ h̃em se ducim᷒ ⁊
ũitasinnob̃ñẽ	ũitas in nob̃ ñ ẽ
MorInepistolis	Mor In epistolis
beatipauliapostoliPRIMUMQUERITURquareposteugl̃iaque	beati pauli apostoli PRIMUM QUERITUR quare post eugl̃ia que
supplementũlegissunt⁊inquib᷒nobisexempla⁊cepta	supplementũ legis sunt ⁊ in quib᷒ nobis exempla ⁊ cepta
uiuendiplenissime	uiuendi plenissime
digestasuntuolueritapl̃s	digesta sunt uoluerit apl̃s
hasepl̃asadsingulasęccl̃asdestinareHacaut̃	has epl̃as ad singulas ęccl̃as destinare Hac aut̃
causauidet᷑factũScilicetutinicio	causa uidet᷑ factũ Scilicet ut inicio
nascentisęccl̃ęnouiscausisexistentib	nascentis ęccl̃ę nouis causis existentib
&sentia⁊mienciaresequaretuicia⁊utpost	& sentia ⁊ miencia resequaret uicia ⁊ ut post
futurasexcluder&questionesexemploꝓphetarũ	futuras excluder& questiones exemplo ꝓphetarũ
qͥposteditã	qͥ post editã
legẽmoysiinquaõiadeimandatalegebant᷑nichilomin᷒	legẽ moysi in qua õia dei mandata legebant᷑ nichilomin᷒
dedoctrinasuarediuiuasemꝑppl̃iconpresserepeccata	de doctrina sua rediuiua semꝑ ppl̃i conpressere peccata
tͣnsmigrationẽierl̃minmenseqͥntor̃Istisuntdiesquos	tͣnsmigrationẽ ierl̃m in mense qͥnto r̃ Isti sunt dies quos
obseruaredebetistemꝑibussuisqͣrtadecimadieaduesꝑmpascha	obseruare debetis temꝑibus suis qͣrtadecima die ad uesꝑm pascha
dñiẽ̃ĩqͥntadecima	dñi ẽ ̃ ĩ qͥntadecima
sollempnitatẽcelebrabitisaltissimo	sollempnitatẽ celebrabitis altissimo
dñoũLoquutusẽdñsadmoysendicensloquere	dño ũ Loquutus ẽ dñs ad moysen dicens loquere
filiisisr̃ldicesadeosQͣrtal̃scd̃a	filiis isr̃l  dices ad eos Qͣrta l̃ scd̃a
Etfc̃mẽũbumdominiadmedicensPriusꝙͣ	Et fc̃m ẽ ũbum domini ad me dicens Priusꝙͣ
teformareminuteronouite	te formarem in utero noui te 
anteꝙͣexiresdeuuluasanctificaui	anteꝙͣ exires de uulua sanctificaui
teꝓph̃am	te  ꝓph̃am
ingentibdediteEtdixi	in gentib dedi te Et dixi
a.a.a.dñe	a. a. a. dñe
deusEccenescio	deus Ecce nescio
loquipueregosumr̃Multiplicatisuntqui	loqui  puer ego sum r̃ Multiplicati sunt qui
tͥbulantmedicuntñ	tͥbulant me  dicunt ñ
ẽsalusip̃iindeoer̃	ẽ salus ip̃i in deo er̃
Exurgedñesaluuᷤ	Exurge dñe saluuᷤ
mefacdeusm̃uᷤQuitͥbulant	me fac deus m̃uᷤ Qui tͥbulant
meexultabunt	me exultabunt
simot᷒fueroegoaut̃ĩmĩatuasꝑaui	si mot᷒ fuero ego aut̃ ĩ mĩa tua sꝑaui
Etdix̃dominusadmeNoli	Et dix̃ dominus ad me Noli
dic̃epuersũl̃	dic̃e  puer sũ l̃
IIIͣExurge	IIIͣ Exurge
qm̃adõia	qm̃ ad õia
quemittamteibisuniũsaq̃cumqmandauero	que mittam te ibis  uniũsa q̃cumq mandauero
tͥloquerisNe	tͥ loqueris Ne
timeasafacieeoꝝtecum	timeas a facie eoꝝ  tecum
egosumut	ego sum ut
eruamte	eruam te
dicitdic̃	dicit dic̃
dominusEtmisitdominusmanũ	dominus Et misit dominus manũ
suamtetigit	suam  tetigit
osmeumr̃Quicustodiebantaĩammeamꝯsiliũfecer̃t	os meum r̃ Qui custodiebant aĩam meam ꝯsiliũ fecer̃t
ĩunumdicentes	ĩ unum dicentes
D̃sdereliqͥteum	D̃s dereliqͥt eum
ꝑseqͥminiꝯhenditeeum	ꝑseqͥmini  ꝯhendite eum 
ñẽqͥliberet	ñ ẽ qͥ liberet
eumdeusm̃sneelongesa	eum deus m̃s ne elonges a
medeusm̃sĩadiutoriũmeumĩtendeũ	me deus m̃s ĩ adiutoriũ meum ĩtende ũ
Omnesinimicimei	Omnes inimici mei
adũsumme	adũsum me
dicentesD̃sl̃iiiiͣEt	dicentes D̃s l̃ iiiiͣ Et
dix̃dominusadmeEccedediũba	dix̃ dominus ad me Ecce dedi ũba
meainore	mea in ore
tuoecceconstituitehodiesuꝑgentes	tuo ecce constitui te hodie suꝑ gentes
egyptumetestoibiusqdũdicamtͥ	egyptum et esto ibi usq dũ dicam tͥ
Futurumẽenimut	Futurum ẽ enim ut
herodesqueratpuerũadꝑdendũeumQuiconsurgensaccepit	herodes querat puerũ ad ꝑdendũ eum Qui consurgens accepit
puerũ⁊matremei᷒nocteetsecessit	puerũ ⁊ matrem ei᷒ nocte et secessit
inegiptũEt	in egiptũ Et
eratibiusqadobitum	erat ibi usq ad obitum
herodisutadimpleret᷑q̃ddictũẽadñoꝑꝓph̃am	herodis ut adimpleret᷑ q̃d dictũ ẽ a dño ꝑ ꝓph̃am
dicentẽExegiptouocaui	dicentẽ Ex egipto uocaui
filiũmeumTuncherodesuidensqm̃illususeẽt	filiũ meum Tunc herodes uidens qm̃ illusus eẽt
amagisiratusestualdeEtmittensocciditom̃spueros	a magis iratus est ualde Et mittens occidit om̃s pueros
qͥerantinbethleem⁊inom̃ibfinib	qͥ erant in bethleem ⁊ in om̃ib finib
ei᷒abimatu⁊infrascd̃m	ei᷒ ab imatu ⁊ infra scd̃m
tempusq̃dexquisieratamagisTuncadimpletum	tempus q̃d exquisierat a magis Tunc adimpletum
ẽquoddictumẽ	ẽ quod dictum ẽ
ꝑieremiamꝓph̃amdicentemVox	ꝑ ieremiam ꝓph̃am dicentem Vox
inramaauditaẽploratus⁊ululatusmultusrachel	in rama audita ẽ ploratus ⁊ ululatus multus rachel
ploransfiliossuosEt	plorans filios suos Et
noluitconsolariquianonsunt.coll̃	noluit consolari quia non sunt . coll̃
DeuscuiushodiernaIn	Deus cuius hodierna In
l̃aHerodesiratusocciditmultos	l̃ a Herodes iratus occidit multos
puerosinbethleem	pueros in bethleem
iudeciuitatedauidcap̃Uidisupͣmontẽ	iude ciuitate dauid cap̃ Uidi supͣ montẽ
syonagnumstantẽ	syon agnum stantẽ
etcũeocentumquadragintaqͣtuormiliahabentes	et cũ eo centum quadraginta qͣtuor milia habentes
nomeneius	nomen eius
etnom̃patͥseius	et nom̃ patͥs eius
scriptũinfrontib	scriptũ in frontib
suisr̃ExultentiustiũIustiinꝑpetuumAdbñ	suis r̃ Exultent iusti ũ Iusti in ꝑpetuum Ad bñ
aHisunt	a Hi sunt
quicũmulieribñsuntcoinquinati	qui cũ mulierib ñ sunt coinquinati
uͥginesenĩs̃t⁊secunt᷑agnũ	uͥgines enĩ s̃t ⁊ secunt᷑ agnũ
qͦcũqieritcoll̃utsupͣAd	qͦcũq ierit coll̃ ut supͣ Ad
iͣaAngl̃ieorũsemꝑuidentfaciempatris	iͣ a Angl̃i eorũ semꝑ uident faciem patris
AdiiiͣaVoxinramaauditaẽplorat᷒⁊	Ad iiiͣ a Vox in rama audita ẽ plorat᷒ ⁊
ululat᷒rachelplorans	ululat᷒ rachel plorans
filiossuoscap	filios suos cap
*⁊coll*	* ⁊ coll *
sicutinl	sicut in l
*AdviͣaSubth	* Ad viͣ a Sub t h
ronod̃isc̃iclamabantuindicasanguinẽ	rono d̃i sc̃i clamabant uindica sanguinẽ
nr̃md̃snr̃	nr̃m d̃s nr̃
capitulumHii	capitulum Hii
suntquicũmulieribñ	sunt qui cũ mulierib ñ
suntcoinquinatiuirginesenĩsunthi	sunt coinquinati uirgines enĩ sunt hi
secunt᷑agnũqͦcũq	secunt᷑ agnũ qͦcũq
ierituoĩfeudumñsuccedatnisipriusddomino	ierit uo ĩ feudum ñ succedat nisi prius d domino
sat̃fec̃itp̃rimodoꝓõib.idomesticis	sat̃fec̃it p̃ri modo ꝓ õib. i domesticis
suishocfaciatIlludquocipimusut	suis hoc faciat Illud quo cipimus ut
siuassallus	si uassallus
defeudosuoaliumuassallũh̃ũitetuassalusuassalli	de feudo suo alium uassallũ h̃ũit et uassalus uassalli
dñmdñi	dñm dñi
suioffẽd̃itnisiꝓ	sui offẽd̃it nisi ꝓ
ẜuitõalt̃iusdominisuih̃fec̃itq̃msñ	ẜuitõ alt̃ius domini sui h̃ fec̃it q̃m sñ
fraudeañah̃ũitfeudosuoppriuetur	fraude aña h̃ũit feudo suo p priuetur
⁊addñm	⁊ ad dñm
suũaquoip̃etenebat	suũ a quo ip̃e tenebat
reũtaturnisirequisitusabeopactus	reũtatur nisi requisitus ab eo pactus
fũitsat̃fac̃e	fũit sat̃fac̃e
maioridñoꝙ̃offendit	maiori dño ꝙ̃ offendit
⁊nisiuassallusid̃asuo	⁊ nisi uassallus id̃ a suo
dominorequisituseũqui	domino requisitus eũ qui
maiorẽdominũ	maiorẽ dominũ
offenditrequisierit	offendit requisierit
utsatisfaciatsuumfeudũamittatt̃ea	ut satis faciat suum feudũ amittat t̃ea
sidefeudoint̃	si de feudo int̃
duosuassallossitꝯtroũsia	duos uassallos sit ꝯtroũsia
dominisitꝯgnitõ⁊pereum	domini sit ꝯgnitõ ⁊ per eum
ꝯtroũsiat̃mineturSiuõĩt̃dñmetuassallũlis	ꝯtroũsia t̃minetur Si uõ ĩt̃ dñm et uassallũ lis
oriat᷑ꝑpares	oriat᷑ ꝑ pares
curieaddomĩos̃o	curie a d domĩo s̃o
debitofidelitatisꝯiuraitos	debito fidelitatis ꝯiuraitos
t̃mineturIlludquos̃cimuᷤutin	t̃minetur Illud quo s̃cimuᷤ ut in
omnisac̃m̃to	omni sac̃m̃to
fidelitatisnominatiminmperatorexcipiaturExplicitliber	fidelitatis nominatim inmperator excipiatur Explicit liber
autenticorumExplicit	autenticorum Explicit
lib̃autenticorumvidebr̃siñfastidio	lib̃ autenticorum videbr̃ siñ fastidio
amabr̃siñ	amabr̃ siñ
fatigatõelaudabr̃hocmun᷒ceterumquifuturisuntꝓ	fatigatõe laudabr̃ hoc mun᷒ ceterum qui futuri sunt ꝓ
m̃itismiorum⁊grado	m̃itis miorum ⁊ grado
bonorũatqgl̃iarumquisest	bonorũ atq gl̃iarum quis est
ydo᷒cogitareqͣntomag̃	ydo᷒ cogitare qͣnto mag̃
dic̃etm̃	dic̃e  tm̃
fut᷑umsint	fut᷑um sint
ñẽãbigend̃atqita⁊̃bt̃a	ñ ẽ ãbigend̃ atq ita ⁊̃ bt̃a
illaciuitasmagnuminsedonumuidebit	illa ciuitas magnum in se donum uidebit
q̃dnullisuperiorinullusinf̃iorinuidebitsic̃ñĩuidẽt	q̃d nulli superiori nullus inf̃ior inuidebit sic̃ ñ ĩuidẽt
archãgl̃isãgl̃icet̃iTamnolleteẽun᷒ꝗsqq̃dñaccepit	archãgl̃is ãgl̃i cet̃i Tam nollet eẽ un᷒ꝗsq q̃d ñ accepit
qͣmuissitpacatissimo	qͣmuis sit pacatissimo
uinculocõcordieeiquiaccep̃obstrictusqͣmnecĩcorꝑe	uinculo cõcordie ei qui accep̃ obstrictus qͣm nec ĩ corꝑe
uultoculius	uult ocul i u s
eẽquiẽdigitus	eẽ qui ẽ digitus
cummebrumutr̃qcontineattocipartispaccatacompagosicitaq	cum mebrum utr̃q contineat toci partispaccata compago sic itaq
habebitdonũalialiominuthocqͦdonũ	habebit donũ ali alio min ut hoc qͦ donũ
h̃atneul̃it	h̃at ne ul̃it
ampliusviciapersapientiedoctͥnaalit̃ꝑinsipiẽtispessimamuitã	amplius vicia per sapientie doctͥna alit̃ ꝑ insipiẽtis pessimam uitã
ita⁊obliuiones	ita ⁊ obliuiones
maloꝝdue	maloꝝ due
s̃tAlr̃eanamqobliuiscitureruditus⁊doctusAlit̃expert	s̃t Alr̃ ea namq obliuiscitur eruditus ⁊ doctus Alit̃ expert
⁊passIllesi	⁊ pass Ille si
periciamnegligatistesimiseriacareat.Scd̃mhãc	periciam negligat iste si miseria careat . Scd̃m hãc
obliuiõequãpost̃iorelocoposuinõeruntmemoressc̃i	obliuiõe quã post̃iore loco posui nõ erunt memores sc̃i
preteritorummaloꝝCarebũt	preteritorum maloꝝ Carebũt
eĩom̃ib.itautpenitdeleatureorumsensibusEt	eĩ om̃ib. ita ut penit deleatur eorum sensibus Et
tm̃potẽtiascĩe	tm̃ potẽtia scĩe
q̃m̃gñĩeiseritñsolũ	q̃ m̃gñ ĩ eis erit ñ solũ
suat̃itas⁊̃dãpñtoꝝ	sua t̃ita s ⁊̃ dãpñtoꝝ
eossẽpit̃ñmiẜiañlateb̃ĩuocabim⁊uidebim᷒⁊am̃bim᷒	eos sẽpit̃ñ miẜia ñ lateb̃ ĩuocabim ⁊ uidebim᷒ ⁊ am̃bim᷒
am̃bim᷒⁊laudabim᷒	am̃bim᷒ ⁊ laudabim᷒
Ecceꝙer̃ĩfĩesũfineExplicitHũc	Ecce ꝙ er̃ ĩ fĩe sũ fine Explicit Hũc
libꝝfec̃scͥbidñs	libꝝ fec̃ scͥbi dñs
Bdecastãetod̃i	B de castãeto d̃i
gr̃aep̃salbieñ	gr̃a ep̃s albieñ
annodñi	anno dñi
mͦcccͦorganiciineodẽinstãti	mͦ cccͦ organici in eodẽ instãti
inquodesunteẽtalisꝑsdesinitibiesseaĩa	in quo desunt eẽ talis ꝑs desinit ibi esse aĩa
necsequit᷑p̃phocq̃dinedem	nec sequit᷑ p̃p hoc q̃d in edem
instãtiibi	instãti ibi
sitnõsitnecĩ	sit  nõ sit  nec ĩ
imoĩstãtipesuelmanusestꝑs	imo ĩstãti pes uel manus est ꝑs
ul̃nõꝑs	ul̃ nõ ꝑs
ip̃iuscorꝑisutrumãima	ip̃ius corꝑis utrum ãima
sitsimpliciorom̃ibaliisformisSEcundoquerit᷑utrumaĩa	sit simplicior om̃ib aliis formis SEcundo querit᷑ utrum aĩa
sitsimplicõrom̃ibaliisformis	sit simplicõr om̃ib aliis formis
videt᷑q̃dnõformaque	 videt᷑ q̃d nõ  forma que
estpluribmodiscõpoĩtaqͣmalieest	est  plurib modis cõpoĩta qͣm alie est
ꝯpositõriillissaĩahũanacõpoĩta	ꝯpositõr i illis s aĩa hũana cõpoĩta
estexeẽeẽnciaformeaut̃emq̃educit᷑de	est ex eẽ  eẽncia forme aut̃em q̃ educit᷑ de
potẽciamat͛ieñsũtexeẽeẽnͣꝯpoĩte	potẽcia mat͛ie ñ sũt ex eẽ  eẽnͣ ꝯpoĩte
cũeisnõ	cũ eis nõ
ꝯpetateẽgͦaĩaest	ꝯpetat eẽ gͦ aĩa est
cõpoĩcõreis	cõpoĩcõr eis
Pͣeẽunũcõpoĩci᷒aliodicitqdd	Pͣ eẽ unũ cõpoĩci᷒ alio dicit qdd
qͦsdamgͣdussnulli	qͦsdam gͣdus s nulli
forͤsb̃alicõpetith̃regradusẜmeẽmͣcũquelibtalis	forͤ sb̃ali cõpetit h̃re gradus ẜm eẽmͣ cũ quelib talis
simplici	simplici 
ĩuariabl̃ieẽnͣcõsistatnec	ĩuariabl̃i eẽnͣ cõsistat nec
ẜmeẽq̃dh̃tinsb̃ocũsb̃m	ẜm eẽ q̃d h̃t in sb̃o cũ sb̃m
formesb̃alis	forme sb̃alis
sitip̃mylegͦsaltẽformissb̃alib	sit ip̃m yle gͦ saltẽ formis sb̃alib
aĩaip̃anõeritsimplicõrpͣ	aĩa ip̃a nõ erit simplicõr pͣ
forͣillaq̃pot̃	forͣ illa q̃ pot̃
dicihocaliqͥdẽcõpoĩtõrillaq̃	dici hoc aliqͥd ẽ cõpoĩtõr illa q̃
hocaͥddicinõpot̃s	hoc aͥd dici nõ pot̃ s
aĩahũanasinecorꝑepot̃dicihocaͥdcũ	aĩa hũana sine corꝑe pot̃ dici hoc aͥd cũ
sitĩdiduũingen͛esb̃egͦ	sit ĩdiduũ in gen͛e sb̃e gͦ
eritcõpoĩtõraliisformisquibind̃iduatõ	erit cõpoĩtõr aliis formis quib ind̃iduatõ
sinemͣuelcorꝑenõ	sine mͣ uel corꝑe nõ
tingitꝯͣriũestaug̃VI	tingit ꝯͣriũ est aug̃ VI
detͥni.caͦVIuͥdicit	de tͥni. caͦ VI uͥ dicit
q̃dcreaturasp̃ualissic̃	q̃d creatura sp̃ualis sic̃
estaĩaincõrꝑatõequidẽcorꝑissimplicõrẽ	est aĩa in cõ r ꝑatõe quidẽ corꝑis simplicõr ẽ
licetĩcõꝑatõedeisitmultiplexquelalia	licet ĩ cõꝑatõe dei sit multiplex   quel alia
formapotestdicicorꝑaliscũmolecorꝑisdiffundat᷑Id̃o	forma potest dici corꝑalis cũ mole corꝑis diffundat᷑ Id̃o
sequit᷑q̃daĩaaliisformissitsimplicõrR̃nsiodd̃q̃d	sequit᷑ q̃d aĩa aliis formis sit simplicõr R̃nsio dd̃q̃d
triasũtillaqueadsimplicitaterequirũt᷑	tria sũt illa que ad simplicitate requirũt᷑
pͥmũ̃	pͥmũ ̃
ĩd̃isibl̃itaqua·H·lib̃tatep᷒s̃talioscorriꝑedũtacite	ĩd̃isibl̃ita qua ·H· lib̃tate p᷒s̃t alios corriꝑe dũ tacite
sibir̃ndentseead̃corrigũtꝯmissiseqm̃	sibi r̃ndent se ead̃ corrigũt ꝯmissise qm̃
ñpͭhortator	ñ pͭ hortator
eẽuiduitatisqͥꝯiugiaf	eẽ uiduitatis qͥ ꝯiugia f
taũitIneuãg̃qͦꝓbat᷑eũqͥ	taũit In euãg̃ qͦ ꝓbat᷑ eũ qͥ
tͣbẽgestatĩocl̃o	tͣbẽ gestat ĩ ocl̃o
suoñp᷒sefeseduc̃deocl̃ofr̃issuiIt̃	suo ñ p᷒se fes educ̃ de ocl̃o fr̃is sui It̃
d̃dpcc̃oriãdixͭde᷒qr̃tuenar.i᷒ticias	d̃d pcc̃ori ã dixͭ de᷒ qr̃ tu enar. i᷒ticias
etassũistest̃ͫm.ꝑostuũEt	et assũis test̃ͫ m. ꝑ os tuũ Et
ẜgg̃ͫc᷒uitadespic᷑ꝯre	ẜ gg̃ͫ c᷒ uita despic᷑ ꝯ re
statutdicatõꝯdẽpnet᷑	stat ut dicatõ ꝯdẽpnet᷑
hĩcẽeĩꝙ	hĩc ẽ eĩ ꝙ
ysaiasadñoaddicand̃mittend᷒pͥ᷒abtate	ysaias a dño ad dicand̃ mittend᷒ pͥ᷒ ab tate
mũda᷑etose᷒calcl̃otãgi᷑qͥforcipetolli᷑de	mũda᷑ et os e᷒ calcl̃o tãgi᷑ qͥ forcipe tolli᷑ de
altaripri᷒gͥdebsac̃doteserratasua	altari pri᷒ gͥ deb sac̃dotes errata sua
corrig̃ep᷒moͫadalienadiluendafestĩarNã	corrig̃e  p᷒moͫ ad aliena diluenda festĩar Nã
gall᷒pͥ᷒seipͫalaꝝũb̃ecorripitdeiñ	 gall᷒ pͥ᷒ se ipͫ alaꝝ ũb̃e corripit  deiñ
adhorascinendasceditsac̃dotes·H·pler̃exemͦsue	ad horas cinendas cedit sac̃dotes  ·H· pler̃ exemͦ sue
passiõisaccendũtqͦss̃uitdoctͥnediuti᷒ꝯfͬmareñ	passiõis accendũt qͦs s̃uit doctͥne diuti᷒ ꝯfͬmare ñ
p᷒s̃tetuitadisciplinisñeruditaexẽpreligiõisde	p᷒s̃t et uita disciplinis ñ erudita exẽp religiõis de
sepr̃arenescͭq̃ĩseip̃aexꝑimẽto	se pr̃are nescͭ q̃ ĩ se ip̃a exꝑimẽto
ñdidicͭUtguitaꝯũsaͦur̃airrehẽsibl̃is	ñ didicͭ Ut g uita  ꝯũsaͦ ur̃a irrehẽsibl̃is
appareatcet͛isluceatꝑplũexpedituͭsitiuxͣ	appareat  cet͛is luceat ꝑ plũ expedit uͭ sit iuxͣ
eccͣmcella	eccͣm cella
ur̃anl̃lusur̃marmal̃glaadferiend̃feratnͥ	ur̃a nl̃lus ur̃m arma l̃ gla ad feriend̃ ferat nͥ
fortetpr̃guerrel̃exꝓbabl̃ic̃atimornl̃l᷒	forte tpr̃ guerre l̃ ex ꝓbabl̃i c̃a timor nl̃l᷒
comãnutͥatne	comã nutͥat ne
barbãetun᷒qͥscoronãtõsurãhꝯgͧentesquas	barbã et un᷒qͥs coronã  tõsurã h ꝯgͧentes quas
̃ꝯiugatiñbigamipͥuilegio	̃ ꝯiugati ñ bigami pͥuilegio
cl̃icaliguaud̃etespubliceportentnl̃lusautcanũ	cl̃icali guaud̃e tes publice portent nl̃lus aut canũ
autauiũiocisĩs͛uiatnl̃lutatibcrapulis.i.	aut auiũ iocis ĩs͛uiat nl̃lu tatib crapulis .i.
gulositatibuslitibscurrilitatib᷒ꝑcussiõib᷒etblasfemiisunull᷒spͨtacl̃isaliqͥb	gulositatibus litib scurrilitatib᷒ ꝑcussiõib᷒ et blasfemiis u null᷒ spͨtacl̃is aliqͥb
q̃autĩnuptiis	q̃ aut ĩ nuptiis
autĩcenisfũitexhĩtersitspõpasscl̃i	aut ĩ cenis fũit exh ĩtersit s põpas scl̃i
ꝯuiuianotapucafugiatpͥuatauͦñpudicas	 ꝯuiuia nota puca fugiat pͥuata uͦ ñ pudica s
⁊sobriacolatUn᷒qͥs	⁊ sobria colat Un᷒qͥs
ur̃mdolos	ur̃m dolos
ꝯiuratõescodiũeml̃atõesobtͤctatõesatĩuidiã	 ꝯiuratões c odiũ eml̃atões obtͤctatões at ĩuidiã
effugiatñ	effugiat ñ
uagisoceffͤnatalĩguaaut	uagis oc effͤnata lĩgua aut
petulãtifluidoqĩgestuĩcedatspuac	petulãti fluidoq ĩ gestu ĩcedat s pu ac
ueꝯdiãmẽtissĩplici	ueꝯdiã mẽtis sĩplici
h̃ituĩcessuqost̃ndatobscenitatẽboꝝmẽbroꝝsic̃	h̃itu ĩcessuq ost̃ndat obscenitatẽ boꝝ  mẽbroꝝ sic̃ 
operũpẽit᷒execret᷑senioribdebit	operũ pẽit᷒ execret᷑ seniorib debit
atob̃iamn	at ob̃iam n
ulloiactãciestudioseipͫattollatbonismostudeat	ullo iactãcie studio se ipͫ attollat bonis mo studeat
abõibillicitiscoraclĩguãcorp᷒	 ab õib illicitis cor ac lĩguã  corp᷒
adeot̃reꝯsõis·H·	adeo t̃re ꝯs õis ·H·
iactãciaatĩmod̃atõabõis÷	iactãcia at ĩmod̃atõ a bõis ÷
moribalienanull᷒ꝑ	morib aliena null᷒ ꝑ
q̃dꝓuocem᷑adhũilitatemexemplosueconũsatõisꝑq̃dĩformem᷑	q̃d ꝓuocem᷑ ad hũilitatem exemplo sue conũsatõis ꝑ q̃d ĩformem᷑
adsc̃itatẽEtmemoriapassionisꝑq̃dincitemurad	ad sc̃itatẽ Et memoria passionis ꝑ q̃d incitemur ad
karitatẽQͣrtoscribiturinhoctemplo	karitatẽ Qͣrto scribitur in hoc templo
cordissp̃ualealphabetũsiuesp̃ualisscripturaHecã	cordis sp̃uale alphabetũ siue sp̃ualis scriptura Hec ã
scͥpturaq̃ibiscͥbiturtriplex	scͥptura q̃ ibi scͥbitur triplex
ests.dictamĩafaciendoꝝtestiõa	est s. dictamĩa faciendoꝝ testiõa
diuinoꝝbñficioꝝꝓpͥoꝝacc̃atõdelictoꝝDehiistribusRII	diuinoꝝ bñficioꝝ ꝓpͥoꝝ acc̃atõ delictoꝝ De hiis tribus R II
CIIGentesquelegẽnõ	C II Gentes que legẽ nõ
h̃ntnaturalr̃quelegissuntfaciunthi᷒	h̃nt naturalr̃ que legis sunt faciunt hi᷒
legemnõ	legem nõ
habentesipisibisuntlexquiostendũtopuslegisscriptũ	habentes ipi sibi sunt lex qui ostendũt opus legis scriptũ
incordibsuisEcce	in cordib suis Ecce
pͥmũtest̃millisReddenteꝯscĩaipoꝝeccescd̃met	pͥmũ test̃m illis Reddente ꝯscĩa ipoꝝ ecce scd̃m et
intrasecogitatõemaccusantiũul̃etiãdeffẽdenciũecceterciumQuinto	intra se cogitatõem accusantiũ ul̃ etiã deffẽdenciũ ecce tercium Quinto
debentpingicruces.i.assumipñie	debent pingi cruces .i. assumi pñie
asꝑritatesqueqͥdemdebẽtinungietigne	asꝑritates que qͥdem debẽt inungi et igne
illustrarinõ	illustrari  nõ
solumferendesuntpacientersetiãlibent̃q̃dꝑ	solum ferende sunt pacienter s etiã libent̃ q̃d ꝑ
unctionẽetardenterperignemUñB᷒Quiminatur	unctionẽ et ardenter per ignem Uñ B᷒ Qui minatur
terrorecrucemxp̃iportatpacient̃	terrore crucem xp̃i portat pacient̃
quiꝑficitĩspeportatlibent̃squiꝯsumatur	qui ꝑficit ĩ spe portat libent̃ s qui ꝯsumatur
inkaritateamplectituriamardenterb̃multiuidentcruces	in karitate amplectitur iam ardenter b̃ multi uident cruces
nr̃ass	nr̃as s
nonuidentunctionesnr̃asquigͥhoc	non uident unctiones nr̃as qui gͥ hoc
insehabebitueretemplũ	in se habebit uere templũ
adhonoremdeidedicatum	ad honorem dei dedicatum
eritDignus	erit Dignus
planeĩquo	plane ĩ quo
xp̃sh̃itetꝑgr̃amut	xp̃s h̃itet ꝑ gr̃am ut
tand̃ineohabitatedigneturꝑ	tand̃ in eo habitate dignetur ꝑ
gl̃amQ̃dipe	gl̃am Q̃d ipe
nobisprestaredignet᷑	nobis prestare dignet᷑
Quiuiuitetregnatdeusper	Qui uiuit et regnat deus per
om̃iascl̃ascl̃oꝝameNHicliberscriptus	om̃ia scl̃a scl̃oꝝ ameN Hic liber scriptus
fuitapudcysterciumAnnodominimillesimo	fuit apud cystercium Anno domini mil lesimo
CCCͦIIIIͦdecimokalẽdas	CCCͦ IIIIͦ decimo kalẽdas
marciiExpliciuntlegendesanctoꝝul̃passionaleadbreuiatumScriptoremgratum	marcii Expliciunt legende sanctoꝝ ul̃ passionale adbreuiatum Scriptorem gratum
faciatd̃s	faciat d̃s
atqbeatumEt	atq beatum Et
sibipͥmatumtribuatdeleat	sibi pͥmatum tribuat deleat
inreatumamẽScriberequi	in reatum amẽ Scribere qui
fecithunclibrumnon	fecit hunc librum non
malefecitIllediuduretpostmortem	malefecit Ille diu duret post mortem
syderacuretamẽHuncdegillentoCscripsitnonpede	sydera curet amẽ Hunc de gillento C scripsit non pede
lentoQuem	lento Quem
deusĩcelistradatmanibmichaelisAMENutrũ	deus ĩ celis tradat manib michaelis AMEN utrũ
taliaob̃a	talia ob̃a
ꝯc̃ꝯstãciistalibbsͨ	ꝯ c̃ꝯstãciis talibb sͨ
sintd̃isas.ꝙaliqͥs	sint d̃isa s. ꝙ aliqͥs
sicẽdispoĩt᷒ꝙtalebonũnõfac̃etꝯtemplacõne	sic ẽ dispoĩt᷒ ꝙ tale bonũ nõ fac̃et ꝯtemplacõne
minorisboniul̃	minoris boni ul̃
malissolũcõtẽplatõnemaiorisputaꝓuitãdodãpnoXII	mali s solũ cõtẽplatõne maioris puta ꝓ uitãdo dãpno XII
d̃nõiret	d̃ nõ iret
adeccamsꝓuitãdaunaũb̃atõneĩ	ad eccam s ꝓ uitãda una ũb̃atõne ĩ
capitl̃obñ	capitl̃o bñ
iretali᷒aut̃sicestdispoĩt᷒ꝙtl̃e	iret ali᷒ aut̃ sic est dispoĩt᷒ ꝙ tl̃e
bonũopusnõ	bonũ opus nõ
fac̃etꝯtẽplatõnemaioris	fac̃et ꝯtẽplatõne maioris
boniul̃malissolũminorisputa	boni ul̃ mali s solũ minoris puta
ꝓuitãdaunaũb̃atõeĩcapl̃onõiret	ꝓ uitãda una ũb̃atõe ĩ capl̃o nõ iret
sꝓuitãdodãpnoamusionis	s ꝓ uitãdo dãpno amusionis
XIId̃bñiretlñsine	XII d̃ bñ iret l ñ sine
alt̃oilloꝝnãsic̃ob̃aapuddiũsossich̃nt	alt̃o illoꝝ nã sic̃ ob̃a apud diũsos sic h̃nt
diũsasc̃ꝯstãciasitaꝙiͤh̃tob̃mꝯtalic̃ꝯstancia	diũsas c̃ꝯstãcias ita ꝙ iͤ h̃t ob̃m ꝯ tali c̃ꝯstancia
illeueroalia	ille uero alia
tũcfacilr̃	tũc facilr̃
pot̃im᷒ꝯꝑareact᷒	pot̃im᷒ ꝯꝑare act᷒
adĩuicẽsiuõ	ad ĩuicẽ si uõ
c̃ꝯstãcieutͦbiq	c̃ꝯstãcie utͦbiq
sĩttõisdeb̃etamitt̃etXIId̃si·H·gͣuit̃	sĩt tõis deb̃et amitt̃et XII d̃ si ·H· gͣuit̃
pcc̃atcui᷒	pcc̃at cui᷒
uolũtastẽtõneuiliorisfinisĩclinatpcc̃andũitam᷒ũtuose	uolũtas tẽtõne uilioris finis ĩclinat pcc̃andũ ita  m᷒ ũtuose
aqͥexmi᷒	a qͥ ex mi᷒
bonofine	bono fine
ĩclinat᷑afaciẽdũsi	ĩclinat᷑ afaciẽdũ si
·H·ut̃qtaliũeq̃lũtarie	·H· ut̃q taliũ eq̃ lũtarie
ul̃ĩuolũtarie	ul̃ ĩuolũtarie
feraip̃mbonũuolitũꝙͣntũadh̃	fera ip̃m bonũ uolitũ ꝙͣntũ ad h̃
nõur̃dmagisul̃m᷒bñfaꝙͣali᷒ẜ	nõ ur̃d magis ul̃ m᷒ bñ fa ꝙͣ ali᷒ ẜ
rõmipi᷒uolũtariisꝯtĩgitex	rõm ipi᷒ uolũtarii s ꝯtĩgit ex
rõnec̃ꝯstãcieaddUñsic̃fortitudoẽũtus	rõne c̃ꝯstãcie add Uñ sic̃ fortitudo ẽ ũtus
nobꝙͣlib̃alitasauariciapei᷒uꝙͣ	nob ꝙͣ lib̃alitas  auaricia pei᷒ u ꝙͣ
timiditasamareẜrõnũcorꝑis	timiditas  amare ẜ rõ nũ corꝑis
ẽmeli᷒ꝙͣ	ẽ meli᷒ ꝙͣ
amareext̃ioraẜrõmsb̃diẜ	amare ext̃iora ẜ rõm  sb̃di ẜ
appeꝑamorẽ	appe ꝑ amorẽ
ĩordinatũbonisexbẽpei᷒ꝙͣsb̃diẜ	ĩordinatũ bonis ex b ẽ pei᷒ ꝙͣ sb̃di ẜ
appetitũ	appetitũ 
ANnodñiMͦ	ANno dñi Mͦ
CCͦNonagͦ	CCͦ Nonagͦ
Vͦnõfuitcelebratũcapͫgñaleꝓpt̃mortẽ	Vͦ nõ fuit celebratũ capͫ gñale ꝓpt̃ mortẽ
ueñabilispr̃ismagistriordinisfr̃is	ueñabilis pr̃is magistri ordinis fr̃is
steph̃idebisũcioquiobiitĩꝯuẽtuluchano	steph̃i debisũcio qui obiit ĩ ꝯuẽtu luchano
romaneꝓuĩcieĩfestosc̃e	romane ꝓuĩcie ĩ festosc̃e
cecilieuirginisetmartiris	cecilie uirginis et martiris
AnnodñiMͦCCͦNonagͦIIIIͦANnodñiMͦCCͦ	Anno dñi Mͦ CCͦ Nonagͦ IIIIͦ ANno dñi Mͦ CCͦ
NonagͦVIͦ	Nonagͦ VIͦ
celebratũfuitLXXIcapͫgñaleĩargẽtinaĩꝓuinciatheutõie	celebratũ fuit LXXI capͫ gñale ĩ argẽtina ĩ ꝓuincia theutõie
inqͦcapͦfuitelc̃us	in qͦ capͦ fuit elc̃us
inmagistrũordinisueñabilispaterdñs	in magistrũ ordinis ueñabilis pater dñs
fraterNycholausdetriuisioqͥ	frater Nycholaus de triuisio qͥ
tũceratpͥorꝓuĩcialislõbardieANnodñiMͦCCͦNonagͦ	tũc erat pͥor ꝓuĩcialis lõbardie ANno dñi Mͦ CCͦ Nonagͦ
VIIͦcelebratũfuitLXXIIcapͫgñaleueneciisinꝓuĩcialõbardie	VIIͦ celebratũ fuit LXXII capͫ gñale ueneciis in ꝓuĩcia lõbardie
ANnodñiMͦCCCIͦcelebratumfuitLXXVcapͫgñale	 ANno dñi Mͦ CCCIͦ celebratum fuit LXXV capͫ gñale
colõieinꝓuĩciath̃otonie	colõie in ꝓuĩcia th̃otonie
inquocapͦfuitelc̃usinmagistrũ	in quo capͦ fuit elc̃us in magistrũ
ordinisfrat̃B̃nard᷒deiuzicodyoc̃uasaceñ	ordinis frat̃ B̃nard᷒ de iuzico dyoc̃ uasaceñ
deꝓuĩciatholosanaquitũcerat	de ꝓuĩcia tholosana qui tũc erat
pͥorꝓuĩcialisꝓuĩcie	pͥor ꝓuĩcialis ꝓuĩcie
nõdũdiuiseANno	nõdũ diuise ANno
dñiMͦCCCIIͦ	dñi Mͦ CCCIIͦ
celebratumfuitLXXVI	celebratum fuit LXXVI
capͫgñalebononieĩꝓuĩcialõbardieafato	capͫ gñale bononie ĩ ꝓuĩcia lõbardie a fato
magr̃o͛quiobiitpostdictũcapͫĩꝯuẽtutreũensi	magr̃o ͛ qui obiit post dictũ capͫ ĩ ꝯuẽtu treũensi
ĩꝓuĩcia	ĩ ꝓuĩcia
theutonieXVͦkls̃	theutonie XVͦ kls̃
octobrisin	octobris in
festob̃tilamb̃ti	festo b̃ti lamb̃ti
ANnodñiMͦCCCIIIIͦcelebratũfuit	ANno dñi Mͦ CCCIIIIͦ celebratũ fuit
LXXVIIIcapͫgñale	LXXVIII capͫ gñale
tholosexp̃ianus	tholose xp̃ianus
Illeuerexp̃ianusestqͥom̃ibmĩamfacit	Ille uere xp̃ianus est qͥ om̃ib mĩam facit
quinullaoĩomouet᷑ĩiuriaquialienũ	qui nulla oĩo mouet᷑ ĩiuria qui alienũ
dolorẽtãqͣmꝓpͥumsentitcui᷒mensãnl̃lus	dolorẽ tãqͣm ꝓpͥum sentit cui᷒ mensã nl̃lus
paup̃ignoratquicorãhõibingl̃iushabet᷑utcorã	paup̃ ignorat qui corã hõib ingl̃ius habet᷑ ut corã
deoangelisgl̃iet᷑	deo  angelis gl̃iet᷑
quit̃renaꝯtempnitutpossith̃re	qui t̃rena ꝯtempnit ut possit h̃re
celestiaquioppͥmiͭpauꝑẽsesentenõ	celestia qui oppͥmiͭ pauꝑẽ se sente nõ
patit᷑quimis̃issb̃uenitquiad	patit᷑ qui mis̃is sb̃uenit qui ad
fletumfletib	fletum fletib
ꝓuocat᷑alienisq̃dbenefaciebatpaulusquisĩfirmat᷑	ꝓuocat᷑ alienis q̃d bene faciebat paulus quis ĩfirmat᷑
egouõ	 ego uõ
ĩfirmoraug̃liodeuitaxp̃ͥana	ĩfirmor aug̃ lio de uita xp̃ͥana
xp̃ianinom̃	xp̃iani nom̃
illefrustͣsortit᷑quixp̃mm̃ime	ille frustͣ sortit᷑ qui xp̃m m̃ime
ĩmitat᷑quid	ĩmitat᷑ quid
·H·tͥꝓdestuocari	·H· tͥ ꝓdest uocari
ꝙnõesnom̃uiuatcruxestatque	ꝙ nõ es  nom̃ uiuat crux est atque
mrtymagxim᷒ĩs̃natal̃dñi	mrty magxim᷒ ĩ s̃ natal̃ dñi
ubifidesũitasfxp̃s	ubi fides ũitas f xp̃s
aEsuriuitxp̃s	a Esuriuit xp̃s
qͥom̃spasitiuit	qͥ om̃s pa sitiuit
ꝑquemcausat᷑on	ꝑ quem causat᷑ on
tusqui	tus  qui
sp̃ualit̃paniserienciũfonsqsitientiũat̃restͥfatigat᷒est	sp̃ualit̃ panis e rienciũ fonsq sitientiũ a t̃restͥ fatigat᷒ est
quisenob̃	qui se nob̃
uiãfecitĩcelũuelumutuit	uiã fecit ĩ celũ uelu mutuit 
obsurduitcorãciantibꝑquẽ	obsurduit corã ciantib ꝑ quẽ
mut᷒locusurd᷒audiuit	mut᷒ locu  surd᷒ audiuit
uinct᷒estdeĩfirmitatũuincl̃isnossolflagellat᷒	uinct᷒ est de ĩfirmitatũ uincl̃is nos sol flagellat᷒
estquiom̃iflagloꝝdehoĩmcorꝑibexpulit	est qui om̃i flag loꝝ de hoĩm corꝑib expulit
fix᷒estqui	fix᷒ est qui
cruciat᷒nr̃osfimortuu᷒est	cruciat᷒ nr̃os fi mortuu᷒ est
qͥmortuossuscsresurrexitnũꝙͣmorituAcidisse	qͥ mortuos susc s  resurrexit nũꝙͣ moritu Acidisse
aliquẽĩmocredũtpectorabrachia⁊	aliquẽ ĩmo credũt pectora brachia ⁊
uultũipugen᷒cibi⁊ex	uultũ ipu gen᷒ cibi ⁊ ex
hocauctorexclamãdodicitgͦꝗd	hoc auctor exclamãdo dicit gͦ ꝗd
dic̃etpictaul̃quonõfugeretsiuidẽt	dic̃et picta ul̃ quo nõ fugeret si uidẽt
hecmõstraquiabstinuitcũctisb.tanꝙͣ	hec mõstra qui abstinuit cũctis b. tanꝙͣ
abhoĩenec	ab hoĩe nec
indulsituentriom̃elegum̃qiͣdicatagorascredebatesse	indulsit uentri om̃e legum̃ qiͣ dica tagoras credebat esse
magnũnephasnocomed̃ehoĩegiptii	magnũ nephas no comed̃e hoĩ egiptii
sedmanducareaĩalia⁊õialegumina	sed manducare aĩalia ⁊ õia legumina
ꝙforti᷒ẽĩiinger̃eretardabatfinito	ꝙ forti᷒ ẽ ĩ i inger̃e retardabat finito
librositlaus⁊gl̃axp̃oam̃Isteliber	libro sit laus ⁊ gl̃a xp̃o am̃ Iste liber
quisenatori᷒uocat᷑fuitscͥpt᷒ꝑmenicolaũolim	qui senatori᷒ uocat᷑ fuit scͥpt᷒ ꝑ me nicolaũ olim
deꝑanno	de ꝑ anno
dñimillͦ	dñi millͦ
cccͦviiͦindictiõevͣtp̃redñi	cccͦ viiͦ indictiõe vͣ tp̃re dñi
clem̃tisp	clem̃tis p
annoei᷒ẜomẽsisalisdiexixͣ⁊fuit	anno ei᷒ ẜo mẽsis alis die xixͣ ⁊ fuit
ꝯpilat᷒quoad	ꝯpilat᷒ quo ad
lectinobilẽ⁊illustrẽuirũ	lecti nobilẽ ⁊ illustrẽ uirũ
dñmGentilẽ	dñm Gentilẽ
defiliisursitpr̃suisenat᷒P	de filiis ursi tpr̃ sui senat᷒ P
Asceoues	Asce oues
measinio.Sicutestinoꝑibmechanicisita	meas in io. Sicut est in oꝑib mechanicis ita
estinoꝑibusnostresalutissuomodoSed	est in oꝑibus nostre salutis suo modo Sed
uidemusquod	uidemus quod
qñartifexaͥcuiusartismechãicedebetaͥcubiꝓficisciinstruitaͥꝙͤ	qñ artifex aͥcuius artis mechãice debet aͥcubi ꝓficisci instruit aͥꝙͤ
deartesuapͤcipueetinforͣtcuicõmittit	de arte sua pͤcipue et inforͣt cui cõmittit
officiũsuũpostrecessũsuũexeꝙͤdum	officiũ suũ post recessũ suũ exeꝙͤdum
Sicfecitdñsih̃sxp̃sipe·H·quierat	Sic fecit dñs ih̃s xp̃s ipe ·H· qui erat
inhocmũdo	in hoc mũdo
rectoretpastor	rector et pastor
ouiũtociusgͤgis	ouiũ tocius gͤgis
eccͤrecessurusamũdoet	eccͤ recessurus a mũdo et
ascensurusin	ascensurus in
celũlocosuiinstituitadregim̃	celũ loco sui instituit ad regim̃
suigregisb̃tmapl̃msuũpetr̃etdemodo	sui gregis b̃tm apl̃m suũ petr̃ et de modo
regisinforͣuitdicenspasce	regis inforͣuit dicens pasce
ouesmeasinquibũbis	oues meas in quib ũbis
tͥanoͣnturpͥm̃estauctoͣspͤlatipͤsidentispascescd̃m	tͥa noͣntur pͥm̃ est auctoͣs pͤlati pͤsidentis pasce scd̃m
estcondc̃opp̃obedientisouest̃ciũ	est condc̃o pp̃ obedientis oues t̃ciũ
estaffc̃oxͥꝯmͭtentisin	est affc̃o xͥ ꝯ mͭtentis in
easobligaciopͤsidentis	eas obligacio pͤsidentis
estinsubuẽiendocũ	est in subuẽiendo cũ
sollicitudĩeCondc̃opp̃estinobediendocũmansuetudineaffc̃ocõmͭtentis	sollicitudĩe Condc̃o pp̃ est in obediendo cũ mansuetudine affc̃o cõmͭtentis
estincõmendandocũten͛itudĩePͥm̃	est in cõmendando cũ ten͛itudĩe Pͥm̃
gͦquodnoͣturinũbis	gͦ quod noͣtur in ũbis
ꝓpoĩtisestobligaciopͤlatipͤsidentisqueconsistitinsubuẽiendocũ	ꝓpoĩtis est obligacio pͤlati pͤsidentis que consistit in subuẽiendo cũ
sollicitudĩeinh̃quoddicit᷑pasceAd	sollicitudĩe in h̃ quod dicit᷑ pasce Ad
hoc·H·obligant᷑pͤsidentesetpͤlati	hoc ·H· obligant᷑ pͤsidentes et pͤlati
utgͤgemsͥcõmissũsollicitepascantnõuttondeantuel	ut gͤgem sͥ cõmissũ sollicite pascant nõ ut tondeant uel
excorientdehocpͭexpõiquoddr̃dIͣ	excorient de hoc pͭ expõi quod dr̃d Iͣ
pe.Vpascite	pe. V pascite
quiinuobis	qui in uobis
estgͤgemcõmissũs.pͣcõnisũbout	est gͤgem cõmissũ s. pͣcõnis ũbo ut
indilectionedeietcogͥtione	in dilectione dei et cogͥtione
suiꝓficiatcõũsacionisexonegͤgeminuiamoꝝerrare	sui ꝓficiat cõũsacionis exo ne gͤgem in uia moꝝ errare
faciatAmbulateindilc̃onesicut	faciat Ambulate in dilc̃one sicut
etxᷤdilexitnosad	et xᷤ dilexit nos ad
ephesᷤVsapiensinꝓũbiis	ephesᷤ V sapiens in ꝓũbiis
uitamiusticõꝑatluce.ꝓu͛biisiiii	uitam iusti cõꝑat luce . ꝓu͛ biis iiii
iustoꝝsemitaq.luxsplendẽsproceditet	iustoꝝ semita q. lux splendẽs procedit et
cͤscitusadꝑfc̃m	cͤscit us ad ꝑfc̃m
diemluxaũdiei	diem lux aũ diei
sicseh̃t	sic se h̃t
quodsemꝑcͤscitueldecͤscitnõꝙͣineod̃statuꝑmanet	quod semꝑ cͤscit uel decͤscit nõꝙͣ in eod̃ statu ꝑmanet
Sicestde	Sic est de
uitaiusti	uita iusti
semꝑ·H·cͤsc̃	semꝑ ·H· cͤsc̃
ueldecͤscitinbonosicutdicitBernardus	uel decͤscit in bono  sicut dicit Ber nardus
inuiadei	in uia dei
nõꝓgͤdiregͤdiestetidcircoapl̃usin	nõ ꝓgͤdi regͤdi est et idcirco apl̃us in
ũbisꝓpoĩtisnonhortaturadꝓficiendũin	ũbis ꝓpoĩtis non hortatur ad ꝓficiendũ in
uiamoꝝdicẽsambulateetc̃Inquibusũbis	uia moꝝ dicẽs ambulateetc̃ In quibus ũbis
pͦnoshortaturapl̃usadꝓfectumcontinuũambulatescd̃o	pͦ nos hortatur apl̃us ad ꝓfectum continuũ ambulate scd̃o
subditmodũꝯgruũ	subdit modũ ꝯgruũ
indilectionedeit̃ciosubiũg̃exẽplũpͤcipuũSicutetxᷤ	in dilectione dei t̃cio subiũg̃ exẽplũ pͤcipuũ Sicut et xᷤ
dilexitnosPrimogͥnoshortaturapl̃usad	dilexit nos Primo gͥ nos hortatur apl̃us ad
ꝑfc̃mcontinuũcũdicitur	ꝑfc̃m continuũ cũ dicitur
ambulatenõpedibuscorporis	ambulate nõ pedibus corporis
sedoꝑibusuirtutisꝑficiendos.	sed oꝑibus uirtutis ꝑficiendo s.
deuirtuteinuirtutemnõiacendocũuoluptuosis	de uirtute in uirtutem nõ iacendo cũ uoluptuosis
ꝑcarnalemcõcupĩamnõsedendocũ	ꝑ carnalem cõcupĩam nõ sedendo cũ
insidiosisꝑ	insidiosis ꝑ
intentionismalitiamnõstãdo	intentionis malitiam nõ stãdo
cũaccidiosisperignauiametpigͥtiamnõequitandocũ	cũ accidiosis per ignauiam et pigͥtiam nõ equitando cũ
põposisetambitiosisꝑelacõm	põposis et ambitiosis ꝑ elacõm
etsuꝑbiam	et suꝑbiam
sedambulãdocũlaboriosisetfestinantibusadpr̃iamde	sed ambulãdo cũ laboriosis et festinantibus ad pr̃iam de
istoꝑfc̃ũambul̃onisdr̃dMicheeVIiudicabotͥ	isto ꝑfc̃ũ ambul̃onis dr̃d Michee VI iudicabo tͥ
ohomogeliiSecunduMatheum	o homo gelii Secundu Matheum
ixINillo	ix IN illo
tp̃reAngl̃sdñiapparuitin	tp̃re Angl̃s dñi apparuit in
sõnisiosephdicẽs	sõnis ioseph dicẽs
Surgeaccipe	Surge  accipe
puerũet	puerũ et
matrẽeiusfugeinegiptũestoibi	matrẽ eius  fuge in egiptũ  esto ibi
usqdũdicamtibiEt	usq dũ dicam tibi Et
rel̃homelialectiõiseiusdeminxpma	rel̃ homelia lectiõis eiusdem in xp ma
mariũfidmẽe	mari ũ fid mẽ e
ꝑproredd	ꝑ pro redd
ramꝑegͥnusꝑficiopericl̃mperiuriũperseũanͣpeticiopetr᷒apl̃s	ram ꝑegͥnus ꝑficio pericl̃m periuriũ perseũanͣ peticio petr᷒ apl̃s
petr᷒martirpietaspigriciapiscatorpolluciopotencia	petr᷒ martir pietas pigricia piscator pollucio potencia
potuspreceptũpredestinacõpredicaciopredicatorpredoprelatusprelaciopositus	potus preceptũ predestinacõ predicacio predicator predo prelatus prelacio positus
scienciasermoserpenss̃uiciũ	sciencia sermo serpens s̃uiciũ
seũitassignũsilenciũsiluest̃simia	seũitas signũ silenciũ siluest̃ simia
symonmag᷒symoniudassymoniasĩplicitassimulaciosingl̃aritassitis	symon mag᷒ symon  iudas symonia sĩplicitas simulacio singl̃aritas sitis
sobrietassompn᷒sortilegiũspectacl̃msolitudosoluciosponsalia	sobrietas sompn᷒ sortilegiũ spectacl̃m solitudo solucio sponsalia
statusFinishuicuenitecce	status Finis huic uenit  ecce
nũcuenithi᷒alphabetifinisilligr̃asqui÷alpha	nũc uenit hi᷒ alphabeti finis illi gr̃as qui÷ alpha
opͥncipiũ	 o pͥncipiũ
finisꝘqͥhũclibꝝlecturisuntorare	 finis Ꝙ qͥ hũc libꝝ lecturi sunt orare
deuotedignent᷑uthoꝝꝯpilatorc᷒nom̃	deuote dignent᷑ ut hoꝝ ꝯpilator c᷒ nom̃
ĩꝓlogoꝯtinet᷑eoꝝoracõibadiutusfinẽlegatũꝯsequim̃eat᷑	ĩ ꝓlogo ꝯtinet᷑ eoꝝ oracõib adiutus finẽ legatũ ꝯsequi m̃eat᷑
Ꝙipepr̃aredignetursc̃atrinitasun᷒de᷒sñfine	Ꝙ ipe pr̃are dignetur sc̃a trinitas un᷒ de᷒ sñ fine
benedc̃usinscl̃ascl̃oꝝamenAnno	benedc̃us in scl̃a scl̃oꝝ amen Anno
dñimͦcccmoviiiFRatrẽGuill̃m	dñi mͦ cccmo viii FRatrẽ Guill̃m
petridegodinobaioneñord̃fr̃mdicatoꝝ	petri de godino baioneñ ord̃ fr̃m dicatoꝝ
magr̃mĩtheologiaꝑisĩassũpsitin	magr̃m ĩ theologia ꝑisĩ assũpsit in
presbiteriumcardinalẽtitulisc̃e	presbiterium cardinalẽ tituli sc̃e
cecilieidemdñsclemens	cecilie idem dñs clemens
ppͣv᷒sabb̃o	ppͣ v᷒ sabb̃o
inieiuniisiiiiortp̃oꝝinaduẽtuxͦkls̃ianuariiAnno	in ieiuniis iiiior tp̃oꝝ in aduẽtu xͦ kls̃ ianuarii Anno
dñimͦcccͦxiiͦpõtificatsui	dñi mͦ cccͦ xiiͦ põtificat sui
annoviiiͦEratãttc̃l̃ctor	anno viiiͦ Erat ãt tc̃ l̃ctor
sacripalaciiuͥlegeratiãviannisfueratqpͥor	sacri palacii uͥ legerat iã vi annis fueratq pͥor
ꝓuĩcial̃ĩꝓuinciaꝓuĩcieord̃dic̃primoetin	ꝓuĩcial̃ ĩ ꝓuincia ꝓuĩcie ord̃ dic̃ primo et in
ꝓuinciatholosanahũcp᷒modũfec̃ep̃mcardinalẽsabinẽcẽdñsioh̃es	ꝓuincia tholosana hũc p᷒modũ fec̃ ep̃m cardinalẽ sabinẽcẽ dñs ioh̃es
papahicfec̃construitotã	papa hic fec̃ construi totã
eccamt̃capusfr̃md̃tholosesuissũptib	eccam t̃ capus fr̃m d̃ tholose suis sũptib
etexpẽcisRatrẽmatheũdeurssinis	et expẽcis Ratrẽ matheũ de urssinis
dec̃itateromanamagr̃mĩtheulogia	de c̃itate romana magr̃m ĩ theulogia
ꝑisĩde	ꝑisĩ de
cuiospicioañ	cui ospicio añ
longefuerãt	longe fuerãt
assũptiaqͥdam	assũpti a qͥdam
papeeteciãinperatoresnͨnõ	pape et eciã inperatores nͨ nõ
etplurescardinalesassũpsitinpresbiteꝝcardinalem	et plures cardinales assũpsit in presbiteꝝ cardinalem
tͥtͥsc̃oꝝioh̃isetpauli	tͥtͥ sc̃oꝝ ioh̃is et pauli
dñsioh̃espapainieiuniisiiiior	dñs ioh̃es papa in ieiuniis iiiior
tẽpoꝝaduẽtus	tẽpoꝝ aduẽtus
xiiiiͦkl̃ianuariiannodñimͦ	xiiiiͦ kl̃ ianuarii anno dñi mͦ
cccͦxxͦ	cccͦ xxͦ
viiͦistefuitinviicapogñaliburdegal̃celebratoanno	viiͦ iste fuit in vii capo gñali burdegal̃ celebrato anno
dñimͦcccͦ	dñi mͦ cccͦ
xxͦiiiiͦerateĩpͥorꝓuĩcial̃romaneꝓuĩcieinquo	xxͦ iiiiͦ erat eĩ pͥor ꝓuĩcial̃ romane ꝓuĩcie in quo
capl̃ofuitgrauit̃	capl̃o fuit grauit̃
infirmFr̃emGeraldũdedomaroBriueñord̃fr̃mdicaꝝ	infirm Fr̃em Geraldũ de domaro Briueñ ord̃ fr̃m dicaꝝ
magr̃mĩtheologiaꝑisĩ	magr̃m ĩ theologia ꝑisĩ
assũpsitĩbr̃mcard̃tͥtͥsc̃esabinedñsclemenspapa	assũpsit ĩ br̃m card̃ tͥtͥ sc̃e sabine dñs clemens papa
vi᷒sasab̃toĩieiuniisiiiiorfest̃exaltacõissc̃e	vi᷒ sa sab̃to ĩ ieiuniis iiiior fest̃ exaltacõis sc̃e
cruciscũuomitucipueinegͥtudinibacutisethoris	crucis cũ uomitu cipue in egͥtudinib acutis et horis
crisisEtqñestcũcõitate	crisis Et qñ est cũ cõitate
ñuoꝝuenientiũad	ñuoꝝ uenientiũ ad
eaac̃ebronuchacũ	ea a c̃ebro  nucha cũ
ꝯũitatequãc̃ebꝝh̃t	ꝯũitate quã c̃ebꝝ h̃t
cũeisFennouadedispositionibusgutturis	cũ eis Fen noua de dispositionibus gutturis
cuiusestunustractatuscõtinenstresdecimcapitulaCapitulũprimũest	cuius est unus tractatus cõtinens tresdecim capitula Capitulũ primũ est
deanathomiagutturiᷤPErgutturintelligim᷒spatiũĩ	de anathomia gutturiᷤ PEr guttur intelligim᷒ spatiũ ĩ
quosunt	quo sunt
meat᷒hanelit᷒etcibiEtdeeosunt	meat᷒ hanelit᷒ et cibi Et de eo sunt
additõqueestunaEtamigdaleEtgalsamathiEttu	additõ que est una Et amigdale Et galsamathi Et tu
quid̃iamsciuistianathomiãmeryetanͣm	quid̃ iam sciuisti anathomiã mery et anͣm
epyglotisUnauõestsub̃iacarnosapendenssuprasupremãꝑtẽ	epyglotis Una uõ est sub̃ia carnosa pendens supra supremã ꝑtẽ
epiglotissicutuelam̃Eteiusquid̃iuuam̃tũest	epiglotis sicut uelam̃ Et eius quid̃ iuuam̃tũ est
gͣdatõaerisutnon	gͣdatõ aeris ut non
ꝑcutiatsuofrigorepl̃monemsubito	ꝑcutiat suo frigore pl̃monem subito
Etꝓh̃eatpulũemfumũEtut	Et ꝓh̃eat pulũem  fumũ Et ut
sitꝑcutiensuocemqua	sit ꝑcutiens uocem qua
confortet᷑etmagnificeturqiͣipa	confortet᷑ et magnificetur qiͣ ipa
sitportacustodienssuꝑexitũuocis	sit porta custodiens suꝑ exitũ uocis
qͣntitatesuaEtp̃phocuocetei᷒	qͣntitate sua Et p̃p hoc uocet ei᷒
incisiouocietꝑatpl̃monẽad	incisio uoci et ꝑat pl̃monẽ ad
recipiendũfrig᷒etnocum̃tũ	recipiendũ frig᷒ et nocum̃tũ
ei᷒ettussim	ei᷒ et tussim
abeoDueuõamigdalesuntduecarnesnatein	ab eo Due uõ amigdale sunt due carnes nate in
radicelinguetendentesadsuꝑioraacdubiumnon	radice lingue tendentes ad suꝑiora ac dubium non
estIdemqͣrediedominicosac̃dotũordinacões	est Idem qͣre die dominico sac̃dotũ ordinacões
celebrant᷑QUodindiedñicoordinacionessac̃dotũep̃oꝝ	celebrant᷑ QUod in die dñico ordinaciones sac̃dotũ ep̃oꝝ
celebrãturnõtm̃	celebrãtur nõ tm̃
exconsuetudĩeseteciãexapl̃icanouim᷒uẽire	ex consuetudĩe set eciã ex apl̃ica nouim᷒ uẽire
doctrinascripturaact᷒xiiiũsuspͥnmãifestanteq̃dcũ	doctrina scriptura act᷒ xiii ũsus pͥn mãifestante q̃d cũ
apl̃ipaulũbarnabamexsp̃ssc̃iceptoad	apl̃i paulũ  barnabam ex sp̃s sc̃i cepto ad
euͣngl̃iumgentibmitt̃entdicandũieiunantesorantesimposũunteis	euͣngl̃ium gentib mitt̃ent dicandũ ieiunantes  orantes imposũunt eis
manusutintl̃ligamus	manus ut intl̃ligamus
qͣntadanciũaccipienciũdeuocionecurand̃	qͣnta  danciũ  accipienciũ deuocione curand̃
sitnetante	sit ne tante
bñdc̃onissacr̃mneggligent̃uideat᷑impletũiõpie	bñdc̃onis sacr̃m neggligent̃ uideat᷑ impletũ  iõ pie 
laudabl̃rapl̃icismorẽgesẜisinstitutissi	laudabl̃r apl̃icis morẽ gesẜis institutis si
hͣncordinãdorũsac̃doctũforͣmꝑ	hͣnc ordinãdorũ sac̃do c tũ forͣm ꝑ
eccl̃iasquibusdñsesseteuoluit	eccl̃ias quibus dñs esse te uoluit
̃ipeẜuaũisicii	̃ ipe ẜuaũis icii
acmedianeebdomadesabb̃iieiuniocircauesꝑasip̃asordĩacões	ac mediane ebdomade  sabb̃i ieiunio circa uesꝑas ip̃as ordĩacões
noũitiscelebͣndasNeccuiuslibutilitatis	noũitis celebͣndas Nec cuiuslib utilitatis
c̃apbr̃mseu	c̃a pbr̃m seu
dyaconẽhiisferreaudeantquiañiposfũintordinatidist̃	dyaconẽ hiis ferre audeant qui añ ipos fũint ordinati dist̃
lxxviQUibtp̃ribieiunia	lxxvi QUib tp̃rib ieiunia
celebͣndasuntcalixtusppͣdet̃minatscͥbensbñdc̃oep̃oquibtp̃rib	celebͣnda sunt calixtus ppͣ det̃minat scͥbens bñdc̃o ep̃o quib tp̃rib
ieiuniacelebrenturIEiuniũq̃dteriap̃	ieiunia celebrentur IEiuniũ q̃d ter i ap̃
nosinannocelebraredidicistisꝯuẽienciusnob̃	nos in anno celebrare didicistis ꝯuẽiencius nob̃
nũcꝑqͣtuor	nũc ꝑ qͣtuor
temꝑaf̃i	temꝑa f̃i
dec̃nim᷒utsic̃annusꝑqͣtuoruoluit̃tpr̃	dec̃nim᷒ ut sic̃ annus ꝑ qͣtuor uoluit̃ tpr̃
sicnosqͣternũsollempneagam᷒ieiuniũꝑqͣtuor	sic  nos qͣternũ sollempne agam᷒ ieiuniũ ꝑ qͣtuor
ãnitpr̃Item	ãni tpr̃ Item
excon.magociẽside	ex con. magociẽsi de
eodẽConstituim᷒utqͣtuortpr̃anniabõibhom̃ibꝯ	eodẽ Constituim᷒ ut qͣtuor tpr̃ anni ab õib hom̃ib ꝯ
Inparidelictouelcausapociorestconditõpossidentis	In pari delicto uel causa pocior est conditõ possidentis
IDemCUmconstat	IDem CUm con stat
pereumquomin᷒conditõimpleaturh̃ridꝑindeac	per eum quomin᷒ conditõ impleatur h̃ri d ꝑinde ac
siimpletafuissIDem	si impleta fuiss IDem
Quodalicui	Quod alicui
suononlicetnoĩenec	suo non licet noĩe nec
alienolicebitIDem	alieno licebit IDem
Potestquisperalium	Potest quis per alium
quodpotestfac̃eꝑse	quod potest fac̃e ꝑ se
ip̃mIDemInmalispromissisfidemnõexpedit	ip̃m IDem In malis promissis fidem nõ expedit
obẜuariIDemIn	obẜuari IDem In
alt̃natiuisdebitorisẽelectõ	alt̃natiuis debitoris ẽ electõ
etsufficitalt̃madĩpleriIDemQuiadagendũadmittit᷑	et sufficit alt̃m adĩpleri IDem Qui ad agendũ admittit᷑
ẽadexcipiẽdũml̃tomagis	ẽ ad excipiẽdũ ml̃to magis
admittẽd᷒IDemQuifacitꝑaliumestꝑinde	admittẽd᷒ IDem Qui facit ꝑ alium est ꝑinde
acsifaciatꝑ	ac si faciat ꝑ
seip̃mIDemFactũ	se ip̃m IDem Factũ
legitime.i.	legitime .i.
ꝯpleteretractarinõdebet	ꝯplete retractari nõ debet
licetcasusposteaeueniat	licet casus postea eueniat
exactumit̃mexigatur	exactum it̃m exigatur
IDemCUmquid	IDem CUm quid
unauianõprohibeturalicuiadid	una uia nõ prohibetur alicui ad id
alianõdadmittiIDem	alia nõ d admitti IDem
Contractusexconuẽtõne	Contractus ex conuẽtõne
legemacciꝑedinoscũt᷑IDeDanpnũ	legem acciꝑe dinoscũt᷑ IDe Danpnũ
quodquissuaculpasentitsibidnõ	quod quis sua culpa sentit sibi d nõ
aliisĩputariIDeInfamibportenõpateãtdignitumIDemCertum	aliis ĩputari IDe Infamib porte nõ pateãt dignitum IDem Certum
estꝙisꝯmͭtit	est ꝙ is ꝯmͭtit
inlegemquilegisuerbacõplectenscontra	in legem qui legis uerba cõplectens contra
legisnittituruoluntatemExplicitlibersextusdecretalium	legis nittitur uoluntatem Explicit liber sextus decretalium
conpletusperdieluneĩuigilia	conpletus per die lune ĩ uigilia
b̃timartinihyemalisdeograciasannodñimͦcccͦ	b̃ti martini hyemalis deo gracias anno dñi mͦ cccͦ
xvͦInstudiodictihicẽuerꝓphetaqui	xvͦ In studio dicti hic ẽ uer ꝓpheta qui
uẽturĩmũdũEstaut̃	uẽtur ĩ mũdũ Est aut̃
ualdeꝯuẽensꝙaduẽtdñi	ualde ꝯuẽens ꝙ aduẽt dñi
ĩcedẽtedñicainchoet᷑ut	ĩ cedẽte dñica inchoet᷑ ut
ecciaadaduẽtũxp̃ieic̃tifica	eccia ad aduẽtũ xp̃i ei c̃tifica
ꝓmissiõeꝯsolata	ꝓmissiõe ꝯsolata
respirãsdeuoci⁊uericlamatAtteleuaui	respirãs deuoci ⁊ ueri clamat At te leuaui
aĩameãAdcuiꝯtẽplacõeaĩenr̃esicleuẽt᷑ut	aĩa meã Ad cui ꝯtẽplacõe aĩe nr̃e sic leuẽt᷑ ut
ĩaduẽtudistrictiiudic̃beat̃sociẽt᷑	ĩ aduẽtu districti iudic̃ beat̃ sociẽt᷑
ꝙgraciosenob̃ꝯcedat	ꝙ graciose nob̃ ꝯcedat
quisñfĩeuiuit	qui sñ fĩe uiuit
⁊regnatamenaͦdñimͦccccͦisto	⁊ regnat amen aͦ dñi mͦ ccccͦ isto
ãnofinit⁊ꝯpletẽistelib̃laus	ãno finit ⁊ ꝯplet ẽ iste lib̃ laus
tibisitxp̃e	tibi sit xp̃e
quoniamliberexplicitistepermanusiohãnisleufferswillen	quoniam liber explicit iste per manus iohãnis leufferswillen
scriptorẽnostiamconsideransdicitquidet̃ra	scriptorẽ nos tiam considerans dicit qui de t̃ra
estdeterraloquiturqͥdecelo	est de terra loquitur qͥ de celo
uenitsuperomnesẽTuautemdominer̃	uenit super omnes ẽ Tu autem domine r̃
DescẽdetdominussicutpluuiainuellusOrietur	Descẽdet dominus sicut pluuia in uellus Orietur
indiebeius	in dieb eius
i᷒ticiaethabundanciapacisũEtadorabunt	i᷒ticiaet habundancia pacis ũ Et adorabunt
eumomnes	eum omnes
regesom̃s	reges om̃s
gentesseruient	gentes seruient
eiOrieturl̃viiiͣCurincarc̃epositusmittens	ei Orietur l̃ viiiͣ Cur in carc̃e positus mittens
discipulosrequirittuesquiuenturuseᷤan	discipulos requirit tu es qui uenturus eᷤ an
aliumexpectamustãꝙͣsiignoretquemõnderatetanipe	alium expectamus tãꝙͣ si ignoret quem õnderat et an ipe
sitnesciat	sit nesciat
quemip̃meẽꝓph̃andobaptisandoostendendoclamaueratshec	quem ip̃m eẽ ꝓph̃ando baptisando ostendendo clamauerat s hec
ciciusquestio	cicius questio
soluitursigestereitempusetordo	soluitur si geste rei tempus et ordo
penseturTu	pensetur Tu
autẽr̃monteᷤremanip̃eueniatrequiritnonquia	autẽ r̃ monteᷤ rem an ip̃e ueniat requirit non quia
ip̃meẽmundi	ip̃m eẽ mundi
redemptorẽdubitatsedqueritut	redemptorẽ dubitat sed querit ut
sciatsiisquiperseinmundumueneratper	sciat si is qui per se in mundum uenerat per
seeciamadinferniclaustradescendatQuemenimprecurrens	se eciam ad inferni claustra descendat Quem enim precurrens
mundonunciauerathuncmoriendoetadinferoscurrebat	mundo nunciauerat hunc moriendo et ad inferos currebat
Tuaut̃r̃Ecceradix	Tu aut̃ r̃ Ecce radix
iesseascendet	iesse ascendet
insalutempopulorumip̃mgentesdeprecabuntur	in salutem populorum ip̃m gentes deprecabuntur
EteritnomẽeiusgloriosumũDabitillidominusdeus	Et erit nomẽ eius gloriosum ũ Dabit illi dominus deus
sedemdauidpr̃iseiusetregnabitdomoiacobĩet̃num	sedem dauid pr̃is eius et regnabit domo iacob ĩ et̃num
EteritGloriapr̃ir̃Ecceradixũañl̃	Et erit Gloria pr̃i r̃ Ecce radix ũ añ l̃
OstendeInl̃ã	Ostende In l̃ ã
Uenietdominusetnõtardabit	Ueniet dominus et nõ tardabit
etilluminabitdumscelestis	et illuminabit dum scelestis
primoqchristiquadringentesimo	primoq christi quadringentesimo
natidieq	nati dieq
ueresecundauicesimaiani	uere secunda uicesima iani
AntoniusdictussanciicognominefultusIspanusnatuastigie	Antonius dictus sancii cognomine fultus Ispanus natu astigie
fõteperunctushunclibrumscripsitiussusanctissimipatrisQuicunctis	fõte perunctus hunc librum scripsit iussu sanctissimi patris Qui cunctis
panditcelestiaRegnabeatisProhuius	pandit celestia Regna beatis Pro huius
statuoretplebs	statu oret plebs
christifidelisQuiuteam	christi fidelis Qui ut eam
saluetpressuras	saluet pressuras
subitinterrisymoutplebischristusabstergatpeccataPius	subit in terris ymo ut plebis christus abstergat peccata Pius
pastororetquiestdignus	pastor oret qui est dignus
uitabeataQuifec̃hosũsusdeuotusnim᷒ꝓhẽialit̃dicta	uita beata Qui fec̃ hos ũsus deuotus nim᷒ ꝓhẽialit̃ dicta
sinttantaDIcamusautemresumẽtesquoniamomniscogͥtioet	sint tanta DIcamus autem resumẽtes quoniam omnis cogͥtio et
electiobonũaliq̃d	electio bonũ aliq̃d
desideratquidesthoc	desiderat quid est hoc
q̃ddicimusCiuilemdesiderareetquidestomnium	q̃d dicimus Ciuilem desiderare et quid est omnium
operatorumsũmũ	operatorum sũmũ
bonũNominequidẽig᷑ferea	bonũ Nomine quidẽ ig᷑ fere a
pl̃imiscõfessũestfelicitatemeniet	pl̃imis cõfessũ est felicitatem eni et
multietexcellentesdicũt	multi et excellentes dicũt
beneuiũeaut̃etbñoꝑariidem	bene uiũe aut̃ et bñ oꝑari idem
existimãteiq̃destessefelicem	existimãt ei q̃d est esse felicem
defelicitateaut̃	de felicitate aut̃
29Deqͣlitateuisionis	29 De qͣlitate uisionis
quaĩfuturoscl̃osc̃ideumuidebunt30Deeterna	qua ĩ futuro scl̃o sc̃i deum uidebunt 30 De eterna
felicitateciuitatisdei	felicitate ciuitatis dei
sabb̃oqꝑpetuo31De	sabb̃oq ꝑpetuo 31 De
oꝑisꝯsũmatõnecum	oꝑis ꝯsũmatõne cum
gr̃aꝝactioneExplicit	gr̃aꝝ actione Explicit
tabulalibrideciuitatedeibt̃iAugustiniquescripta	tabula libri de ciuitate dei bt̃i Augustini que scripta
fuitAnno	fuit Anno
dñiMͦCCCCͦ	dñi Mͦ CCCCͦ
pͥMarciidie26ͣuigente	pͥ Marcii die 26ͣ uigente
scismateetppͣbenedc̃o13ͦinpalatioAuinioneñsub	scismate et ppͣ benedc̃o 13ͦ in palatio Auinioneñ sub
clausuraiamperbienniũ	clausura iam per bienniũ
detẽtoꝓth	detẽto ꝓ th
dolorCeescripstGuylleminCronierpourdesprelats	dolor Ce escripst Guyllemin Cronier pour des prelats
lepermierEt	le per mier Et
sebiensonnomweulz	se bien son nom weulz
scavoirPren	scavoir Pren
leRouge	le Rouge
etlaysselenoirOmortaliummiserandaconditioquesemper	et laysse le noir O mortalium miseranda conditio que semper
inarduumlabentiuminanitertendis	in arduum labentium inaniter tendis
utlapsugrauioreruasQueris	ut lapsu grauiore ruas Queris
hicfulgentiadunores	hic fulgentia du nores
eximioslongosqpotentatusubinullapotentiapotense	eximios longosq potentatus ubi nulla potentia potens e
uerushonosnullumconsistensdyademasomnia	uerus honos nullum consistens dyadema s omnia
casushumanetquicquidinaltumfortunatulitruitura	casus human et quicquid in altum fortuna tulit ruitura
leuatRespiceregesetregnaquonperiainterlaudantiumora	leuat Respice reges et regna quon peria inter laudantium ora
atqmirantiumrepentecorruisseutdeturintesectanturnonad	atq mirantium repente corruisse ut detur inte sectantur non ad
idquotendunt	id quo tendunt
euolantsadymadedecorosesepissimeiuxtaeuangelicumdictum	euolant s ad yma dedecorose sepissime iuxta euangelicum dictum
Quiseexaltathumiliabiturlucexiiii	Qui se exaltat humiliabitur luce xiiii
Quisꝗsmesuirtutumesseconcupiscit	Quisꝗs mes uirtutum esse concupiscit
stabilifixoqgradu	stabili fixoq gradu
manereinterradiantchorosfelicitercollocarinormamuirtutumuthic	manere inter radiant choros feliciter collocari normam uirtutum ut hic
duxnosterfecitdiscat	dux noster fecit discat
uniutinquitTulliusinphilippicis	uni ut inquit Tullius in philippicis
Omniaaliaincertasunt	Omnia alia incerta sunt
caducaetmobiliaestunaaltissimisinfixaradicibusquenulla	caduca et mobilia est una altissimis infixa radicibus que nulla
uilabefactaripotestnecdimoQuicũqgͦuirtutis	ui labefactari potest nec dimo Quicũq gͦ uirtutis
uestigiasequeturuthicdux	uestigia sequetur ut hic dux
inclitusmeritosibi	inclitus merito sibi
diceturquprincipiodiximusposuiteumducemuirtutumuniuersarum	dicetur qu principio diximus posuit eum ducem uirtutum uniuersarum
q̃dfuitthcuius	q̃d fuit th cuius
declarationepotesttalisratioformariQuisꝗscompositementis	declaratione potest talis ratio formari Quisꝗs composite mentis
inpresentiseterniducis	in presentis eterni ducis
signasequituranimoseillum	signa sequitur animose illum
deusponitducemuiruersarumsdux	deus ponit ducem uir uersarum s dux
nosterinclitusmentecelo	noster inclitus mente celo
dedituseterniducissignamucutusergo	deditus eterni ducis signa mu cutus ergo
illumdeusposuitducemuirtutumuniuersarum	illum deus posuit ducem uirtutum uniuersarum
Primaparsanpatetperilludapostolisecundethesalõicensespͥmo	Prima pars an patet per illud apostoli secunde thesalõicenses pͥmo
Nonenimdeditnobisdeus	Non enim dedit nobis deus
timorisseduirtutisEteccͥxluirtutesexaltant	timoris sed uirtutis Et eccͥ xl uirtutes exaltant
cor.Ethec	cor . Et hec
paucadeprimap	pauca de prima p
detissecũda	detis secũda
parsantecedẽtisqueestsduxnosterĩclitus⁊c̃	pars antecedẽtis que est s dux noster ĩclitus ⁊ c̃
patetperilld̃ioIN	patet per illd̃ io IN
pͥncipioẽatũbũetũbũ	pͥncipio ẽat ũbũ et ũbũ
ẽataputd̃mdeusẽatũbũhoc	ẽat aput d̃m  deus ẽat ũbũ hoc
ẽatinpͥncipioaputd̃m	ẽat in pͥncipio aput d̃m
Om̃iaꝑip̃mfc̃as̃t	Om̃ia ꝑ ip̃m fc̃a s̃t 
sineipofc̃m÷nichilQͦtfc̃m÷	sine ipo fc̃m ÷ nichil Qͦt fc̃m ÷
inipouitaẽat	in ipo uita ẽat
EtuitaẽatluxhoĩmEt	Et uita ẽat lux hoĩm Et
luxintenebͥslucettenebreeã	lux in tenebͥs lucet  tenebre eã
nonꝯhenderũtfuithomomissusadeocui	non ꝯhenderũt fuit homo missus a deo cui
nomẽẽatiohãnesHicuenit	nomẽ ẽat iohãnes Hic uenit
ĩtestimõiͫuttestimõͫꝑhib̃et	ĩ testimõiͫ ut testimõͫ ꝑhib̃et
delumĩeutom̃es	de lumĩe ut om̃es
cred̃entꝑillũNonẽatilleluxsut	cred̃ent ꝑ illũ Non ẽat ille lux s ut
testimomꝑhib̃etdelumĩeẼatlux	testimom ꝑhib̃et de lumĩe Ẽat lux
ũaq̃illuĩat	ũa q̃ illuĩat
om̃emhomĩemuenientẽinhũcmũdumInmundoillumsed	om̃em homĩem uenientẽ in hũc mũdum In mundo illum sed
seasidioneprocreatumVerumpostꝙͣasillanauiolencia	se asidione procreatum Verum postꝙͣ a sillana uiolencia
cesarianaequitasreduxitgubernaculaRomaniImperii	cesariana equitas reduxit gubernacula Romani Imperii
iustioreprincipeoptinente	iustiore principe optinente
inpubcacustodiasp̃umposuit	in pubca custodia sp̃um posuit
EodempresideR.pubceinconsiml̃imendaciomuliebris	Eodem preside R. pubce in consiml̃i mendacio muliebris
temẽitasrepressaestSiquidemcum	temẽitas repressa est Siquidem cum
seprorubria	se pro rubria
quedamperindeacfalsocredita	quedam perinde ac falso credita
essincendioperpetinichiladseꝑtinentibbonisinser̃et	ess incendio perpeti nichil ad se ꝑtinentib bonis inser̃et
neqeiautsplendidi	neq ei aut splendidi
testesautcohortisAugustifauor	testes aut cohortis Augusti fauor
deesspropterinexpungnabl̃emCesaris	deess propter inexpungnabl̃em Cesaris
constanciamirritapropoĩtinefariiabiitIdembarbarumquendamproptereximiam	constanciam irrita propoĩti nefarii abiit Idem barbarum quendam propter eximiam
sil̃itudinemCapadocieRegnumaffectantem	sil̃itudinem Capadocie Regnum affectantem
tamꝙͣAriathes	tamꝙͣ Ariathes
essquemaM.Antonio	ess quem a M . Antonio
interemptumluceclariuseratꝙͣꝙͣpene	interemptum luce clarius erat ꝙͣꝙͣ pene
tociusorientisCiuitatiumetgentium	tocius orientis Ciuitatium et gentium
credulasuffragacõnefultumcaput	credula suffragacõne fultum caput
dementerImpẽioinminensiustoImpendisuppliciocoegitExplicitUaleriusMaximus	dementer Impẽio inminens iusto Impendi supplicio coegit Explicit Ualerius Maximus
Annomͦccccmoterciocͥca	Anno mͦ ccccmo tercio cͥca
festũassupͦͥᷤMariaFilimandatadataquesunt	festũ assupͦͥᷤ Maria Fili mandata data que sunt
congrualaudiIncipit	congrua laudi Incipit
speculũsacerdotũcclesiesancteRegimẽquiduc̃esancte	speculũ sacerdotũ cclesie sancte Regimẽ qui duc̃e sancte
uishecmetralege	uis hec metra lege
desc̃aꝯditalegeQuesiꝑleg̃e	de sc̃a ꝯdita lege Que si ꝑleg̃e
bñuis⁊cordetenereactiꝯplerepot̃is	bñ uis ⁊ corde tenere acti ꝯplere pot̃is
bonasemꝑhaberehocspeculũclarũ	bona semꝑ habere hoc speculũ clarũ
curãmõstrans	curã mõstrans
aĩarũCondotibicarũ	aĩarũ Condo tibi carũ
plusꝙͣsitgẽmauelaurũQuopossisaĩassacͣmẽt̃reddere	plusꝙͣ sit gẽma uel aurũ Quo possis aĩas sacͣmẽt̃ reddere
mũdasCriminauitare	mũdas Crimina uitare
uirtutesmultiplicareut	uirtutes multiplicare ut
bñuiuẽdosubiectissanctadocendo	bñ uiuẽdo subiectis sancta docendo
Tandemleteris	Tandem leteris
incelis⁊speculeris	in celis ⁊ speculeris
adducẽdogregẽsũmũꝑsecularegẽhoc	adducẽdo gregẽ sũmũ ꝑ secula regẽ hoc
ꝯcedentedñobñcũctaregente	ꝯcedente dño bñ cũcta regente
primotñ	primo tñ
dñmrogotrinũ	dñm rogo trinũ
sẽꝑ⁊unũa	sẽꝑ ⁊ unũ a
quocũctabonamanãtutdetmichidona	quo cũcta bona manãt ut det michi dona
Cũquibhocspeculũualeãꝯplerenouellũ	Cũ quib hoc speculũ ualeã ꝯplere nouellũ
utilemũdanisaĩabusedificandisdemodo⁊formahui᷒	utile mũdanis aĩabus edificandis de modo ⁊ forma hui᷒
libriDetitulopandãtibiprimoꝯmoda	libri De titulo pandã tibi primo ꝯmoda
quedãutẜuesuitãpost	quedã ut ẜues uitã post
hecdiceturhonestam	hec dicetur honestam
Quedebesscirefaciãpost	Que debes scire faciã post
istasubirehincꝙineccl̃aresidencia	ista subire hinc ꝙ in eccl̃a residencia
sitfaciendaQue	sit facienda Que
sũtofficiatibi	sũt officia tibi
subiũgãfugiendaposthecofficiatibidebitaiũgonouena	subiũgã fugienda post hec officia tibi debita iũgo nouena
Scilicinsacradignetractessac̃mentaut	Scilic in sacra digne tractes sac̃menta ut
missascelebres	missas celebres
deuoteposteacernesposteamonstraturquid	deuote post ea cernes postea monstratur quid
quomodoꝯfiteaturQuomododoctrinãtradastransportatieẽnt⁊	quomodo ꝯfiteatur Quomodo doctrinã tradas transportati eẽnt ⁊
easuplem̃toadductoquoãpli᷒duab.legionib.ꝙͣ	ea suplem̃to adducto quo ãpli᷒ duab. legionib. ꝙͣ
xmilia⁊quadringẽtipeditessexcentieꝗteseẽnt⁊sociũ	x milia ⁊ quadringẽti pedites sexcenti eꝗtes eẽnt ⁊ sociũ
lat̃inoĩisduodecĩmiliasexcẽtieꝗtes	lat̃i noĩis duodecĩ milia sexcẽti eꝗtes
quoꝝfortioꝑaadũsusceltiberosliisususꝗnt᷒fului᷒eẽt	quoꝝ forti oꝑa adũsus celtiberos liis usus ꝗnt᷒ fului᷒ eẽt
quossiuideret᷑secũdeportaret⁊suplicatõesdec̃te	quos si uideret᷑ secũ deportaret ⁊ suplicatões dec̃te
ꝙisꝓspererempublicã	ꝙ is ꝓspere rem publicã
gesisset⁊	gesisset ⁊
cet̃itoresĩ	cet̃i tores ĩ
ꝓuĩciasꝗntofabiobutroniꝓrogatũingalliã	ꝓuĩcias ꝗnto fabio butroni ꝓrogatũ in galliã
imꝑiũẽ	imꝑiũ ẽ
octolegionesterex̃citũuet̃emꝗĩligurib.ĩ	octo legiones ter ex̃citũ uet̃em ꝗ ĩ ligurib. ĩ
speꝓpinquamissiõiserãteo	spe ꝓpinqua missiõis erãt eo
ãnoeẽplacuit	ãno eẽ placuit
⁊isipeex̃cit᷒	⁊ is ipe ex̃cit᷒
egreexplebat᷑ꝑꝑpestilentiaq̃t̃ciũ	egre explebat᷑ ꝑꝑ pestilentia q̃ t̃ciũ
iããnu	iã ãnu
urbẽroͣnaatqitaliã	urbẽ roͣna atq italiã
uastabattortit᷒minuti᷒⁊hautitaml̃to	uastabat tor tit᷒ minuti᷒ ⁊ haut ita ml̃to
p᷒ꝯsulgne᷒calfurni᷒	p᷒ ꝯsul gne᷒ calfurni᷒
morit᷑ml̃tiqaliiõiuordinũillustresuiripost̃moꝓdigiiloco	morit᷑ ml̃tiq alii õiu ordinũ illustres uiri post̃mo ꝓdigii loco
eacladesh̃riceptagne᷒ẜuili᷒pontifexmaxi᷒piaculaire	ea clades h̃ri cepta gne᷒ ẜuili᷒ pontifex maxi᷒ piacula ire
deũꝯꝗr̃eiussixuirilibros	deũ ꝯꝗr̃e iussi x uiri libros
inspic̃eꝯsulapol̃iexculapiosalutis	inspic̃e ꝯsul apol̃i exculapio salutis
donauouere⁊daresignaĩaurataq̃uouitdeditqx	dona uouere ⁊ dare signa ĩaurata q̃ uouit deditq x
uirisuplicationẽĩbiduũualitudinisc̃a	uiri suplicationẽ ĩ biduũ ualitudinis c̃a
⁊ꝑõiaforaꝯciliabulaq	⁊ ꝑ õia fora ꝯciliabulaq
edixeruntNUncitaqquoniamprincipaleserroresnõhabentiũ	edixerunt NUnc itaq quoniam principales errores nõ habentiũ
legẽin	legẽ in
premissahui᷒opusculiꝑtesatisuidẽtureuersi	premissa hui᷒ opusculi ꝑte satis uidẽtur euersi
Adiugulandũerroreslegem	Ad iugulandũ errores legem
habentiũEritulteriusinsistendũPorroiudeiint̃legẽ	habentiũ Erit ulterius insistendũ Porro  iudei int̃ legẽ
h̃ntesPrimũ	h̃ntes Primũ
sibiarrogant	sibi arrogant
locũpͥmiĩhacẜaparteaggrediẽdisuntSciendum	locũ pͥmi ĩ hac ẜa parte aggrediẽdi sunt Sciendum
igit᷑Q̃diudeisscissuradecẽtribuũhocnom̃inposuitAntea	igit᷑ Q̃d iudeis scissura decẽ tribuũ hoc nom̃ inposuit Antea
quippehebreiul̃ysraeldicebãturExquoautẽinduo	quippe hebrei ul̃ ysrael dicebãtur Ex quo autẽ in duo
regnapopulusillediuisus	regna populus ille diuisus
estQuicũqexeisreges	est Quicũq ex eis reges
habuerũtdestirpeiudeseudetribuiudaIudeid	habuerũt de stirpe iude seu de tribu iuda Iudei d
dictisũtDecemuõtrib.etquicũq	dicti sũt Decem uõ trib. et quicũq
insamariaIhẽoboamregẽsibi	in samaria Ihẽoboam regẽ sibi
constituerũtIsraelisuntuocatiQuib.yeroboãduosuitulosaureos	constituerũt Israel i sunt uocati Quib. yeroboã duos uitulos aureos
fatiẽsUnũposuitindanetalteꝝinbethel	fatiẽs Unũ posuit in dan et alteꝝ in bethel
DixitqeisregnũtelorũSedtamen	Dixitq eis regnũ telorũ Sed tamen
dc̃iIudeiexpectauerunt⁊crediderunt	dc̃i Iudei expectauerunt ⁊ crediderunt
uenturũsicutpatreseorũ	uenturũ sicut patres eorũ
antiquicrediderũtEttñininferno	antiqui crediderũt Et tñ in inferno
fuerũtEtquisiuixissent	fuerũt Et qui si uixissent
usqadtempus	usq ad tempus
aduentusꝓphetexp̃itãtũ	aduentus ꝓphete xp̃i tãtũ
credidissentipixp̃mquãtum	credidissent ipi xp̃m quãtum
etisticrediderũt	et isti crediderũt
Cũxp̃sꝓph̃ãaggrauaredebebatcordaIudeorũeteorũoculos	Cũ xp̃s ꝓph̃ã aggrauare debebat corda Iudeorũ et eorũ oculos
excecareetauresclaudereutysa.viEtperconsequens	excecare et aures claudere ut ysa. vi Et per consequens
crederenonpoterant	credere non poterant
utIo.xiiNonneantiqui	ut Io. xii Nonne antiqui
pr̃eseorũĩterfecer̃tsanctosꝓph̃as	pr̃es eorũ ĩterfecer̃t sanctos ꝓph̃as
etiãadeomissos	etiã a deo missos
sicutysayametIeremiãetaliosꝙͣpluressed	sicut ysayam et Ieremiã et alios ꝙͣ plures sed
tñdictiantiquiet	tñ dicti antiqui et
sanctipatresininfernodãpnatifuerunt	sancti patres in inferno dãpnati fuerunt
insanguĩetestam̃tisaluatideinfernoergoetisti	in sanguĩe testam̃ti saluati de inferno ergo et isti
DicitemichioIusticiaquidhabuitsignificaredelatere	Dicite michi o Iusticia quid habuit significare de latere
xp̃iiudicisnostrisanguĩemetclarãaquamemanasseAitIusticia	xp̃i iudicis nostri sanguĩem et clarã aquam emanasse Ait Iusticia
nescioAitmisericordiaPostꝙͣnescistedoceboEt	nescio Ait misericordia Postꝙͣ nescis te docebo Et
aitipasãguĩeillefuitsanguisfederisde	ait ipa sãguĩe ille fuit sanguis federis de
quosupͣdc̃mestInquosanguĩeom̃escircũcisos	quo supͣdc̃m est In quo san guĩe om̃es circũcisos
nonpreuaricatoreslegiset	non preuaricatores legis et
adeoetlegisnonfornicatoreseduceredebebat	adeo et legis non fornicatores educere debebat
deinfernoAquaillafuitfederisgentiũ	de inferno Aqua illa fuit federis gentiũ
populiInquaaquaipedc̃asgentesinppl̃met	populi In qua aqua ipe dc̃as gentes in ppl̃m et
regnumdebebathereditareutysaye	regnum debebat hereditare ut ysaye
liiSicingloriosuseritinteruirosaspectus	lii Sic ingloriosus erit inter uiros aspectus
etformaeiusinterfilios	et forma eius inter filios
hoĩmipeasꝑgetgentesmultassuꝑip̃m	hoĩm ipe asꝑget gentes multas suꝑ ip̃m
cõtinebunt᷑regesossuũ	cõtinebunt᷑ reges os suũ
quiaquib᷒nonestnarratũnondeeouidebuntet	quia quib᷒ non est narratũ non de eo uidebunt et
quinonaudieruntcontemplatisuntetetiãipexp̃squi	qui non audierunt contemplati sunt et etiã ipe xp̃s qui
debuitexpͥmicũ	debuit expͥmi cũ
semperinteristosduospopulos	semper inter istos duos populos
fũitdistinctioutgẽxxvet	fũit distinctio ut gẽ xxv et
esterxdequibussanguĩeetaqua	ester x de quibus sanguĩe et aqua
habeturfiguraleuixiiiicinfine	habetur figura leui xiiii c in fine
ubisacerdoslegisinsanguĩeet	ubi sacerdos legis in sanguĩe et
aquisuiuentibaspergebatleprosũ	aquis uiuentib aspergebat leprosũ
etmũdabaturItaxp̃elegissacerdos	et mũdabatur Ita xp̃e legis sacerdos
aspergensdesuo	aspergens de suo
lateresanguĩem⁊	latere sanguĩem ⁊
aquãuiuammũdũ	aquã uiuam mũdũ
leꝓsũinpc̃tismũdauit⁊mũdabitAsillusquos	leꝓsũ in pc̃tis mũdauit ⁊ mũdabit As illus quos
dicisdetribussceleribusetde	dicis de tribus sceleribus et de
quarto⁊c̃TuIusticiadebesscireteOratio	quarto ⁊c̃ Tu Iusticia debes scire te Oratio
sanctiambrosiiquedebetdiciantemissam	sancti ambrosii que debet dici ante missam
Summesacerdosetuerepontifexquiteobtulistideopatri	Summe sacerdos et uere pontifex qui te obtulisti deo patri
hostiampuramet	hostiam puram et
immaculataminaracrucispronobismiseris	immaculatam in ara crucis pro nobis miseris
pcc̃oribusquiqdedistinobiscarnemtuamadmanducandumetsanguinem	pcc̃oribus quiq dedisti nobis carnem tuam ad manducandum et sanguinem
tuũadbibendumetposuistimisteriumistud	tuũ ad bibendum et posuisti misterium istud
inuirtutespiritussãctidicenshecquocienscũqfeceritisin	in uirtute spiritus sãcti dicens hec quocienscũq feceritis in
meimemoriamfaNecletheosseuaperamnesUosfata	mei memoriam fa Nec letheos seua per amnes Uos fata
trahentsedcũ	trahent sed cũ
sũmasExigethorasconsumptadiesIteradsuperosgl̃ia	sũmas Exiget horas consumpta dies Iter ad superos gl̃ia
pandetSedtudomitormagneferaꝝOrbisqsiml̃pacatorades	pandet Sed tu domitor magne feraꝝ Orbisq siml̃ pacator ades
Nũcquoqnr̃asrespiceterrasEtsiqua	Nũc quoq nr̃as respice terras Et si qua
nouabeluauultuQuatietppl̃osterroregrauiTu	noua belua uultu Quatiet ppl̃os terrore graui Tu
fulminib.frangetrisulcisFortiusipogenitoretuoFulminamittesExpliciunt	fulminib. frange trisulcis Fortius ipo genitore tuo Fulmina mittes Expliciunt
TragedieSeneceDeo	Tragedie Senece Deo
GraciasAmenScripteacconpletepermanus	Gracias Amen Scripte ac conplete per manus
IohãnisTenNordedeDoetinchemClericiTraiecteñdyoc̃SubAnno	Iohãnis Ten Norde de Doetinchem Clerici Traiecteñ dyoc̃ Sub Anno
dñiMͦccccͦviiiiDie	dñi Mͦ ccccͦ viiii Die
decimanonaMensisIanuariiEpitaphiu	decimanona Mensis Ianuarii Epitaphiu
SeneceCuralabormeritusũptiꝓmunerehonoresItealias	Senece Cura labor meritu sũpti ꝓ munere honores Ite alias
posthancsolicitateanimasMeproculauob̃	post hanc solicitate animas Me procul a uob̃
deuseuocatilicetactis	deus euocat ilicet actis
RebusterrenishospitaterraualeCorpusauaratñsolẽpnib.	Rebus terrenis hospita terra uale Corpus auara tñ solẽpnib.
accipesaxisNamqaĩamceloreddim᷒ossatibi	accipe saxis Namq aĩam celo reddim᷒ ossa tibi
Expliciuntuocabulaugucionis	Expliciunt uocabula ugucionis
incipientiaaZXplicitExpositiouocabulorumexsententiaugutionis	incipientia a Z Xplicit Expositio uocabulorum ex sententia ugutionis
ꝯpilacioneIacobiꝯdamMag̃ri	ꝯpilacione Iacobi ꝯdam Mag̃ri
Isaacphisicide	Isaac phisici de
paduacompleta	padua completa
clugieAnnoxp̃iMcccxxiiidems̃	clugie Anno xp̃i Mcccxxiii de ms̃
nouembrisEt	nouembris Et
scriptaꝑmeIohannem	scripta ꝑ me Iohannem
ꝯdamd̃Siluestrideluxaueneciaruoriginariu	ꝯdam d̃ Siluestri de luxa ueneciaru originariu
⁊teruisiiciuempublicumImperialiAuct̃e	⁊ teruisii ciuem publicum Imperiali Auct̃e
notarium⁊tũcCancelariumMagnifici⁊	notarium ⁊ tũc Cancelarium Magnifici ⁊
potentisdñidñiNicolaiMudatioproẜenisimo⁊excellentissimoducali	potentis dñi dñi Nicolai Mudatio pro ẜenisimo ⁊ excellentissimo ducali
dñioveneciaꝝtociusInsulecretehonorabiliscapitañgeneralis⁊	dñio veneciaꝝ tocius Insule crete honorabilis capitañ generalis ⁊
CompletaInciuitatecandideAnnonatiuitatisdñinr̃iih̃u	Completa In ciuitate candide Anno natiuitatis dñi nr̃i ih̃u
xp̃iMccccxiiIndic̃quĩtadieSabati	xp̃i Mccccxii Indic̃ quĩta die Sabati
xviimensisdecembrisciosa	xvii mensis decembris ciosa
qualiasuntõiasignamortẽꝓnosticiaQueuõinparte	qualia sunt õia signa mortẽ ꝓnosticia Que uõ in parte
auferũtuelauferrisignificant	auferũt uel auferri significant
utsignanũciãtiatorturãuelꝑalisimautappoͣ̃	ut signa nũciãtia torturã uel ꝑalisim aut appoͣ̃
uelcardiacãaͭ	uel cardiacã aͭ
sil̃iapessimaquidẽsunts	sil̃ia pessima quidẽ sunt s
mĩorismalicieꝙͣillaquecisemortẽꝓnosticãtDe	mĩoris malicie ꝙͣ illa que cise mortẽ ꝓnosticãt De
qͥbom̃ibspãlr̃ꝑtractãenõ	qͥb om̃ib spãlr̃ ꝑtractãe nõ
spectatintͦduconumpñtiũformesiuetenorispredc̃isꝯtenti	spectat intͦduconum pñtiũ forme siue tenori s predc̃is ꝯtenti
gr̃asr̃ferimdñoih̃uxp̃o	gr̃as r̃ferim dño ih̃u xp̃o
qͥꝯsid̃acõesintͦductoriaspͥmepartis	qͥ ꝯsid̃acões intͦductorias pͥme partis
menequetheoricadr̃dadimpleuitEt	mene que theorica dr̃d adimpleuit Et
quiiãinr̃giͭͦsanitatisnr̃o⁊	qui iã in r̃giͭͦ sanitatis nr̃o ⁊
affomisde	affomis de
Ingeniosanitatis	Ingenio sanitatis
h̃undanterinchoauitconsid̃acões	h̃undanter inchoauit consid̃acões
praticenecc̃as⁊sꝑamcũdeuocõeꝙ	pratice necc̃as ⁊ sꝑam cũ deuocõe ꝙ
ipeꝑficietinꝯtodc̃oꝝaffoꝝ	ipe ꝑficiet in ꝯto dc̃oꝝ affoꝝ
⁊inaliisaffomisꝑticuter	⁊ in aliis affomis ꝑticuter
expͥmentibquepermedicũsapientemconsid̃anda	expͥmentib que per medicũ sapientem consid̃anda
suntinmorbisquoꝝdãm̃brorumꝑticuriuminquib	sunt in morbis quoꝝdã m̃brorum ꝑticurium in quib
uelutinexemplo	uelut in exemplo
siuespeculoclarouiarc̃ꝓcessus	siue speculo claro uia rc̃ ꝓcessus
incetẽisaꝑtissimecognoscaͬacũctisamatõibusũitatisducentumparuulos	in cetẽis aꝑtissime cognoscaͬ a cũctis amatõibus ũitatis ducentum paruulos
aduiamqueducitad	ad uiam que ducit ad
xp̃mQuiconuertifecerit	xp̃m Qui conuerti fecerit
peccatoremaberroreuie	peccatorem ab errore uie
suesaluabitaĩameiusamorteetoperitmultitudinem	sue saluabit aĩam eius a morte et operit multitudinem
peccatorumExhocuerbo	peccatorum Ex hoc uerbo
traherepotuitgregorius	trahere potuit gregorius
nullumessedeoaccepciussacrificiumꝙͣ	nullum esse deo accepcius sacrificium ꝙͣ
zelumanimarumꝙsitanta	zelum animarum ꝙ si tanta
sollicitudinisinquietudinesitotuigiliisetcuriisĩmortalibuspermedia	sollicitudinis inquietudine si tot uigiliis et curiis ĩmortalibus per media
uitepericulaquerunthominessaluate	uite pericula querunt homines saluate
resuanasiamiam	res uanas iam iam
periturassicolligeresataguntuilesterrenarũopum	perituras si colligere satagunt uiles terrenarũ opum
sarcinulasquasapostolusarbitrabaturutstercoraEt	sarcinulas quas apostolus arbitrabatur ut stercora Et
dumhecaguntlaudanturutindustriiutdiligẽtes	dum hec agunt laudantur ut industrii ut diligẽtes
utofficiosiet	ut officiosi et
utilesreipublice	utiles rei publice
Uideteoro	Uidete oro
quantaestuelinherciauelinfidelitasdeanimarumĩmortaliumsalute	quanta est uel inhercia uel infidelitas de animarum ĩmortalium salute
noncurarexp̃ianosymoqualis	non curare xp̃ianos ymo qualis
illaestimpudentissimaperuersitaseosinculpareDñsqnuncapertis	illa est impudentissima peruersitas eos inculpare Dñs q nunc apertis
nuncoccultisprepedirequiducereparuulos	nuncoccultis prepedire qui ducere paruulos
satagũtaiatArdisTantaardebat	satagũt aiat Ardis Tanta ardebat
curautarchitectopermiserituel	cura ut architecto permiserit uel
utsuãpecuniam	ut suã pecuniam
consumeretdũmodoperduceretspecus	consumeret dũmodo perduceret specus
epistrinisinmareabiectamolequaestusbisquotidieab	epistrinis in mare abiecta mole qua estus bis quotidie ab
exorͭalunaadproximũ	exorͭa luna ad proximũ
nouãintroireacredirerursusinmarepossetac	nouã introire ac redire rursus in mare posset ac
refrigerarepiscinasNoscumhęc&ecce	refrigerare piscinas Nos cum hęc & ecce
strepitusdestraatq.leua	strepitus destra atq. leua
candidatusnosterdesignatusĘdilis	candidatus noster designatus Ędilis
adestaduillãCuinos	adest ad uillã Cui nos
occidimus&gratulatiĩCapitoliũpersequimurIlloinde	occidimus & gratulati ĩ Capitoliũ persequimur Illo inde
cunctosuãdomũnosnostrã	cuncto suã domũ nos nostrã
Oppinioninostrosermone	Oppinioni nostro sermone
depastioneuillaticasumatimhocquẽexposuihabito	de pastione uillatica sumatim hoc quẽ exposui habito
MTerrenciiUarronisrerũrusticarumdeuillaticispastionibus	M Terrencii Uarronis rerũ rusticarum de uillaticis pastionibus
liberterciusexplicitfeliciter1414MTC	liber tercius explicit feliciter 1414 M T C
EPISTOLARŨADATTICŨLXIIIINCIPITFELICITERCICEROatticosal.	EPISTOLARŨ AD ATTICŨ L XIII INCIPIT FELICITER CICERO attico sal.
Adciceronemitascripsistiutneqseuerius	Ad ciceronem ita scripsisti ut neq seuerius
neqtemperatiusscribipotueritnecmagisꝙͣquẽado	neq temperatius scribi potuerit nec magis ꝙͣ quẽad o
modũego	modũ ego
maximeuellemprudentissimeet̃adtulliosquareaut	maxime uellem prudentissime et̃ ad tullios quare aut
istaproficientautaliudagamus	ista proficient aut aliud agamus
Depecunia	De pecunia
uͦuideoateomnẽdiligentiamadhiberi	uͦ uideo a te omnẽ diligentiam adhiberi
uelpotiusiamadhibitãesseefficisatehortoshabeo	uel potius iam adhibitã esse efficis a te hortos habeo
necuͦullumgenuspossessionisestquodmalimmaximescilicet	nec uͦ ullum genus possessionis est quod malim maxime scilicet
obeamcausamquaesusceptaestcuiusfestinationemihitollis	ob eam causam quae suscepta est cuius festinatione mihi tollis
qm̃deestatepolliceris	qm̃ de estate polliceris
uelpotiusrecipisdeindeet̃adκαταβί	uel potius recipis deinde et̃ ad καταβί
uitãMarciTullii	uitã Marci Tullii
CiceroniscontraCatilinamOracionesiiiiorQuo	Ciceronis contra Catilinam Oraciones iiiior Quo
usqtandem	usq tandem
abut̃ecatilinapac̃ianr̃aQuãdiufuroristetuusnos	abut̃e catilina pac̃ia nr̃a Quãdiu furor iste tuus nos
eludetQuẽ	eludet Quẽ
adfinemeffrenatasese	ad finem effrenata sese
iactabitaudaciaNichilnenocturnũpresidiũpalaciinichilurbis	iactabit audacia Nichil ne nocturnũ presidiũ palacii nichil urbis
vigilienichiltimoresppl̃inichilconcursus	vigilie nichil timores ppl̃i nichil concursus
bonoꝝoĩmnichilhicmunitissim᷒	bonoꝝ oĩm nichil hic munitissim᷒
habendisenatusloc᷒nich̃	habendi senatus loc᷒ nich̃
hoꝝorauultusqmouerũtPateretuaconsilia	hoꝝ ora uultusq mouerũt Patere tua consilia
nonsentisConstrictãiamhoꝝomniũsciencia	non sentis Constrictã iam hoꝝ omniũ sciencia
tenericoniuracionẽ	teneri coniuracionẽ
tuãnõuidesQͥdꝓximaquid	tuã nõ uides Qͥd ꝓxima quid
superiorinocteegerisubifuerisquidconsilii	superiori nocte egeris ubi fueris quid consilii
ceperisquoscõuocauerisquẽnr̃mignorarearbitrarisOtp̃rao	ceperis quos cõuocaueris quẽ nr̃m ignorare arbitraris O tp̃ra o
moressenat᷒hocintelligitconsuluidethictamenuiuituiuit	mores senat᷒ hoc intelligit consul uidet hic tamen uiuit uiuit
Immoueroinsenatũuenitfit	Immo uero in senatũ uenit fit
publicicõsiliiparticepsNotat⁊	publici cõsilii particeps Notat ⁊
designatoculis	designat oculis
adcedẽunũqͤnqnr̃mNosautẽfortesuiri	ad cedẽ unũqͤnq nr̃m Nos autẽ fortes uiri
satisfac̃ereipubliceuidem᷑si	satisfac̃e rei publice uidem᷑ si
istiustelaacfuroremuitem᷒Ad	istius tela ac furorem uitem᷒ Ad
mortemtecatilinaduciiussuconsulisiãpͥdemoportebat	mortem te catilina duci iussu consulis iã pͥdem oportebat
Intecõferri	In te cõferri
pestemistam	pestem istam
ꝙͣtuĩnos	ꝙͣ tu ĩ nos
om̃siãmachinarisAnuerouiramplissim᷒	om̃s iã machinaris An uero uir amplissim᷒
pscipiopõtifexmaxim᷒tiberinũgracchũmediocriterlabefactãte	p scipio põtifex maxim᷒ tiberinũ gracchũ mediocriter labefactãte
statũr.paepͥuatusinterfecitCatilinaueroorbemterrecede	statũ r. pae pͥuatus interfecit Catilina uero orbem terre cede
atqincendiͦuastare	atq incendiͦ uastare
cupientẽnos	cupientẽ nos
ꝯsulesperferem᷒Namillanimisantiqͣpret̃eoq̃dqser	ꝯsules perferem᷒ Nam illa nimis antiqͣ pret̃eo q̃dq ser
caderetUoluitenĩinexcelsum	caderet Uoluit enĩ in excelsum
leuariadconiũutruente	leuari ad co niũ ut ruente
illũde	illũ de
excelsooculiom̃iũꝑuigitur	excelso oculi om̃iũ ꝑui gitur
estiniquitaselatõnisutinaltũselime	est iniquitas elatõnis ut in altũ se lime
seerigatSedsc̃aoratioomnẽhumiamuniũsamdeicit	se erigat Sed sc̃a oratio omnẽ humi am uniũsam deicit
uanitatẽItemsermo	uanitatẽ Item sermo
BEatoꝝmartyrũclara	BEatoꝝ martyrũ clara
gestaetsminafideliumincitam̃ta	gesta et s mina fidelium incitam̃ta
sunteArmantur	sunt e Armantur
enĩfilioꝝanimidũp	enĩ filioꝝ animi dũ p
turtriumphiClamatutiqxp̃ianoꝝcorpioꝝ	tur triumphi Clamat utiq xp̃ianoꝝ cor pioꝝ
sanguissp̃ualiũbellatoꝝqͣntũamartria	sanguis sp̃ualiũ bellatoꝝ qͣntũ amar tria
hecMaioraũhisestcaritasxiiii	hec Maior aũ his est caritas xiiii
Sectaminicaritatẽ	Sectamini caritatẽ
Emulaminisp̃ualiamagisautẽutꝓph̃etisQͥ	Emulamini sp̃ualia magis autẽ ut ꝓph̃etis Qͥ
enĩloquitur	enĩ loquitur
linguanõhõibloquit᷑	lingua nõ hõib loquit᷑
seddeoNemoenĩauditSp̃saũloquiturmyst̃ia	sed deo Nemo enĩ audit Sp̃s aũ loquitur myst̃ia
Nãquiꝓph̃at	Nã qui ꝓph̃at
hõibloquituradedificatõem	hõib loquitur ad edificatõem
etexhortatõemet	et exhortatõem et
consolationẽQͥ	consolationẽ Qͥ
loquiturlinguasemetip̃medificatQͥautemꝓph̃at	loquitur lingua semet ip̃m edificat Qͥ autem ꝓph̃at
eccl̃amdeiedificatUoloaũ	eccl̃am dei edificat Uolo aũ
uosom̃sloquilinguismagisaũproph̃areNam	uos om̃s loqui linguis magis aũ proph̃are Nam
maiorestquiproph̃atquã	maior est qui proph̃at quã
quiloquiturlinguanisiforteinterteturuteccl̃aedificatõemaccipat	qui loquitur lingua nisi forte intertetur ut eccl̃a edificatõem accipat
Nuncaũfr̃essi	Nunc aũ fr̃es si
ueñoad	ueño ad
uoslinguisloquensquiduoꝓdero	uos linguis loquens quid uoꝓdero
nisiuobisloquaraut	nisi uobis loquar aut
inreuelatõeautinscĩaaumenetillesũ	in reuelatõe aut in scĩa au men et illesũ
ĩuẽitGestaãthuisc̃iiulianiadintegrũ	ĩuẽit Gesta ãt hui sc̃i iuliani ad integrũ
habereneqͥuimadmanũSC̃ebrigideuirg̃is	habere neqͥuim ad manũ SC̃e brigide uirg̃is
kl̃isfebroariiexgestiseiusBEatabrigidaortafuit	kl̃is febroarii ex gestis eius BEata brigida orta fuit
ĩscociadebonaꝓsapiaexpatredubtocho	ĩ scocia de bona ꝓsapia ex patre dubtocho
matrebrocaꝓgehec	 matre broca ꝓgehec
asuapuericiabonaꝝ	a sua puericia bonaꝝ
rerumstudiisinoleuitpudicicieac	rerum studiis inoleuit pudicicie ac
sobrietatiintentasemꝑdebonisadmeliora	sobrietati intenta semꝑ de bonis ad meliora
crescebatetabipapuellarietate	crescebat et ab ipa puellari etate
uirtutũsignis	uirtutũ signis
extititadmirandaCũ	extitit admiranda Cũ
enĩamatresuatrãsmissa	enĩ a matre sua trãsmissa
eẽtutdeuaccaꝝlacte	eẽt ut de uaccaꝝ lacte
butirumcõgregaretetadpondusredderetsicutalie	butirum cõgregaret et ad pondus redderet sicut alie
puelleĩillisregionibfac̃esolebãt	puelle ĩ illis regionib fac̃e solebãt
heciamtũcuirgohospitalismagisuolẽsobediredeo	hec iam tũc uirgo hospitalis magis uolẽs obedire deo
ꝙͣhõibpauꝑibhospitib᷒tamlacꝙͣbutirum	ꝙͣ hõib pauꝑib  hospitib᷒ tam lac ꝙͣ butirum
largit᷑distribuerecepitEtcumtp̃saduenissetut	largit᷑ distribuere cepit Et cum tp̃s aduenisset ut
om̃sredderentfructumuaccaꝝ	om̃s redderent fructum uaccaꝝ
cooꝑatriceseiusmonstraueruntoꝑasuacõpletaUentumestadbrigidam	cooꝑatrices eius monstrauerunt oꝑa sua cõpleta Uentum est ad brigidam
utredderetopussuũQuenonhabensquid	ut redderet opus suũ Que non habens quid
redderettotũpauꝑib᷒erogauerattimorematrispauidatotamse	redderet  totũ pauꝑib᷒ erogauerat timore matris pauida totam se
cõINnominedominiamen	cõ IN nomine domini amen
Pateatuniuersis	Pateat uniuersis
sensinstrumẽtumpublicuminspecturisq̃dannodñimillesimo	sens instrumẽtum publicum inspecturis q̃d anno dñi millesimo
trecentesimotͥcesimoseptimodieuicesimasextamensis	trecentesimo tͥcesimo septimo die uicesima sexta mensis
IuniiindictõnequintaPontificat᷒sanctissimiinxp̃o	Iunii indictõne quinta Pontificat᷒ sanctissimi in xp̃o
pr̃isacdñinr̃idñibñdicti	pr̃is ac dñi nr̃i dñi bñdicti
sacͦsancteRomaneacuniuersaliseccesũmipontificisxiianno	sacͦsancte Romane ac uniuersalis ecce sũmi pontificis xii anno
t̃cioapd̃monasteriumsancti	t̃cio apd̃ monasterium sancti
petͥdecult᷑acenom̃ordinissanctibñdicticapitulo	petͥ de cult᷑a cenom̃ ordinis sancti bñdicti capitulo
ꝓuincialiAllatummonast̃ioꝝmonachoꝝnigroꝝꝓuincie	ꝓuinciali Allatum monast̃ioꝝ monachoꝝ nigroꝝ ꝓuincie
rothomageñetturoneñauct̃eapl̃icacongregatofuitinmei	rothomageñ et turoneñ auct̃e apl̃ica congregato fuit in mei
infrascriptipublicinotariiettestiumsubscriptoꝝsenciaexꝑte	infrascripti publici notarii et testium subscriptoꝝ sencia ex ꝑte
ueñabiliumpatrumdñoꝝd̃igr̃amaiorismoͣst̃iituroñetsancti	ueñabilium patrum dñoꝝ d̃i gr̃a maioris moͣst̃ii turoñ et sancti
florenciidesalmuroaudegaueñdioc̃	florencii de salmuro audegaueñ dioc̃
adidꝑsedemapl̃icamspecialr̃deputatoꝝabAgnelli	ad id ꝑ sedem apl̃icam specialr̃ deputatoꝝ ab Agnelli
debentimmolariquiaagnusfuturus	debent immolari quia agnus futurus
ẽcrucifigiquitollitpcc̃amundiSoues	ẽ crucifigi qui tollit pcc̃a mundi S oues
ululãtmr̃esquiaagnosꝑduntsñ	ululãt mr̃es quia agnos ꝑdunt sñ
uocebalantesGrandemartiriũcrudelespectaculũlc̃vͣEximiturmachera	uoce balantes Grande martiriũ crudele spectaculũ lc̃ vͣ Eximitur machera
nullaint̃uenͭ	 nulla int̃uenͭ
c̃aSolastridetinuidiacũquinatusẽnullifaciat	c̃a Sola stridet inuidia cũ qui natus ẽ nulli faciat
uiolenciãSouescernimusmr̃es	uiolenciã S oues cernimus mr̃es
quesuꝑantagnos	que suꝑant agnos
lugentesUoxinramaauditaẽploratus	lugentes Uox in rama audita ẽ ploratus 
ululatusmagnus	ululatus magnus
pignorasuntnõcreditasedcreatanõdepositasedexposita	pignora sunt nõ credita sed creata nõ deposita sed exposita
testisẽipan᷑aquepugnabat	testis ẽ ipa n᷑a que pugnabat
inmr̃escũtyrãn᷒iactaretĩfãteslc̃vͣ	in mr̃es cũ tyrãn᷒ iactaret ĩfãtes lc̃ vͣ
MatercrinescapitisdissipabatqueornamentũcapitisamͭtebatQuantismodis	Mater crines capitis dissipabat que ornamentũ capitis amͭtebat Quantis modis
infantẽuolebatabscondere	infantẽ uolebat abscondere 
ipeseinfantuluspublicabatNesciebat	ipe se infantulus publicabat Nesciebat
tac̃e,quiaciamineternuAmen	tac̃e , quia ciam in eternu Amen
AmenExplicitor̃osc̃i	Amen Explicit or̃o sc̃i
ambrosiiquedicit᷑antemissamOrateprohenricopauꝑe	ambrosii que dicit᷑ ante missam Orate pro henrico pauꝑe
clericoquicõpleuit	clerico qui cõpleuit
hũclibrumAnnodñiMͦcccͦ	hũc librum Anno dñi Mͦ cccͦ
xlͦviiiͦIncrastinofesti	xlͦ viiiͦ In crastino fe sti
bt̃imartinihyemalisProdñoludowico	bt̃i martini hyemalis Pro dño ludowico
decanometñeccl̃ierigritaꝝ	decano metñ eccl̃ie rigritaꝝ
GetuloꝝqpassimuagantiumNelittoraꝗinfecundas̃t	Getuloꝝq passim uagantium Ne littora ꝗ infecunda s̃t
p᷑pura&	p᷑pura &
muriceefficass̃isadtingendum&ubiqq̃ĩtinxereclarissima	murice efficass̃is ad tingendum & ubiq q̃ ĩtinxere clarissima
Reliqͣestoramauritanięext̃ior&	Reliqͣ est ora mauritanię ext̃ior &
ĩfinẽsuifastigãtisseafricęnouissimusangulusiisdem	ĩ finẽ sui fastigãtis se africę nouissimus angulus iisdem
opibussminusdiuesCęt̃um	opibus s minus diues Cęt̃um
soloditiõ&ad̃oestfertilisutfrugũgñanõ	solo ditiõ & ad̃o est fertilis ut frugũ gña nõ
cũserant᷑modobenignissimeꝓcreet	cũ serant᷑ modo benignissime ꝓcreet
sq̃damꝓfũdat&̃notahicAntheus	s q̃dam ꝓfũdat &̃ nota hic Antheus
regnassedicit᷑Etsignũq̃dfabulęprorsusõnditurclaꝝ	regnasse dicit᷑ Et signũ q̃d fabulę prorsus õnditur claꝝ
collismodicusresupinihõis	collis modicus resupini hõis
imagĩeiacẽtisilliusutĩcolęferũttumulusUndeuͥaliqͣ	imagĩe iacẽtis illius ut ĩcolę ferũt tumulus Unde uͥ aliqͣ
ꝑserupta	ꝑs erupta
estsolentimbressꝑgi&doneceffossarepleant᷑	est solent imbres sꝑgi & donec effossa repleant᷑
euẽiunthoĩumꝑssiluas	euẽiunt hoĩum ꝑs siluas
freq̃ntãtminusꝙͣquosm̃odiximusuagi	freq̃ntãt minus ꝙͣ quos m̃o diximus uagi
ꝑsĩurbibusagũtqͣꝝutĩt̃ꝑuasopulẽtissimęh̃nt᷑	ꝑs ĩ urbibus agũt qͣꝝ ut ĩt̃ ꝑuas opulẽtissimę h̃nt᷑
proculamariGilodanoDulbritaniaꝓpiusautemsola&	procul a mari Gilodano Dulbritania ꝓpius autem sola &
lixiofluminilimoꝓximaUltraestcolonia&	lixio flumini limo ꝓxima Ultra est colonia &
fluuiusGnaEtundeinitiumfecimus	fluuius Gna Et unde initium fecimus
Ampelusiaĩnostrũiamfretum	Ampelusia ĩ nostrũ iam fretum
uergensꝓmontoriũoꝑishuius	uergens ꝓmontoriũ oꝑis huius
atatlanticilittoristerminus	at atlantici littoris terminus
ΤέλοςXXIIIIAprilis1450AntheusAntheitulusGNAfl	Τέλος XXIIII Aprilis 1450 Antheus Anthei tu lus GNA fl
Ampelusiarenturinanesaliquefuissequefurtieẽntexcicatesic	Ampelusia rentur inanes alique fuisse que furti eẽnt excicate sic
tuet̃sicq̃dscribes	tu et̃ sic q̃d scribes
scribitotm̃	scribito tm̃
nefurtũcessationisquesimilevideasUaldeeĩmi	ne furtũ cessationis que simile videas Ualde eĩ mi
semꝑetueraetdulcia	semꝑ et uera et dulcia
tuisepl̃is	tuis epl̃is
nũcianturAmanosetualeQuintusCiceroTironisuo	nũciantur Ama nos et uale Quintus Cicero Tironi suo
sal̃p.dicit	sal̃ p. dicit
MIrificauimi	MIrificaui mi
uerberationemcessatiõisepl̃adedistiNamquefraterꝑtiusꝑscripserat	uerberationem cessatiõis epl̃a dedisti Nam que frater ꝑtius ꝑscripserat
uerecondiauet	uerecondia u et
proꝑationeeãtusineassensioneuterantde	proꝑatione eã tu sine assensione ut erant de
mescripsisti	me scripsisti
etmaximecoss.designatisquosegopẽitusnoui	et maxime coss. designatis quos ego pẽitus noui
libidinũetlangoriseteffeminatissimi	libidinũ et langoris et effeminatissimi
ãiplenosquiubiagubernaculisrecesẜintmaxĩuabuniuerso	ãi plenos qui ubi a gubernaculis recesẜint maxĩu ab uniuerso
naufragioꝑiculũestIncredibileestqueegoillosscioappoĩtis	naufragio ꝑiculũ est Incredibile est que ego illos scio appoĩtis
gallorucastrisĩestiuisfecissequosille	galloru castris ĩ estiuis fecisse quos ille
latroubialiquidfirmiusfuitsocietateuitiorũdelinietRes	latro ubi aliquid firmius fuit societate uitiorũ deliniet Res
estauttribunicisconsiliisminuendaNam	est aut tribunicis consiliis minuenda Nam
istiduouixsuntdigniquibusalteriCossutiͣnarumtabernarum	isti duo uix sunt digni quibus alteri Cossutiͣnarum tabernarum
fundamentacredasTeutdixifere	fundamenta credas Te ut dixi fere
celerisEgouosadIIIIkl̃uidebotuosqoculoset	celeris Ego uos ad IIII kl̃ uidebo tuosq oculos et
siteuenies	si te uenies
ĩmedioforo	ĩ medio foro
uideodissamabor.MeamaUale	uideo dissamabor . Me ama Uale
LXVDeoGratiasAmen1450ciscentisdomini	LXV Deo Gratias Amen 1450 ciscentis domini
iniutãneceminterfectus&huicmaiorutroqhanibalimperatorAmilcaris	iniutã necem interfectus & huic maior utroq hanibal imperator Amilcaris
filiussucceditsiquidẽresgestasutriusqsuꝑgressusuniuersamhyspaniãdomuit	filius succedit siquidẽ res gestas utriusq suꝑgressus uniuersam hyspaniã domuit
Inderomanisillatobelloytaliam	Inde romanis illato bello ytaliam
ꝑannossexdecimuariiscladibusfatigauit	ꝑ annos sexdecim uariis cladibus fatigauit
CumintereaRomanimissisinhyspaniaScipionibusprimopoenosprouincia	Cum interea Romani missis in hyspania Scipionibus primo poenos prouincia
expuleruntposteacũipsishyspanis	expulerunt postea cũ ipsis hyspanis
grauiabellagesserunt	grauia bella gesserunt
Necpriusꝑdomiteprouincieiugumq	Nec prius ꝑdomite prouincie iugumq
hyspaniaccipere	hyspani accipere
potueruntꝙͣCesarAugustusperdomito	potuerunt ꝙͣ Cesar Augustus perdomito
orbeuictriciaad	orbe uictricia ad
eosarmatranstulitpopulumqferumacbarbarumlegibusadcultiorem	eos arma transtulit populumq ferum ac barbarum legibus ad cultiorem
uiteusumtraductum	uite usum traductum
informãprouincieredegitDEO	in formã prouincie redegit DEO
GRATIASHISPANIIUSTINIXXXXIIIIorUOLUMINUMTROGIPOMPEI	GRATIAS HISPANI IUSTINI XXXXIIIIor UOLUMINUM TROGI POMPEI
ABREVIATORISLIBEREXPLICITScriptumpermedominicũMacth̃ide	ABREVIATORIS LIBER EXPLICIT Scriptum per me dominicũ Macth̃i de
ReatemanuꝓͥaREATEMCCCCLIII	Reate manu ꝓͥa REATE MCCCCLIII
IIIIkl̃Maii	IIII kl̃ Maii
RISSIMUMIMPERATOREM	RISSIMUM IMPERATOREM
ACILLUSTRISSIMUMPRINCIPEMCOMITEMFRANCISCUMSFORTIAMVICECOMITEMFrancisciAleardiueronẽsis	AC ILLUSTRISSIMUM PRINCIPEM COMITEM FRANCISCUM SFORTIAM VICECOMITEM Francisci Aleardi ueronẽsis
laudatioNONdubito	laudatio NON dubito
foreꝑmultosPrincepsillustrissimequirerumtuarũ	fore ꝑ multos Princeps illustrissime qui rerum tuarũ
magnitudinemadmiratipręstanti	magnitudinem admirati pręstanti
ingeniouiri	ingenio uiri
litteriset	litteris et
monumentissuiseasmandareetillustrareconabunturpartimutgratiam	monumentis suis eas mandare et illustrare conabuntur partim ut gratiam
tuãquamuelsũmisopibusuelamplissĩsdiuitiis	tuã quam uel sũmis opibus uel amplissĩs diuitiis
meritoanteponantfaciliuscõsequantur	merito anteponant facilius cõsequantur
Partimutintuisrebusmendandisuelingenia	Partim ut in tuis rebusmendandis uel ingenia
suaexerceantuelintecollaudandomateriamnacticopiosissimam	sua exerceant uel in te collaudando materiam nacti copiosissimam
nomensuumquoq.ĩmortalitatitransmittantDeniq.nõincideret&uox	nomen suum quoq. ĩmortalitati transmittant Deniq. nõ incideret & uox
indeerupit&sanguissicutdocetOuidi᷒driadesuõ	inde erupit & sanguis sicut docet Ouidi᷒ driades uõ
s̃tquęĩterarboreshabitanthocaut̃adsuꝑioraꝑtinet	s̃t quę ĩter arbores habitant hoc aut̃ ad suꝑiora ꝑtinet
quędixeratmixtislustrabomenalanimphisNeccarmina	quę dixerat mixtis lustrabo menala nimphis Nec carmina
uobisipaplacẽt	uobis ipa placẽt 
dixeratcarminapastorissiculimodulaborauenaIpsę	dixerat carmina pastoris siculi modulabor auena Ipsę
rursuscõceditesiluęꝑꝑ	rursus cõcedite siluę ꝑꝑ
illudIammihiꝑrupesvideorlucosqsonãtesNec	illud Iam mihi ꝑ rupes videor lucosq sonãtes Nec
sifrigorib.mediuebrũqbibamusmanifestehoc	si frigorib. mediu ebrũq bibamus manifeste hoc
dicitamor̃secarer̃nõposse	dicit amor̃ se carer̃ nõ posse
Necsiebrum	Nec si ebrum
Tracięfluuiũmediisfrigorib.bibatnecestib.	Tracię fluuiũ mediis frigorib. bibat nec estib.
nimiisfiuntĩardẽtiꝓuinciadicit	nimiis fiunt ĩ ardẽti ꝓuincia dicit
aut̃hocẜmphisicos	aut̃ hoc ẜm phisicos
quimorbosautaꝯtrariisautasimilib.asserũt	qui morbos aut a ꝯtrariis aut a similib. asserũt
possedepelli	posse depelli
SitionasqniuesSitonmonsẽtracięlibercorticis	Sitionasq niues Siton mons ẽ tracię liber corticis
parsĩteriorUersemurpascamushecsat	pars ĩterior Uersemur pascamus hec sat
eritIamadmusasloquitur	erit Iam ad musas loquitur
gracilifiscellãtexit	gracili fiscellã texit
ibiscoacsidiceretnisi	ibisco ac si diceret nisi
hacreoccupat᷒minimecanerẽallegoricosaut̃significat	hac reoccupat᷒ minime canerẽ allegoricos aut̃ significat
secõposuissehunc	se cõposuisse hunc
libellũtenuissimostiloquãtum	libellũ tenuissimo stilo quãtum
uerenououiridissesubicitalnusAmoinquitGallũsed	uere nouo uiridis se subicit alnus Amo inquit Gallũ sed
latentersicutarborescrescũt	latenter sicut arbores crescũt
namoꝑatioistahocsignificatꝑꝑcęsarẽEt	nam oꝑatio ista hoc significat ꝑꝑ cęsarẽ Et
frugib.umbrę	frugib. umbrę
quãtomagishõib.uñ&̃ĩgeorgicis&auris	quãto magis hõib. uñ &̃ ĩ georgicis & auris
optatifp	optati f p
uItedomũSaturęuenithesꝑusitecapellęuerecũdese	u Ite domũ Saturę uenit hesꝑus ite capellę uerecũde se
capellaꝝdicitpastorẽ.i.uilissimoꝝanimaliuNambuccolica	capellaꝝ dicit pastorẽ .i. uilissimoꝝ animaliu Nam buccolica
scribẽsdebuitsedicer̃boum	scribẽs debuit se dicer̃ boum
eẽpastorẽsuitãsãogãtiamultimũse	eẽ pastorẽ s uitãs ãogãtiam ultimũ se
uoluiteẽprincipẽĩ	uoluit eẽ principẽ ĩ
scribẽdisbuccolicisfinisUiterbiiMͦCCCCLVmẽs̃maiiN.V	scribẽdis buccolicis finis Uiterbii MͦCCCCLV mẽs̃ maii N. V
pont̃MͦsedẽteEgoAngl̃us	pont̃ Mͦ sedẽte Ego Angl̃us
scarponi᷒scolarishũclibrũscripsiDeuassano	scarponi᷒ scolaris hũc librũ scripsi De uassano
scilicortañdioc̃cepitq̃iasonihocordinetͣdiditꝯseruanda	scilic ortañ dioc̃ cepit q̃ iasoni hoc ordine tͣdidit ꝯseruanda
Detͣditõe	De tͣditõe
Rerũadincãtand̃INpͥmis	Rerũ ad incãtand̃ IN pͥmis
tͣdiditeiquãd̃ymaginẽargenteãꝙͣdixit	tͣdidit ei quãd̃ ymaginẽ argenteã ꝙͣ dixit
esseꝑincantatõemnodos	esse ꝑ incantatõem nodos 
ml̃tiartificiiũtutecõstructamq̃adũsusincantatõesiãfc̃as	ml̃ti artificii ũtute cõstructam q̃ adũsus incantatões iã fc̃as
ẽualdepotissĩacassansuidel	ẽ ualde potissĩa cassans uidel
q̃fc̃aIam	q̃ fc̃a Iam
sũt&eoꝝ	sũt & eoꝝ
uotiuaexpulsionefinaliRepellensDehacgͥiasonẽsͨinstͧxit	uotiua expulsione finali Repellens De hac gͥ iasonẽ sͨ instͧxit
uteãcaute	ut eã caute
supͣsedeferatnãadũsusincantatõesqͣslualerese	supͣ se deferat nã adũsus incantatões qͣsl ualere se
scietuociuoꝝincantatõisuiribanl̃latisScd̃o	sciet uociuoꝝ incantatõis uirib anl̃latis Scd̃o
sͥtradidͭ	sͥ tradidͭ
cui᷒dãumguẽtiodoriferimedicamẽquoip̃mliuire	cui᷒dã umguẽti odoriferi medicamẽ quo ip̃m liuire
suasitasẜensineoũtutẽineẽutadũsus	suasit asẜens in eo ũtutẽ ineẽ ut adũsus
ꝯflãmasualde	ꝯflãmas ualde
ualeatextingatincendia⁊om̃eꝙh̃tpotenciãꝯburendiincessa	ualeat extingat incendia ⁊ om̃e ꝙ h̃t potenciã ꝯburendi incessa
fumositateResoluatDem̃ꝙͣdãanulũsͥdeditinquotalis	fumositate Resoluat Dem̃ ꝙͣdã anulũ sͥ dedit in quo talis
ũtutũlapiserat	ũtutũ lapis erat
inclususutq̃cũquenenacorriꝑẽt	inclusus ut q̃cũq uenena corriꝑẽt
corũnocum̃ta	corũ nocum̃ta
Repelleret⁊ꝙͣ	Repelleret ⁊ ꝙͣ
ueneniRabiesꝑfusaforsaninfic̃etuelutabaqͥs	ueneni Rabies ꝑfusa forsan infic̃et uelut ab aqͥs
innãdequa	in nã de qua
illũinstuxitut	illũ instuxit ut
ꝙͣpͥmũꝑueniretadboueslicoreillo	ꝙͣ pͥmũ ꝑueniret ad boues licore illo
ineoꝝora	in eoꝝ ora
ꝑfund̃et	ꝑfund̃et 
crebrisasꝑsionibirroraretInlicoreẽillohancineẽ	crebris asꝑsionib irroraret In licore ẽ illo hanc ineẽ
uirtutẽasẜuntutꝙͣpͥmũ	uirtutẽ asẜunt ut ꝙͣ pͥmũ
orabouminfũderent᷑exabillouelutq̃duiscosoglutino	ora boum infũderent᷑ ex ab illo uelut q̃d uiscoso glutino
sͨꝯpactaꝯstring̃ent᷑	sͨ ꝯpacta ꝯstring̃ent᷑
ĩunũꝙeoꝝaꝑtura	ĩ unũ ꝙ eoꝝ aꝑtura
nõtamdifficilis	nõ tam difficilis
ꝙͣimpossibiliseẽtinillissͨde	ꝙͣ impossibilis eẽt in illis  sͨ de
singl̃issuccessiuemedeaIasonẽdiligent̃instͧxitMedeagͥ	singl̃is successiue medea Iasonẽ diligent̃ instͧxit Medea gͥ
suisinstructionibdoctrinissͨdemũfinẽimposuitetdata	suis instructionib  doctrinis sͨ demũ finẽ imposuit et data
iasonilicentiaRecedẽdiañ	iasoni licentia Recedẽdi añ
dieicõminãtislucisaduent̃Iasonindecretãsͥ	diei cõminãtis lucis aduent̃ Iason in decretã sͥ
CamerãfurtiuispassibseRecepitInsurgẽtegͥ	Camerã furtiuis passib se Recepit Insurgẽte gͥ
Roseisaurorasplendorib	Roseis aurora splendorib
etsoleaureolucemodica	et sole aureo luce modica
Cacumĩamontiũillustranteiasonfutiuo	Cacumĩa montiũ illustrante iason futiuo
surgitathalamoin	surgit a thalamo in
comitiauidel	comitia uidel
h̃culissuoꝝ	h̃culis  suoꝝ 
oetisRegisadiuitsoliũ	oetis Regis adiuit soliũ
inquoipe	in quo ipe
Rexiamse	Rex iam se
Receꝑatml̃toꝝastantichoraulepalliotyriantino	Receꝑat ml̃toꝝ astanti choraule pallio tyriantino
quoilleuelutspolionobilitatisexultatmesalenomẽ	quo ille uelut spolio nobilitatis exultat mesale nomẽ
uxõisiamꝗdlineaspetitaᷤegyptoloquarQuidtyroet	uxõis iam ꝗd lineas petitaᷤ egypto loquar Quid tyro et
sydonatenuitateꝑlucidaᷤmicãtespũpuraplumãdidifficultateꝑ	sydona tenuitate ꝑ lucidaᷤ micãtes pũpura plumãdi difficultate ꝑ
nobilesdõatisũ	nobiles dõati sũ
atrabatitisbiripetitidonatibiricanussiniafricaneopesinscenaripri᷒	atrabatitis biri petiti donati biri canussini africane opes inscenari pri᷒
uiseEthecquideidcĩcoegoĩlitterasretuliꝙ	uise Et hec quide idcĩco ego ĩ litteras retuli ꝙ
futuroseditões	futuros editões
pudõetang̃etne	pudõe tang̃et ne
pr̃imoniasuaproscriptislegitimis	pr̃imonia sua pro scriptis legitimis
hr̃dib᷒mimisetbalteõib.deputarẽtHabemiamicemeũmim᷒	hr̃dib᷒ mimis et balteõib. deputarẽt Habe mi amice meũ mim᷒
ꝙegoutsepe	ꝙ ego ut sepe
dixinõeloquiẽtiecausa	dixi nõ eloquiẽtie causa
sedcũiositatis	sed cũiositatis
inlumẽEdidi	in lumẽ Edidi
idcipueagẽsutsiꝗseloquẽs	id cipue agẽs ut siꝗs eloquẽs
uelletfc̃aprĩcipureẜaremateriã	uellet fc̃a prĩcipu reẜare materiã
nõreꝗuir̃eth̃iturosmeoslibellosministroseloquiitequeso	nõ reꝗuir̃et h̃ituros meos libellos ministros eloquii te queso
sisꝯtẽtusnosq.sic	sis ꝯtẽtus nosq. sic
uoluissescriberemeli᷒ꝙͣpotuissecontẽdas	uoluisse scribere meli᷒ ꝙͣ potuisse contẽdas
FeLiCiTerAm̃	Fe Li Ci Ter Am̃
ExpliciteuiteDiuersoꝝPrĩcipũEtTyrãnoꝝAdiuo	Explicite uite Diuersoꝝ Prĩcipũ Et Tyrãnoꝝ A diuo
AdrianousqadNum̃ianum	Adriano usq ad Num̃ianum
FeliciterUt̃eFelixScript᷒fuitsubMillĩo	Feliciter Ut̃e Felix Script᷒ fuit sub Millĩo
cccͦLVIdemensefebr̃Et	cccͦ LVI de mense febr̃ Et
scripsiteum	scripsit eum
Frat̃ioh̃esdeCampagnolaRegiñdioc̃DeoG̃asAm̃Am̃	Frat̃ ioh̃es de Campagnola Regiñ dioc̃ Deo G̃as Am̃ Am̃
am̃PErcorrermiglioraqqOmaila	am̃ PEr correr miglior aqq Omai la
nauicelladelmioinChelasciadietroasemar	nauicella del mio in Che lascia dietro a se mar
Ecanterodiquelsecondo	E cantero di quel secondo
Ouel'umanospiritosipurE	Oue l ' umano spirito si pur E
disaliraddiodiuentadeMaquila	di salir a ddio diuenta de Ma qui la
mortapoesiriOsante	morta poesi ri O sante
musepoi	muse poi
cheuost	che uost
Equicaliope	E qui caliope
alquantosurSeghuitandoel	alquanto sur Seghuitando el
miocantoconquel	mio canto con quel
sonodichuilepicchemiseresentirolocolpo	sono di chui le picche misere sentiro lo colpo
talchedesperarꝑdonoDolcecolord'orientalzaphiro	tal che desperar ꝑdono Dolce color d ' oriental zaphiro
Ches'acolgeuanelserenoaspectoDilaerpuroinsino	Che s ' acolgeua nel sereno aspecto Dilaer puro insino
alprimo	al primo
giroAgliocchimeiricominciodilectotostoch	giro Agli occhi mei ricomincio dilecto tosto ch
'iouscidel'auramortaChe	' io usci de l ' aura morta Che
m'auiacontristatigli	m ' auia contristati gli
occhie'lpLobelpianetached	occhi e ' l p Lo bel pianeta che d
'amarconfortaFaceuatuctoriderl	' amar conforta Faceua tucto rider l
'orienteUelandoei	' oriente Uelando ei
pescich'eraminsua	pesci ch ' eram in sua
scortREuerendediscretõnis	scort REuerende discretõnis
dñomagr̃ohugonicantuariensisdñippͤnuncioinanglia	dño magr̃o hugoni cantuariensis dñi ppͤ nuncio in anglia
fraterNicolaustreueth	frater Nicolaus treueth
orRecõmendatõnehũiliReũenciã⁊honoremAntiquitataliq̃dexordiumsiue	or Recõmendatõne hũili Reũenciã ⁊ honorem Antiquitat aliq̃d exordium siue
ꝑcreationẽutcatholiciseuꝑIuno	ꝑ creationẽ ut catholici seu ꝑ Iuno
flagrationesseudiluuiasicutplatonici	flagrationes seu diluuia sicut platonici
noneodẽ	non eodẽ
eãualloIntercet̃osaut̃	eã uallo Inter cet̃os aut̃
maiorisuetustatisassertoresĩuẽsac̃dotibinsignẽint̃septẽsapientes	maioris uetustatis assertores ĩuẽ sac̃dotib insignẽ int̃ septẽ sapientes
SolonẽinstrucmeoSaimurbemegipciacãoctomilibannoꝝ	Solonẽ instruc meo Saim urbem egipciacã octo milib annoꝝ
tũcsteathenaꝝꝓcessitcondiciomilleãnis	tũc ste athenaꝝ ꝓcessit condicio mille ãnis
sml̃toantiquiorhiisfingit᷑	s ml̃to antiquior hiis fingit᷑
gensegcian᷒	gens eg cian᷒
inꝓlogoastronomiesue	in ꝓlogo astronomie sue
quiipolibrorari᷒inuenit᷑exꝑsona	qui ipo libro rari᷒ inuenit᷑ ex ꝑsona
sap̃ieꝑ	sap̃ie ꝑ
assentuiguisseSedhũcantiquitatispositionẽuelutfabulosisfitaugustin᷒	assent uiguisse Sed hũc antiquitatis positionẽ uelut fabulosis fit augustin᷒
deciuitatedeilibro	de ciuitate dei libro
12mononsolũquiaueritatisacrescͥpturedisso	12mo non solũ quia ueritati sacre scͥpture disso
hystoriisgrecoꝝquiint̃mũdi	hystoriis grecoꝝ qui int̃ mũdi
sapientesanteRomanos	sapientes ante Romanos
habitis̃tclarioresnimẽtadeclarãtdiscrepareꝙͣ	habiti s̃t clariores nimẽta declarãt discrepare ꝙͣ
pl̃imũĩueniturQuãdissonãciãdeclarãssancdocetquomͦut	pl̃imũ ĩuenitur Quã dissonãciã declarãs sanc docet quomͦ ut
liquetexquadã	liquet ex quadã
epl̃aquã	epl̃a quã
MatrisueOlimpiadiAlexandern	Matri sue Olimpiadi Alexander n
rioꝝRegnoascribũtegipciiannoꝝ5000ampli᷒	rioꝝ Regno ascribũt egipcii annoꝝ 5000 ampli᷒
cuigreci	cui greci
nõultra1300aittuqab	nõ ultra 1300 ait tuq ab
eod̃t̃minosuesumant	eod̃ t̃mino sue sumant
cõputatõnispͥncipiũ	cõputatõnis pͥncipiũ
uidelabexordioregni	uidel ab exordio regni
BENEDICTUSep̃usẜuus	B ENEDICTUS ep̃us ẜuus
ẜuorumdeiUeñfr̃iEp̃oMagaloñsalt̃	ẜuorum dei Ueñ fr̃i Ep̃o Magaloñ salt̃
⁊apl̃icã	⁊ apl̃icã
bñDudumadaudientiamnr̃iapl̃atusꝑuenitꝑlate	bñ Dudum ad audientiam nr̃i apl̃atus ꝑuenit ꝑlate
quodꝓeoꝙ	quod ꝓ eo ꝙ
inCastrodebrixiacoMagaloñdioc̃adtuam	in Castro de brixiaco Magaloñ dioc̃ ad tuam
Magal̃eccam&dilc̃mfiliũnobilemuirũRaymundumpetri	Magal̃ eccam & dilc̃m filiũ nobilem uirũ Raymundum petri
Militemdñm	Militem dñm
Agauteiusd̃dioc̃	Agaut eiusd̃ dioc̃
cõiterꝑtinẽteperquosdamiudic̃	cõiter ꝑtinẽte per quosdam iudic̃
secular̃cur̃cõisecceacnobil̃dictoꝝcontͣquadam	secular̃ cur̃ cõis ecce ac nobil̃ dictoꝝ contͣ quadam
Michaelemgaut͛ie	Michaelem gaut͛ie
etEmẽgardamdecarnic̃ac	et Emẽgardam de carnic̃ ac
Agnetẽfabricemulieresut	Agnetẽ fabrice mulieres ut
asserebat᷑sortilegas⁊maleficas	asserebat᷑ sortilegas ⁊ maleficas
c̃tushabitusꝓcessusfuerat⁊cõdempnacionissñiaꝓmulgataet	c̃tus habitus ꝓcessus fuerat ⁊ cõdempnacionis sñia ꝓmulgata et
executionimandatainofficiidilc̃ifiliiInquisitor	executioni mandata in officii dilc̃i filii Inquisitor
heretic̃prauitat̃inillispartibauct̃e	heretic̃ prauitat̃ in illis partib auct̃e
apl̃icadeputatiutdicebat᷑iudiciũ⁊cõtemptumpereũdem	apl̃ica deputati ut dicebat᷑ iudiciũ ⁊ cõtemptum per eũdem
Inquisitorseudemãdatosuocontͣnonullasꝑsonas	Inquisitor seu de mãdato suo contͣ nonullas ꝑsonas
c̃tifuerãtfacti	c̃ti fuerãt facti
ꝓcessusRoc̃tisexcaus̃tamde	ꝓcessus Ro c̃tis ex caus̃ tam de
totoꝓcessusuꝑmiss̃habito	toto ꝓcessu suꝑ miss̃ habito
perdc̃osIudic̃essecular̃ꝙͣꝓcessupredc̃opereũdemInquisitor̃	per dc̃os Iudic̃es secular̃ ꝙͣ ꝓcessu predc̃o per eũdem Inquisitor̃
ueldesuo	uel de suo
AdLuchinumuicecoͥtem	Ad Luchinum uicecoͥtem
mediolanidominu	mediolani dominu
cũpiratransmitteretincidenteregitdelaudib.italieARgolicas	cũ pira transmitteret incidenter egit de laudib. italie ARgolicas
sifamauolans	si fama uolans
uulgataꝑurbesArborisausoniequondam	uulgata ꝑ urbes Arboris ausonie quondam
dumsplenduitetasAurea	dum splenduit etas Aurea
,saturnoterrisregnantefuiss⁊Utreor	, saturno terris regnante fuiss⁊ Ut reor
eurysteusnũꝙͣtotferre	eurysteus nũꝙͣ tot ferre
laboresCogeretalcydem,suaditia	labores Cogeret alcydem , sua ditia
pomadraconiOrtulushesperidummale	poma draconi Ortulus hesperidum male
custoditushaberetHoc	custoditus haberet Hoc
potiusmandaretopusnecuinceret	potius mandaret opus nec uinceret
auruNatiuidulcorisopesFelitiusomniEslatiumtellure	auru Natiui dulcoris opes Felitius omni Es latium tellure
quidemfertilisoraItalie	quidem fertilis ora Italie
ꝙͣfuluaceres	ꝙͣ fulua ceres
uiridisq.mineruaPurpureusꝙͣbachusquãamat	uiridisq. minerua Purpureus ꝙͣ bachus quã amat
tufrõdea	tu frõdea
caprisFloreamellificisapib.	capris Florea mellificis apib.
pecoriq.uicissimPascuaetirriguislate	pecoriq. uicissim Pascua et irriguis late
pulcerrimapratisTuredolensortis	pulcerrima pratis Tu redolens ortis
uariisscatebrosametallisArborib.q.uirenssiluisumbrosauetustisante	uariis scatebrosa metallis Arborib.q. uirens siluis umbrosa uetustis ante
reclusumsubNuma	reclusum sub Numa
regeetuictaprimũcarthagineHincconuersusad	rege et uicta primũ carthagine Hinc conuersus ad
pacempronũin	pacem pronũ in
omniamalaetinluxumfluenssaeculumgrauib	omnia mala et in luxum fluens saeculum grauib
seuerisqlegibusmultiscoercuitOb	seuerisq legibus multis coercuit Ob
haectotfactaingentiadictatorꝑpetuusetpaterpatriędictus	haec tot facta ingentia dictator ꝑpetuus et pater patrię dictus
estTractatumetiaminsenatuan	est Tractatum etiam in senatu an
quiacondidissetimꝑiumromulusuocaretursedsanctiuserreuerentiusuisum	quia condidisset imꝑium romulus uocaretur sed sanctius er reuerentius uisum
estnomenaugustiut	est nomen augusti ut
scilicetiamdudumducolitterrasiponomine	scilicet iamdudum du colit terras ipo nomine
ettitulo	et titulo
consecret᷑LAnneiFloriliberultimusanno	consecret᷑ L Annei Flori liber ultimus anno
dñi1458IIInoñianuar̃Mlĩ	dñi 1458 III noñ ianuar̃ Mlĩ
DeolausEGOOMNIOFFICIOACPOTI᷒	Deo laus EGO OMNI OFFICIO AC POTI᷒
pietateerga	pietate erga
teceterissatisfacioomnibusmihi	te ceteris satisfacio omnibus mihi
ipsenunꝙͣsatisfacioTantaenimestmagnitudo	ipse nunꝙͣ satisfacio Tanta enim est magnitudo
tuorumergame	tuorum erga me
meritorumut	meritorum ut
quoniamtunisi	quoniam tu nisi
perfectarede	perfecta re de
menonconquiestiego	me non conquiesti ego 
idemintuacausanonofficiouitã	idem in tua causa non officio uitã
mihiesseacerbamputem	mihi esse acerbam putem
IncausahęcsuntHamoniusregis	In causa hęc sunt Hamonius regis
legatusapertepecunianosoppugnatResagiturpereosdemcompetitores	legatus aperte pecunia nos oppugnat Res agitur per eosdem competitores
perquoscumtuaderasagebaturRegiscausa	per quos cum tu aderas agebatur Regis causa
siquisunt	si qui sunt
quiuelintꝗ	qui uelint ꝗ
paucisuntomnesremadpompeium	pauci sunt omnes rem ad pompeium
deferriuoluntSenatusreligioniscalũniamnonreligionesedmaleuolentia&	deferri uolunt Senatus religionis calũniam non religione sed maleuolentia &
illiusregiaeLargitionisinuidiacõprobatPompeiumethortarietorare	illius regiae Largitionis inuidia cõprobat Pompeium et hortari et orare
etiamLiberiusaccusare	et iam Liberius accusare
etmonere	et monere
utmagnaminfamiamfugiatnondesistimusSedplanenecprecibus	ut magnam infamiam fugiat non desistimus Sed plane nec precibus
nr̃issi	nr̃is si
quidobcommissorumpenitenciameligitisuel	quid ob commissorum penitenciam eligitis uel
iniuriaamicisuestrisneanicomedeinferrisiniteSiceni	iniuria amicis uestris ne a nicomede inferri sinite Sic eni
faciẽtibusuobisauxiliacontraitalosregemnostrumlaturumpollicemur	faciẽtibus uobis auxilia contra italos regem nostrum laturum pollicemur
uelapparentemamiciciamsaltemdissoluiteuel	uel apparentem amiciciam saltem dissoluite uel
romamadiudiciumcontendamusunaSicpelopidaselocutusest	romam ad iudicium contendamus una Sic pelopidas elocutus est
Hiauteminsolenciisillumloquiarbitrantesmitridatemanicomedeet	Hi autem insolenciis illum loqui arbitrantes mitridatem a nicomede et
capadociaabstiñeimperantsestatimAriobarzanemineam	capadocia abstiñe imperant se statim Ariobarzanem in eam
reducturosessepelopidaminsuperabexercitucedere	reducturos esse pelopidam insuper ab exercitu cedere
iubentneculteriusadeosreuertinisiin	iubent nec ulterius ad eos reuerti nisi in
hisquemandataessent	his que mandata essent
permaneretrexInhunc	permaneret rex In hunc
mod̃tuleresentenciametdiscendentiabindepelopide	mod̃ tulere sentenciam et discendenti abinde pelopide
custodiamadhibuerenequempiamin	custodiam adhibuere ne quempiam in
itinereꝑuert̃etQuibusperactisconsiliatantibellineutiqexpectantesaut	itinere ꝑuert̃et Quibus peractis consilia tanti belli neutiq expectantes aut
utpopulonotafierentetgalatis	ut populo nota fierentet galatis
quiinasia	qui in asia
suntstatimmouent	sunt statim mouent
Verumquiapropiusipisexercitus	Verum quia propius ipis exercitus
aderatquemlucassiusasieproconsulretinebat	aderat quem lu cassius asie proconsul retinebat
etomnessocioꝝuiresĩunũ	et omnes socioꝝ uires ĩ unũ
conuenerantdispartitiscopiisunusquisqcastraponitCassiusbithinieet	conuenerant dispartitis copiis unusquisq castra ponit Cassius bithinie et
galacieinmedioinannisperinferiorabithi	galacie in medio in annis per inferiora bithi
Hocpriuilegiumadñoppͣnobisetecclesie	Hoc priuilegium a dño ppͣ nobis et ecclesie
nostreconcessumloquiturdeom̃ibusterriᷤquas	nostre concessum loquitur de om̃ibus terriᷤ quas
habeteccl̃a	habet eccl̃a
nr̃aubicumqsintAlexanderepiscopusseruusseruorumdeidilectisfiliis	nr̃a ubicumq sint Alexander episcopus seruus seruorum dei dilectis filiis
Andreedecanoeccl̃esancti	Andree decano eccl̃e sancti
auitieiusqfratribtampresentibquamfuturiscanonicesustituendis	auiti eiusq fratrib tam presentib quam futuris canonice sustituendis
inꝑpetuumQuotiens	in ꝑpetuum Quotiens
anobisilludpetiturquodreligioniethonestati	a nobis illud petitur quod religioni et honestati
condereet	condere et
petentiumdesideriiscongruuminpertirisuffragiumEaꝓpterdilectiindño	petentium desideriis congruum inpertiri suffragium Eaꝓpter dilecti in dño
filiiuestrisiustispostulationibclementer	filii uestris iustis postulationib clementer
annuimusetcũctaillũĩansos	annuimus et cũcta illũĩans os
d̃ilinguaignitasap̃iam	d̃i lingua ignita sap̃iam
ꝓmẽsfonsiugit͛sanitates	ꝓmẽs fons iugit͛ sanitates
emanãsQuimareĩmeabl̃ibgͤssib᷒sc̃ificastiQͥ	emanãs Qui mare ĩ meabl̃ib gͤssib᷒ sc̃ificasti Qͥ
t̃rãp᷑pureãtuocruorefecistiqͥceloscõmeastiuͥ	t̃rã p᷑pureã tuo cruore fecisti qͥ celos cõmeasti uͥ
ĩmediodiuineacieirefulgesĩsplendoreĩmarcessibilisgl̃ie	ĩ medio diuineaciei refulges ĩ splendore ĩmarcessibilis gl̃ie
splendesInexultatõneIocũditatisĩsaciabilis	splendes In exultatõne Iocũditatis ĩsaciabilis
gaudesh̃theodorusAugustinushocnom̃sortitusẽul̃	gaudes h̃ theodorus Augustinus hoc nom̃ sortitus ẽ ul̃
ꝑꝑethimologiãnõisꝓpt̃excellentiãdignitatisqm̃sic̃	ꝑꝑethimologiã nõis ꝓpt̃ excellentiã dignitatis qm̃ sic̃
ĩꝑatoraugustuscellebatõsregessicisteexcellit	ĩꝑator augustus cellebat õs reges sic  iste excellit
õsdoctoresẜꝙdicitremigi᷒undealii	õs doctores ẜ ꝙ dicit remigi᷒ unde alii
doctoresꝯꝑant᷑stellisdañxiiQui	doctores ꝯꝑant᷑ stellis dañ xii Qui
adiustĩamerudiuntml̃tossic̃stelle⁊c̃hicaut̃	ad iustĩam erudiunt ml̃tos sic̃ stelle ⁊ c̃ hic aut̃
ꝯꝑat᷑solisic̃pĩepl̃a	ꝯꝑat᷑ soli sic̃ p ĩ epl̃a
q̃deeocantat᷑qiͣsolrefulgenssic	q̃ de eo cantat᷑ qiͣ sol refulgens sic
iperefulsitintemplod̃iScd̃op̃p	ipe refulsit in templo d̃i Scd̃o p̃p
f̃uorẽdilectõisqm̃sic̃m̃sisaugustusualdeferuetestucaloris	f̃uorẽ dilectõis qm̃ sic̃ m̃sis augustus ualde feruet estu caloris
sic⁊ipeualdeĩcaluitignediuini	sic ⁊ ipe ualde ĩcaluit igne diuini
amorisuñipeĩlibroꝯfõnũ	amoris uñ ipe ĩ libro ꝯfõnũ
desedicitSagittaũastucormeũcaritatetua⁊	de se dicit Sagittaũas tu cor meũ caritate tua ⁊
c̃It̃ibidẽaliqñĩtromittismeĩ	c̃ It̃ ibidẽ aliqñ ĩtromittis me ĩ
affc̃mml̃tũ	affc̃m ml̃tũ
ĩusitatũĩtrorsusnescio	ĩusitatũ ĩtrorsus nescio
adqͣmdulcedinẽ	ad qͣm dulcedinẽ
q̃siꝑficiat᷑	q̃ si ꝑficiat᷑
ĩmenescioqͥderitꝙuitaista	ĩ me nescio qͥd erit ꝙ uita ista
nõeritT̃ciop̃pethymologiamnõisDicit᷑	nõ erit T̃cio p̃p ethymologiam nõis Dicit᷑
eĩaugustin᷒abaugeo⁊astimq̃d	eĩ augustin᷒ ab augeo ⁊ astimq̃d
ẽciuitasanaq̃dẽsursũIndeaug̃	ẽ ciuitas  ana q̃d ẽ sursũ Inde aug̃
qiͣaugenssuꝑnãciuitatẽuñdeeocantat᷑Quiualuit	qiͣ augens suꝑnã ciuitatẽ uñ de eo cantat᷑ Qui ualuit
amplificareciuitatẽc̃ul̃utdr̃dinglosario	amplificare ciuitatẽ  c̃ ul̃ ut dr̃d in glosario
aug̃dr̃dmagnificusfelixclarus	aug̃ dr̃d magnificus felix clarus
indoctrinafuit·H·magnificusĩuita	in doctrina fuit ·H· magnificus ĩ uita
