fecitconstantin᷒celebrariꝯciliumExpliciunttitulilibripͥmiIncip̃	fecit constantin᷒ celebrari ꝯcilium Expliciunt tituli libri pͥmi Incip̃
lib̃IOratioallocutoria	lib̃ I Oratio allocutoria
sozomeniadtheodosiũĩꝑatorAiuntantiquispͥncipibdiligentiestudium	sozomeni ad theodosiũ ĩꝑator Aiunt antiquis pͥncipib  diligentie studium
fuisseuteis	fuisse ut eis
amatoresqͥdemornam̃toꝝpurpuramatq	amatores qͥdem ornam̃toꝝ purpuram atq
coronamethissimiliapararentLibroꝝ	 coronam et his similia  pararent Libroꝝ
uͦh̃ntesintentionemcircaquasdãfabulasoccupati	uͦ h̃ntes intentionem circa quasdã fabulas occupati
conscͥptionesagerent	conscͥptiones agerent
queaudientiumcorda	que audientium corda
mulc̃entPorrobellasectantesutsagittamoportune	mulc̃ent Porro bella sectantes ut sagittam oportune
dirigerentbestiamꝓsternerent	dirigerent bestiam ꝓsternerent
lanceãbñ	lanceã bñ
iacularent᷑autequũdecent̃ascenderentPresentabãt᷑enimsingl̃iregalib	iacularent᷑ aut equũ decent̃ ascenderent Presentabãt᷑ enim singl̃i regalib
eoꝝstudentesrebillis	 eoꝝ studentes reb  illis
q̃forentgratissimedñatuiAuusitaq̃lapidesciososdifficile	q̃ forent gratissime dñatui Auus itaq̃ lapides  ciosos difficile
comꝑtosofferebatalt̃tincturampurpuraclariorẽplurimipoemataautdiũsas	comꝑtos offerebat alt̃ tincturam purpura clariorẽ plurimi poemata aut diũsas
conscͥptionesinsinuabantaliusbonacingl̃autoptimũarmoꝝpandebatusum	conscͥptiones insinuabant alius bona cingl̃ aut optimũ armoꝝ pandebat usum
maximauͦetimꝑialisputabat᷑h᷒popularis	maxima uͦ et imꝑialis putabat᷑ h᷒ popularis
Antoninirequireagapiti	Antonini req uire agapiti
uiragiulphirequiremalcelliUigl̃	uir agiulphi req uire malcelli Uigl̃
sc̃iBertiniutinuigl̃sc̃iiacobiIndies̃	sc̃i Bertini ut in uigl̃ sc̃i iacobi In die s̃
BertiniOM̃IPS̃sempiternedeus	Bertini OM̃IPS̃ sempiterne deus
quimirabiliterfulgesinelectistuis	qui mirabiliter fulges in electis tuis
quostehabitatoreglorificareuoluisticoncedenosqs̃	quos te habitatore glorificare uoluisti concede nos qs̃
beatipatrisnr̃iBertiniitasollempniauenerari	beati patris nr̃i Bertini ita sollempnia uenerari
utei᷒suffragantib	ut ei᷒ suffragantib 
meritistemplũtuummereamur	meritis templũ tuum mereamur
fieriPerSecretaMuneranr̃atibidñe	fieri Per Secreta Munera nr̃a tibi dñe
d̃sbeatiBertiniAURELIIAUGUSTINIDOCTORISLIBERI᷒	d̃s beati Bertini AURELII AUGUSTINI DOCTORIS LIBER I᷒
HYPPONIENSISEP̃IDECIUITATED̃IINCIP̃CONTR[A]	HYPPONIENSIS EP̃I DE CIUITATE D̃I INCIP̃ CONTR [ A ]
PAGANOSGL̃IOSISSIMAMCIUITATEMDEISIUE	PAGANOS GL̃IOSISSIMAM CIUITATEM DEI SIUE
INHOCTẼPORŨCURSUCŨINTERimpiosperegrinaturexfide	IN HOC TẼPORŨ CURSU CŨ INTER impios peregrinatur exfide
uiuenssiueinillastabilitatesedisęternęquamnuncexpectat	uiuens siue in illa stabilitate sedis ęternę quam nunc expectat
ꝑpacientiãquoadusqiustitiac̃uertat᷑in	ꝑ pacientiã quoadusq  iustitia c̃uertat᷑ in
iudiciũdeinceps	iudiciũ deinceps
adepturaꝑexcellentiãuictoriaultima&paceꝑfecta	adeptura ꝑ excellentiã uictoria ultima & pace ꝑfecta
hocoꝑead	hoc oꝑe ad
teinstituto&meaꝓmissionedebitodefendereaduersus	te instituto & mea ꝓmissione debito defendere aduersus
eosquic̃ditori	eos qui c̃ditori
ei᷒deossuosferuntfilikm̃eMARcelliNE	ei᷒ deos suos  ferunt fili km̃e MARcelliNE
suscepiMagnũopus	suscepi Magnũ opus
&arduũsedd̃sadiutornr̃Namscioquib	& arduũ sed d̃s adiutor nr̃ Nam scio quib 
EXPLIC̃TERCIAꝓpositioINCIPITQUARTAQUARTAPROPOSITIOESTADŨsariiquę	EXPLIC̃ TERCIA ꝓpositio INCIPIT QUARTA QUARTA PROPOSITIO EST ADŨsarii quę
&extremaduoseẽordines	& extrema duos eẽ ordines
ouium&hircoꝝalterũiustoꝝalterumpeccatoꝝ	ouium & hircoꝝ alterũ iustoꝝ alterum peccatoꝝ
aliosstare	alios stare
adextris	a dextris
aliosasinistris	alios a sinistris
&audireiustosVenitebenedicti	& audire iustos Venite benedicti
patͥsmeipossideteparatũuob̃	patͥs mei possidete paratũ uob̃
regnũaconstitutionemundiPeccatoribuͦdiciDiscedite	regnũ a constitutione mundi Peccatorib  uͦ dici Discedite
amemaledictiin	a me maledicti in
ignẽęt̃nũquiparat᷒ẽdiabolo&angelis	ignẽ ęt̃nũ qui parat᷒ ẽ diabolo & angelis
ei᷒Arborẽbonãnonposse	ei᷒ Arborẽ bonã non posse
fruct᷒malosfac͛enecmalãbonosUñ&saluator	fruct᷒ malos fac͛e nec malã bonos Uñ & saluator
loqͥt᷑adiudeosUosdepatrediaboloestis	loqͥt᷑ ad iudeos Uos de patre diabolo estis
&concuQVIA	& concu QVIA
LARGIENTEDÑOmissarum	LARGIENTE DÑO missarum
sollempniaterhodiecelebraturisum᷒loquidiudeeuangelica	sollempnia ter hodie celebraturi sum᷒ loqui diu de euangelica
lectionenonpossumus	lectione non possumus
sednosaliquiduelbreuiterdicereredemptorisnr̃i	sed nos aliquid uel breuiter dicere redemptoris nr̃i
natiuitasipsacõpellitQuidestqͦdnasciturodñomundus	natiuitas ipsa cõpellit Quid est qͦd nascituro dño mundus
describiturnisihocquod	describitur nisi hoc quod
aꝑtemonstratur	aꝑte monstratur
quiailleueniebatin	quia ille ueniebat in
carneqͥelectossuosascriber&in	carne qͥ electos suos ascriber & in
ęternitateCui	ęternitate Cui
contradereꝓbisꝑproph̃amdiciturDeleanturdelibro	contra de reꝓbis ꝑ proph̃am dicitur Deleantur de libro
uiuentiũ&cumiustisnon	uiuentiũ & cum iustis non
scribanturQuibene&iaminb&	scribantur Qui bene & iam in b &
hleemnascitur	hleem nascitur
B&hleemquippedomuspanisinterpretat᷑Ipsenamq	B & hleem quippe domus panis interpretat᷑ Ipse namq 
estqͥaitEgosumpanisuiuusqͥdecęlo	est qͥ ait Ego sum panis uiuus qͥ de cęlo
descendiLocusergoinqͦdñsnascereturdomus	descendi Locus ergo in qͦ dñs nasceretur domus
panisanteuocatusest	panis ante uocatus est
quiafuturũꝓfectoerat	quia futurũ ꝓfecto erat
utilleibi	ut ille ibi
ꝑmateriãcarnisapparer	ꝑ materiã carnis apparer
&quielectoꝝm̃tesinternasatietatereficer	& qui electoꝝ m̃tes interna satietate reficer
&Quinoninparentũmentisiudicans&	& Qui non in parentũ mentis iudicans &
uulnerabilipaternęconsolationisadhibensmedicinamSic	uulnerabili paternę consolationis adhibens medicinam Sic
illereuersusadsesusceptionem	ille reuersus ad se susceptionem
quamdilatamdoluitpacient̃	quam dilatam doluit pacient̃
expectauitMortemquoq	expectauit Mortem quoq 
Willelmiiuniorisquimagno	Willelmi iunioris qui magno
actriumphatori	ac triumphatori
anglorũWillelmopatrisuosuccesserateuidenti	anglorũ Willelmo patri suo successerat euidenti
uaticinioindicauit	uaticinio indicauit
Eratille	Erat ille
d̃iseruusgl̃oseopinionisanselm᷒cantu	d̃i seruusgl̃ose opinionis anselm᷒ cantu
ꝓmisitfueratPrescriptussiqui	ꝓmisit fuerat Prescriptus siqui
nationisinsistercui᷒dãmilitisin	nationis insister cui᷒dã militis in
statimqsubitaexpirauitSiciterminata	statimq  subita expirauit Sic i terminata
etaclaruit&cantquiꝑsequentis	et a claruit & cant qui ꝑsequenti s
redeundifaculcessitIdemd̃iseruusNonoportetaLXXma	redeundi facul cessit Idem d̃i seruus Non oportet a LXXma
usqinoct̃pasche&abaduentudñi	usq  in oct̃ pasche & ab aduentu dñi
usqp᷒theophaniãnupciascelebrari	usq  p᷒ theophaniã nupcias celebrari
Conuenientib᷒eisqͥhocsacram̃tũ	Conuenientib᷒ eis qͥ hoc sacram̃tũ
celebraredesiderantpͥmocauendũ&	celebrare desiderant pͥmo cauendũ &
diligentissimeẽ	diligentissime ẽ
inqͥrend̃nesitint̃eosaliqͥd	inqͥrend̃ ne sit int̃ eos aliqͥd
q̃dtanto	q̃d tanto
sacram̃topoᷤsiteẽcontrariũReqͥenduᷤẽętiã	sacram̃to poᷤsit eẽ contrariũ Reqͥenduᷤ ẽ ętiã
diligent̃asac̃dote	diligent̃ a sac̃dote
amboꝝid	amboꝝ id
÷uiriet	÷ uiri et
mulierisassensusQ̃dsiuotaamboꝝconuenerintsacerdoslecta	mulieris assensus Q̃d si uota amboꝝ conuenerint sacerdos lecta
cartasponsaliciibñdicatarrasdicensBENEDICdñehasarras	carta sponsalicii bñdicat arras dicens BENEDIC dñe has arras
quashodietradetfamulustuus	quas hodie tradet famulus tuus
inmanuancillętuęquemadmodũ	in manu ancillę tuę quem admodũ
benedixistiabraamcum	benedixisti abraam cum
sairaysaaccũRebecaiacob	saira ysaac cũ Rebeca iacob
cũrachelDona	cũ rachel Dona
suꝑeosdñe	suꝑ eos dñe
gr̃ambenedicPAPAVRBISROME	gr̃am benedic PAPA VRBIS ROME
EDITVSSCRIPTORISLIBRILECTORMEMORESTOSICARDIOrdoqualit̃in	EDITVS SCRIPTORIS LIBRI LECTOR MEMOR ESTO SICARDI Ordo qualit̃ in
Catholicaeccl̃amissacelebreturInpͥmisantiph̃a	Catholica eccl̃a missa celebretur In pͥmis antiph̃a
adintroitũDeindekiriel̃IIIͦxp̃el̃IIIͦkiriel̃	ad introitũ Deinde kiriel̃ IIIͦ xp̃el̃ IIIͦ kiriel̃
IIIͦPosteaGl̃ainexcelsisd̃odieb᷒	IIIͦ Postea Gl̃a in excelsis d̃o dieb᷒
festistantũmͦIndeor̃oSeqͥturEpl̃aDeindeGradal̃siue	festis tantũmͦ Inde or̃o Seqͥtur Epl̃a Deinde Gradal̃ siue
all̃aPosteaEugl̃mIndeOffertoriũPostomodũseqͥturor̃osuꝑ	all̃a Postea Eugl̃m Inde Offertoriũ Postomodũ seqͥtur or̃o suꝑ
obl̃aQuasubsilentiocompletasacerdosexpansismanib᷒	obl̃a Qua sub silentio completa sacerdos expansis manib᷒
excelsauocereuerenterdicatSUPEROBLATAOblata	excelsa uoce reuerenter dicat SUPER OBLATA Oblata
confessoristuicolumbanihonoresinttibinr̃agratalibamina&	confessoris tui columbani honore sint tibi nr̃a grata libamina &
nr̃arumapud	nr̃arum apud
tesupplicationumeffectumobtineãt	te supplicationum effectum obtineãt
*P*ADCOMPLENDṼFacnosquesumusdominebeati	* P * AD COMPLENDṼ Fac nos quesumus domine beati
confessoristuicolumbanidignesollempniacelebrarequilargitatis	confessoris tui columbani digne sollempnia celebrare qui largitatis
tuaepreuent᷒munerelaudabilisuitęcursumgloriosofinecompleuit	tuae preuent᷒ munere laudabilis uitę cursum glorioso fine compleuit
*P*EODEMDIE	* P * EODEM DIE
VIGILIASC̃ECECILIAEVIRGINISSANctęCECILIAEmr̃istuęquesumus	VIGILIA SC̃E CECILIAE VIRGINIS SANctę CECILIAE mr̃is tuę quesumus
domineintercessionibusnosfoueas&cuiusuenerabilemsollempnitatemnos	domine intercessionibus nos foueas & cuius uenerabilem sollempnitatem nos
tribuispreuenireob	tribuis preuenire ob
Incipitsecund᷒Postmortemuͦysaacfiliieius	Incipit secund᷒ Post mortem uͦ ysaac filii eius
inuicemhabitaculadiuiseruntnoneaqueacceperant&tenuerants	inuicem habitacula diuiserunt non ea que acceperant & tenuerant s
esauquidemebronciuitatemfratridanshabitauitin	 esau quidem ebron ciuitatem fratri dans habitauit in
seir&inidumearegnabatquamregionemasemetipso	seir & in idumea regnabat quam regionem a semetipso
itauocauitEdomenimnominatusest	ita uocauit Edom enim nominatus est
Quamnuncupationemhuiusmodiuenationis	Quam nuncupationem huiusmodi uenationis
causasortitusestAliquandolabore	causa sortitus est Aliquando labore
uenationisesuriens	uenationis esuriens
redibatdumadhucpuereẽtetateInueniensqfratremlentem	redibat dum adhuc puer eẽt etate Inueniensq  fratrem lentem
sibipreparantemad	sibi preparantem ad
prandiumrubeumcoloremnimishabentem&	prandium rubeum colorem nimis habentem &
proptereapotiusincitatusrogabatuteipreberetad	propterea potius incitatus rogabat ut ei preberet ad
cibumQuiuenderesibiprimatumpropt̃cibumꝑ	cibum Qui uendere sibi primatum propt̃ cibum ꝑ
eiusesuriemcimpulitfratrẽSICVTIN	eius esuriem cimpulit fratrẽ SICVT IN
DIVINISLITTERISdiuersalegunturcanticaita&sp̃usc̃o	DIVINIS LITTERIS diuersa leguntur cantica ita & sp̃u sc̃o
lam̃tationesdiuersęEt	lam̃tationes diuersę Et
sic̃ꝓpͥeappellaturlibersalomonis	sic̃ ꝓpͥe appellatur liber salomonis
canticacanticoꝝita	cantica canticoꝝ ita
&appellariqͤũtthreniiheremięlamentationeslam̃tationũsic̃omnino	& appellari qͤũtthreni iheremię lamentationes lam̃tationũ  sic̃ omnino 
celluntillainquibsponsusac	cellunt illa in quib  sponsus ac
sponsadulvibfruunturamplexibusita	sponsa dulvib  fruuntur amplexibus ita
&lam̃tationesistęhocĩnõedñiadmonem᷒qͣntũ	& lam̃tationes istę hoc ĩ nõe dñi admonem᷒ qͣntũ
posum᷒&cipim᷒	posum᷒ & cipim᷒
utqnͦauditisexponisacͣm̃tũ	ut qnͦ auditis exponi sacͣm̃tũ
scͥpt᷑ęnarrantiᷤquęgestas̃priusilludq̃dlectũ	scͥpt᷑ę narrantiᷤ quę gesta s̃ prius illud q̃d lectũ
ẽcredatissicgestũqͦmͦlectũ	ẽ credatis sic gestũ qͦmͦ lectũ
ẽnesubtractofundam̃toreigestęqͣsiinaere	ẽ ne subtracto fundam̃to rei gestę qͣsi in aere
quaeratiᷤedificare	quaeratiᷤ edificare
Abrahãpat̃nr̃homo	Abrahã pat̃ nr̃ homo
eratillistẽporib	erat illis tẽporib
fid̃liᷤcredensd̃oiustificat᷒exfidesic̃	 fid̃liᷤ credens d̃o iustificat᷒ ex fide sic̃
script᷑adic̃&uet᷒	script᷑a dic̃ & uet᷒
&nouaSuscep̃filiũdesara	& noua Suscep̃ filiũ de sara
uxoreiã	uxore iã
insenectute	in senectute
utͥsqc̃stitutiᷤ	utͥsq  c̃stitutiᷤ
exmagnadesꝑatiõe,sscd̃mhominẽQͥdaut̃	ex magna desꝑatiõe , s  scd̃m hominẽ Qͥd aut̃
dedeoñsꝑandũcuinichildifficileẽqͥ	de deo ñ sꝑandũ cui nichil difficile ẽ qͥ
sicfac̃magnaquomͦparuasicsuscitat	sic fac̃ magna quomͦ parua sic suscitat
mortuoᷤqͦmͦcreatuiuosSipictoreadẽ	mortuoᷤ qͦmͦ creat uiuos Si pictor eadẽ
artefac̃muremsudarioporrigit᷑adaltareq̃d	arte fac̃ murem sudario porrigit᷑ ad altare q̃d
sudariũponiturincornualta	sudariũ ponitur in cornu alta
Calixinlatere	Calix in latere
oblatainaltaricõponit᷑	oblata in altari cõponit᷑
ñposttergũLętanięitacęlebraᷠt᷑	ñ post tergũ Lętanię ita cęlebraᷠt᷑
inuigiliispaschęut	in uigiliis paschę ut
nr̃mosolimobtinuitidestpostbaptismũꝑ	nr̃ mos olim obtinuit id est post baptismũ ꝑ
sepnariũ&quinariũ&ternariũnumerumOFFICIALIS	sepnariũ & quinariũ & ternariũ numerum OFFICIALIS
LIBERGLORIOSISSIMEIMPERATORETMAGNIFICEN	LIBER GLORIOSISSIME IMPERATOR ET MAGNIFICEN
simeaccenties	sime ac centies
inuictissimead̃o	inuictissime a d̃o
coronatenecn&conseruateatqconseruandeseruusego	coronate nec n & conseruate atq  conseruande seruus ego
ur̃ALARIUS	ur̃ A LARIUS
quãuisminimusom̃iũAfficiebarolidesiderioutscirẽrationẽ	quãuis minimus om̃iũ Afficiebar oli desiderio ut scirẽ rationẽ
aliquãdeordinenr̃ęmissęquã	aliquã de ordine nr̃ę missę quã
consuętomorecęlebram᷒&ampliusex	consuęto more cęlebram᷒ & amplius ex
diuersitateqsoletfieriineahocest	diuersitate q solet fieri in ea hoc est
q̃daliquotiensunaepistolalegit᷑aliqͦtiens	q̃d aliquotiens una epistola legit᷑ aliqͦtiens
duę&cęterataliasimulqde	duę & cętera talia simulq  de
ceterisofficiisPręterita	ceteris officiis Pręterita
ꝓximpriis	ꝓxim priis
eoꝝuerbisutensquę	eoꝝ uerbis utens quę
aptaerantmeostudio	apta erant meo studio
temperauiInterdumautẽquęmanifestanondubiũuidebanturueraratione	temperaui Interdum autẽ quę manifesta non dubiũ uidebantur uera ratione
firmauiEtcontra	firmaui Et contra
quęq.ineiusdemlibrimarginelitterasdoctoꝝquospremisi	quęq . in eiusdem libri margine litteras doctoꝝ quos premisi
exinitio	ex initio
nominise	nominis e
regionefigerecurauiPropterquod	regione figere curaui Propter quod
legesecurus&ꝑfice	lege securus & ꝑfice
quęmonuideuotus	quę monui deuotus
ExplicitPROLOG᷒INCIPIVNTCAPITVLAIxp̃i	Explicit PROLOG᷒ INCIPIVNT CAPITVLA I xp̃i
cõmunionẽuerũcorpusei᷒&sanguinẽesseII	cõmunionẽ uerũ corpus ei᷒ & sanguinẽ esse II
Q̃dhocmysteriũxp̃inullusfideliũ	Q̃d hoc mysteriũ xp̃i nullus fideliũ
debeatignorareIIIQuidsintsacramentauelquare	debeat ignorare III Quid sint sacramenta uel quare
dicanturIIIIVtrũ	dicantur IIII Vtrũ
subfigura	sub figura
aninueritate	an in ueritate
hocmysticũfiatsacramentũVQuidsitinterimmolationesueterũ	hoc mysticũ fiat sacramentũ V Quid sit inter immolationes ueterũ
figurasq.legaliũ&int̃sacramentũdñicicorporis&sanguinis	figurasq . legaliũ & int̃ sacramentũ dñici corporis & sanguinis
puritatecelesisdesid̃iigaudentErateneũ	puritate celesis desid̃ii gaudent Erat eneũ
quiamultisũtqͥdicuntmenteseruiuim᷒legidei	quia multi sũt qͥ dicunt mente seruiuim᷒ legi dei
carneaut̃legipeccatiEratantetemplifores	carne aut̃ legi peccati Erat ante templi fores
positumquiapaucisuntquirenuntiantom̃ib	positum quia pauci sunt qui renuntiant om̃ib
q̃possidentutadostiumportic᷒appropinquentPortic᷒siqͥd̃	 q̃ possident ut ad ostium portic᷒ appropinquent Portic᷒ siqͥd̃
templiẽutsuꝑi᷒dixim᷒	templi ẽ ut suꝑi᷒ dixim᷒
renuntiatõmundiInhacporticudue	renuntiatõ mundi In hac porticu due
erigunt᷑colũpneunacastitatisalt̃asobͥetatis	erigunt᷑ colũpne una castitatis alt̃a sobͥetatis
utqͥmundorenuntiãtsobrie	ut qͥ mundo renuntiãt sobrie
⁊castedeouiuantPostporticumrenuntiatõnisseqͥt᷑templũ	⁊ caste deo uiuant Post porticum renuntiatõnis seqͥt᷑ templũ
recteꝯuconuersionisDealtariaureo⁊mensaaurea⁊	recte ꝯu conuersionis De altari aureo ⁊ mensa aurea ⁊
candelabroINhoctemploẽ	candelabro IN hoc templo ẽ
altareaureũestm̃saaureasunt⁊	altare aureũ est m̃sa aurea sunt ⁊
candelabradeauropurissimofactaInaltariaccendebant᷑thimiamata	candelabra de auro purissimo facta In altari accendebant᷑ thimiamata
inm̃sapanesponebant᷑incandelabrislucerneAltare	in m̃sa panes ponebant᷑ in candelabris lucerne Altare
aureũsuntcordaelectoꝝthimiamatabona	aureũ sunt corda electoꝝ thimiamata bona
oꝑaodorthimiamatũbonioꝑisexemplumFum᷒thimiamatũ	oꝑa odor thimiamatũ boni oꝑis exemplum Fum᷒ thimiamatũ
qͥsuꝑi᷒ascenditẽintentõ	qͥ suꝑi᷒ ascendit ẽ intentõ
oratõnisq̃ex	oratõnis q̃ ex
affectucordisaddesid̃andacelestiatenditm̃sauͦ	affectu cordis ad desid̃anda celestia tendit m̃sa uͦ
aureaẽdiuinascͥptura	aurea ẽ diuina scͥptura
panessuntapostolisiueeoꝝsuccessoresexquoꝝactib	panes sunt apostoli siue eoꝝ successores ex quoꝝ actib
tanqͣmexpanib	 tanqͣm ex panib
reficiunt᷑	 reficiunt᷑
fideliũmentes	fideliũ mentes
Quipanesꝓpositõnisꝯuenient̃possuntappellar	Qui panes ꝓpositõnis ꝯuenient̃ possunt appellar
quiaadimitandũꝓponunt᷑uniũsoorbiDecẽcandelabrasũtdecem	quia ad imitandũ ꝓponunt᷑ uniũso orbi Decẽ candelabra sũt decem
legisceptaluc̃nelumen	legis  cepta luc̃ne lumen
doctͥnePossunthec⁊	doctͥne Possunt hec ⁊
alit̃diciSitgͥaltare	alit̃ dici Sit gͥ altare
dilectõmensalectõcandeINCIPITPROLOG᷒IN	dilectõ mensa lectõ cande INCIPIT PROLOG᷒ IN
VITÃSC̃IAGERICIImpellitisme	VITÃ SC̃I AGERICI Impellitis me
actrahitisuiolentiaamabilifr̃skm̃i	ac trahitis uiolentia amabili fr̃s km̃i
utindiefestiuitatisSc̃i	ut in die festiuitatis Sc̃i
acuenerabilispatrisnr̃i	ac uenerabilis patris nr̃i
AGERICIdehortouirtutumipsiusfecundissimoquosdam	AGERICI de horto uirtutum ipsius fecundissimo quosdam
flosculosetuirentiaquęlibetodoramentadecerpameaq.	flosculos et uirentia quęlibet odoramenta decerpam eaq .
admensamleticięcõmunis	ad mensam leticię cõmunis
ferculolitterarumcõpositaofferamsicq.	ferculo litterarum cõposita offeram sicq .
repleamdesideriiur̃i	repleam desiderii ur̃i
appetitumparticulãq.bonam	appetitum particulãq . bonam
acceptamadño	acceptam a dño
uobisex	uobis ex
caritatecõmunicemBonaẽ	caritate cõmunicem Bona ẽ
aclaudabilisplutimũintentioEXPLICITDIESQUART᷒INCIP̃LIB̃QͥNT᷒	ac laudabilis plutimũ intentio EXPLICIT DIES QUART᷒ INCIP̃ LIB̃ QͥNT᷒
QVIVINDEMIAMCOLLIGITuasapriusquibusuinum	QVI VINDEMIAM COLLIGIT uasa prius quibus uinum
infundit᷑mundareconsueuitnesordesaliquauinigr̃amdecoloret	infundit᷑ mundare consueuit ne sordes aliqua uini gr̃am decoloret
Quidenĩprodestponeręuitę̃ordinefoderequot	Quid enĩ prodest ponerę uitę̃ ordine fodere quot
annisautaratrissulcosducereputare	annis aut aratris sulcos ducere putare
subrigereadiungereulmis&quodamconubiocopularesitanto	subrigere adiungere ulmis & quodam conubio copulare si tanto
laboreuina	labore uina
quesitainuasecoacescantmatutinosquoq	quesita in uase coacescant matutinos quoq 
solisort᷒siquisspectaredesideratemundat	solis ort᷒ si quis spectare desiderat emundat
ocl̃ossuosnequidpuluerisneqͥd	ocl̃os suos nequid pulueris neqͥd
purgam̃toꝝocl̃isei᷒insideat	purgam̃toꝝ ocl̃is ei᷒ insideat
quotuendishebetet᷑optut᷒neuealiquacaligonebulosacorporeosuisus	quo tuendis hebetet᷑ optut᷒ neue aliqua caligonebulosa corporeos uisus
spectantisob	spectantis ob
uestręquarehuncsermonẽ	uestrę quare hunc sermonẽ
necessehabuiuob̃ꝓmereExquohicsumuseuntesad	necesse habui uob̃ ꝓmere Ex quo hic sumus euntes ad
ęccl̃am&redeuntespauperesint̃pellantnos&dicunt	ęccl̃am & redeuntes pauperes int̃pellant nos & dicunt
utdicam᷒uob̃utaliqͥdaccipiantauob̃	ut dicam᷒ uob̃ ut aliqͥd accipiant a uob̃
Nosnouer̃l̃r̃tloquiuob̃&	Nos nouer̃ l̃ r̃t loqui uob̃ &
seuident	se uident
ñaccipereauob̃Inanit̃nosarbitranturlaborareinuob̃	ñ accipere a uob̃ Inanit̃ nos arbitrantur laborare in uob̃
Expectantaliquid&anob̃damus	Expectant aliquid & a nob̃ damus
quãtumhabem᷒damussicutpossumus	quãtum habem᷒ damus sicut possumus
Nũquidtam̃adeorũnecessitatẽsupplendãidoneisumus	Nũquid tam̃ ad eorũ necessitatẽ supplendã idonei sumus
Quiagͦadeorumnecessitatẽ	Quia gͦ ad eorum necessitatẽ
implendãidoneinonsumusuelad	implendã idonei non sumus uel ad
uoslegatiipsorũsumusAudistislaudastisd̃ogr̃as	uos legati ipsorũ sumus Audistis laudastis d̃o gr̃as
egistisSem̃accepistisũba	egistis Sem̃ accepistis ũba
reddidistisLaudes	reddidistis Laudes
istaeur̃ęgrauant	istae ur̃ę grauant
nospotius&inpericulũmittuntToleram᷒	nos potius & in periculũ mittunt Toleram᷒
illas&tremimus	illas & tremimus
int̃illasTam̃fr̃smeiistelaudesur̃ęfoliasunt	int̃ illas Tam̃ fr̃s mei iste laudes ur̃ę folia sunt
arborũfructusquęriturEXPLICITITEMEIUSDEMDEVERBIS	arborũ fructus quęritur EXPLICIT ITEM EIUSDEM DE VERBIS
DÑIINEUGL̃OSCD̃MMATH̃MDEPVEROCENTVRIONIS	DÑI IN EUGL̃O SCD̃M MATH̃M DE PVERO CENTVRIONIS
&VERBISEI᷒INDIGNṼSEPRESENTIADÑI	& VERBIS EI᷒ INDIGNṼ SE PRESENTIA DÑI
debitanr̃asic̃&nosdimittim᷒debitorib	debita nr̃a sic̃ & nos dimittim᷒ debitorib
nSꝑateresurrecturũ&	 n Sꝑa te resurrecturũ &
tc̃futurũ	tc̃ futurũ
om̃imͦsin	om̃i mͦ sin
peccatoQͥailleresurrex̃qͥ	peccato Qͥa ille resurrex̃ qͥ
pͥm᷒fuitsinepeccatoAuig	pͥm᷒ fuit sine peccato A uig
matutinasꝑanolidicereegoñsũ	matutina sꝑa noli dicere ego ñ sũ
dign᷒ꝓpt̃peccata	dign᷒ ꝓpt̃ peccata
ñesmultaapudillũredẽptioEtipse	ñ e s  multa apud illũ redẽptio Et ipse
redimetisr̃lexom̃ib	redimet isr̃l ex om̃ib 
iniqͥtatibei᷒EXPLIC̃DE	iniqͥtatib  ei᷒ EXPLIC̃ DE
PSAMOCENTESIMOVICESIMONONO	PSA MO CENTESIMO VICESIMO NONO
INCIPITDEPSALMOCENTESIMOTRICESIMOIN	INCIPIT DE PSALMO CENTESIMO TRICESIMO IN
ISTOPSALMOcõm̃dat᷑nob̃humilitasseuid̃i	ISTO PSALMO cõm̃dat᷑ nob̃ humilitas seui d̃i
&fideliscui᷒uocecantat᷑q̃dẽuniuersũ	& fidelis cui᷒ uoce cantat᷑ q̃d ẽ uniuersũ
corp᷒xp̃iSepeenĩadmonuim᷒	corp᷒ xp̃i Sepe enĩ admonuim᷒
caritatẽur̃am	caritatẽ ur̃am
ñqͣsiuni᷒	ñ qͣsi uni᷒
hominiscantantisucẽaccipideberesedom̃iũqͥ	hominis cantantis u cẽ accipi debere sed om̃iũ qͥ
s̃tinxp̃icorporeEtqͥainilli᷒	s̃t in xp̃i corpore Et qͥa in illi᷒
corpores̃tom̃stãquã	corpore s̃t om̃s tãquã
ihomoloqͥt᷑Etipseẽun᷒	i homo loqͥt᷑ Et ipse ẽ un᷒
qͥ&multis̃tMti	qͥ & multi s̃t Mti
enĩs̃tinseipsisun᷒s̃tinilloqͥun᷒	enĩ s̃t in seipsis un᷒ s̃t in illo qͥ un᷒
ẽIpsũẽetiãtẽplũd̃ideqͦ	ẽ Ipsũ ẽ etiã tẽplũ d̃i de qͦ
apl̃sdicitTẽpenĩd̃isc̃mẽq̃destisuos	apl̃s dicit Tẽp enĩ d̃i sc̃m ẽ q̃d estis uos
Om̃sqͥcredd̃tinxp̃m&siccred̃t	Om̃s qͥ credd̃t in xp̃m & sic cred̃t
utdiliganthocẽcredeinxp̃mdiligerexp̃mNON	ut diligant hoc ẽ crede in xp̃m diligere xp̃m NON
qͦmͦdemonesfontẽuenirentnͥ	qͦmͦ demones fontẽ uenirent nͥ
aliqͣdielauarent᷑	aliqͣ die lauarent᷑
Istũaut̃diempoti᷒adhoc	Istũ aut̃ diem poti᷒ ad hoc
electũqͦcenadñicaanniuersariecelebͣt᷑	electũ qͦ cena dñica anniuersarie celebͣt᷑
&qͥaconcessũẽhocbaptismũaccept᷑is	& qͥa concessũ ẽ hoc baptismũ accept᷑is
,multicũhislauareuoluer̃ieiuniũq	, multi cũ his lauare uoluer̃ ieiuniũq
laxarehisꝓutpotuidisputatimoneoeaquę	 laxare his ꝓut potui disputati moneo ea quę
locut᷒sũseruesqͣntũpotes	 locut᷒ sũ serues qͣntũ potes
utęccl̃ędprudentẽacpacificũfiliũAliaquęquęint̃rogasti	ut ęccl̃ę d prudentẽ ac pacificũ filiũ Aliaquę quę int̃rogasti
sidñsuolueritaliotẽpore	si dñs uoluerit alio tẽpore
expediamEXPLIC̃LIB̃	expediam EXPLIC̃ LIB̃
INCIPITII᷒ADEVNDẼIAÑDEC̃SVETVDINE	INCIPIT II᷒ AD EVNDẼ IAÑ DE C̃SVETVDINE
ĘCCL̃ĘDILECTISSIMO	ĘCCL̃Ę DILECTISSIMO
filioIanuarioAUgUSTINUSLectislitt͛istuis	filio Ianuario AUgUSTINUS Lectis litt͛is tuis
ubimecõmonuistiutdebitũredderẽderesiduisenodandisquestionib᷒	ubi me cõmonuisti ut debitũ redderẽ de residuis enodandis questionib᷒
qͣsiãlonge	qͣs iã longe
añquesiueras	añ quesiueras
gͣtissimũmͥatqkarissimũdesideriũIncipitsũmamagistͥ	gͣtissimũ mͥ atq  karissimũ desideriũ Incipit sũma magistͥ
alanideꝯfessioneet	alani de ꝯfessione et
penitenciaQuoniamcircaconfessionesaĩaꝝꝑicl̃asuntetdifficultatesqñ	penitencia Quoniam circa confessiones aĩaꝝ ꝑicl̃a sunt et difficultates qñ
emerguntId̃oadhonorem	 emergunt Id̃o ad honorem
d̃isc̃iq	d̃i sc̃iq
Nicholaiadfr̃mutilitatematqconfitentiũ	 Nicholai ad fr̃m utilitatem atq  confitentiũ
salutemtractatumbreuemdeconfessione	salutem tractatum breuem de confessione
conpilauisubcertistitulis	conpilaui sub certis titulis
singl̃aq̃circaꝯfessionemrequirũt᷑	singl̃a q̃ circa ꝯfessionem requirũt᷑
etincidũtcõcludensutfacili᷒lectorq̃	et incidũt cõcludens ut facili᷒ lector q̃
uelitualeatinuenireCui᷒tͣctat᷒rubricesunthe	uelit ualeat inuenire Cui᷒ tͣctat᷒ rubrice sunt he
IcapitulumQͦtemꝑeinceꝑitꝯfessio	I capitulum Qͦ temꝑe inceꝑit ꝯfessio
IIQuaresitinstitutaconfessioIIICuifaciendasitconfessio	II Quare sit instituta confessio III Cui facienda sit confessio
Quandosit	Quando sit
confitendumVQueprecipueĩꝯfessiõe	confitendum V Que precipue ĩ ꝯfessiõe
reqͥrũt᷑VIQ̃sintnecc̃aaduerãpeñiamVII	reqͥrũt᷑ VI Q̃ sint necc̃a ad uerã peñiam VII
Deallocutiõesac͛dotisetĩductiõeadꝯfitẽd̃VIIIDe	De allocutiõe sac͛dotis et ĩductiõe ad ꝯfitẽd̃ VIII De
cirꝯstanciisquaspcc̃ortenet᷑ꝯfiteri	cirꝯstanciis quas pcc̃or tenet᷑ ꝯfiteri
IXUtrumcirꝯstancieagrauentpcc̃mX	IX Utrum cirꝯstancie agrauent pcc̃m X
Deint̃rogationib	De int̃rogationib 
asac̃dotefaciendisXIDegeneribusabusionum	a sac̃dote faciendis XI De generibus abusionum
XIIDeofficio	XII De officio
etdebitosac̃dotisergapenitẽtesXIIIQͥspcc̃adimͭtat	et debito sac̃dotis erga penitẽtes XIII Qͥs pcc̃a dimͭtat
etꝑq̃mortaliasiueuenialiadimittãt᷑XIIIIDemodo	et ꝑ q̃ mortalia siue uenialia dimittãt᷑ XIIII De modo
penitencieꝓquolibetpeccatoXV	penitencie ꝓ quolibet peccato XV
QuedebentconsiderariininposionepenitencieNon·	Que debent considerari in inposione penitencie Non ·
H·nosmip̃osdicamuss	H · nosm  ip̃os  dicamus s 
ih̃mxp̃mdominũnr̃mnoᷤaũseruosur̃osꝑih̃m	ih̃m xp̃m dominũ nr̃m noᷤ aũ seruos ur̃os ꝑ ih̃m
qm̃d̃sqͥ	qm̃ d̃s qͥ
dixitdetenebrislucẽ	dixit de tenebris lucẽ
splendesc̃eipseillux̃incordib	splendesc̃e ipse illux̃ in cordib 
nr̃isadilluminacionẽscĩeclaritatisd̃iinfaciexͥ	nr̃is ad illuminacionẽscĩe claritatis d̃i in facie xͥ
ih̃unedicogl̃iexp̃inon	ih̃u nedico gl̃ie xp̃i non
·H·⁊c̃l̃itaꝯtinuaꝯm̃dam᷒nosin	· H ·⁊ c̃ l̃ ita ꝯtinua ꝯm̃dam᷒ nos in
manifestacioneũitatis⁊cet̃a	manifestacione ũitatis ⁊ cet̃a
ͭaliafacimus⁊	ͭalia facimus ⁊
h̃ꝓp̃xp̃mñ	h̃ ꝓp̃ xp̃m ñ
·H·di.	· H · di .
nosmip̃ossih̃mxp̃m	nosm  ip̃os s  ih̃m xp̃m
do.nos..i.dicacionr̃anon	do . nos .. i . dicacio nr̃a non
tenditadgl̃iamnr̃aml̃adlucranr̃as	tendit ad gl̃iam nr̃am l̃ ad lucra nr̃a s 
adgl̃iamxͥꝙ̃	ad gl̃iam xͥ ꝙ̃
predicamussaluatorem⁊	predicamus saluatorem ⁊
dñmnr̃meẽillũ	dñm nr̃m eẽ illũ
dicam᷒eẽdñmNosaũdñiseẽseruos.	 dicam᷒ eẽ dñm Nos aũ dñis eẽ seruos .
i.minisstrosur̃os	i . minisstros ur̃os
⁊h̃ꝑxp̃m	⁊ h̃ ꝑ xp̃m
quinobish̃iniunx̃hoc	qui nobis h̃ iniunx̃ hoc
aut̃facimusqm̃	aut̃ facimus qm̃
d̃sip.illux̃incor.no..	d̃s ip . illux̃ in cor . no ..
i.seqͥẽlumennobisinfu	i . se qͥ ẽ lumen nobis infu
nditqͥdixit.i.ceptosolo	n dit qͥ dixit . i . cepto solo
fecitlucemsplend̃edetenebrisq̃dfuitĩseꝑacione	fecit lucem splend̃e de tenebris q̃d fuit ĩ seꝑacione
elem̃toꝝceꝑunt	elem̃toꝝ ceꝑunt
·H·tenebreex	· H · tenebre ex
quoꝯfusamolesceli⁊t̃recep̃eẽañqͣm	quo ꝯfusa moles celi ⁊ t̃re cep̃ eẽ añqͣm
luxfc̃aeẽtqua	lux fc̃a eẽt qua
illuminaret᷑ꝙsñluce	illuminaret᷑ ꝙ sñ luce
fuerattenebrosump᷒eaeuõaccedenteluceꝙ	fuerat tenebrosum p᷒ea e uõ accedente luce ꝙ
fc̃mestmeliusreddr᷑	fc̃m est melius reddr᷑
inqͦꝓficientishõisaffectiosigc̃aturuñapl̃s	in qͦ ꝓficientis hõis affectio sigc̃atur uñ apl̃s
loquẽstore&loquutusẽeismultainparabolisdicens	loquẽs tore & loquutus ẽ eis multa in parabolis dicens
ExiitquiseminatseminaresemensuumEtdumsemiminores	Exiit qui seminat seminare semen suum Et dum semi minores
subditiĩeccl̃iaintelligunt᷑quiñascenduntinnauim	 subditi ĩ eccl̃ia intelligunt᷑ qui ñ ascendunt in nauim
ñdumcelestibmisteriis	ñdum celestib  misteriis
imbuticumxp̃oinꝑabolisLucasꝑsimilitudinẽq̃d	imbuti cum xp̃o in ꝑabolis Lucas ꝑ similitudinẽ q̃d
idemẽMarcusDicebateisindoctrinasua	idem ẽ Marcus Dicebat eis in doctrina sua
Cap̃lxxiiExiitQuidiscipl̃is	Cap̃ lxxii Exiit Qui discipl̃is
loq̃bat᷑sacramentaexiitseminareũbum	loq̃bat᷑ sacramenta exiit seminare ũbum
deiinturbasparabolas	dei in turbas  parabolas
utiuxtauarias	ut iuxta uarias
uoluntatess.sentenciassuas	uoluntates s . sentencias suas
diũsasrecipiantdisciplinass.utuidentesñ	diũsas recipiant disciplinas s . ut uidentes ñ
uideantc̃Notatriplexẽsem̃Sem̃	uideant  c̃ Nota  triplex ẽ sem̃ Sem̃
seminatumpuluereecogitationisobscuretQuetamen	seminatum pulueree cogitationis obscuret Que tamen
ñpulsarerectoris	ñ pulsare rectoris
animumnequeuntsfestinarenecesseestutrepugnationeuincantur	animum nequeunt s  festinare necesse est ut repugnatione uincantur
neuitiumquodꝑ	ne uitium quod ꝑ
suggestionemtemptatmolliciedelectationissubigat,cumq	suggestionem temptat mollicie delectationis subigat , cumq 
hecabanimotarderepelliturmucroneconsensusoccidat.	hec ab animo tarde repellitur mucrone consensus occidat .
xiiiiSitrectoroꝑatione	xiiii Sit rector oꝑatione
cipuusutuiteuiamsubditis	 cipuus ut uite uiam subditis
uiuendodenunciet	uiuendo denunciet 
grexquipastorisuocẽmoresq	grex qui pastoris uocẽ mores q 
sequiturꝑexemplamelius	sequitur ꝑ exempla melius
quãꝑu͛ba	quã ꝑ u͛ba
gradiaturQuienimlocisuinecessitateexigitur	gradiatur Qui enim loci sui necessitate exigitur
summadic̃ehaceademnecessitateconpellitursumma	summa dic̃e hac eadem necessitate conpellitur summa
monstrareIllanamq	monstrare Illa namq
uoxfaciemrubore	 uox faciem rubore
uestietautpalloreconfũdet	uestiet aut pallore confũdet
cui᷒labiacontrahenturautsalienttoxicabit᷑lingua	cui᷒ labia contrahentur aut salient toxicabit᷑ lingua
genuatrementmanusꝓt̃uiet	genua trement manus ꝓt̃uiet
seip̃mnugisnr̃isconuincetobnoxiumInqͥbfuit	se ip̃m nugis nr̃is conuincet obnoxium In qͥb  fuit
ꝓpositisemꝑanugisadbonatransire	ꝓpositi semꝑ a nugis ad bona transire
seria⁊adidquoddecetautꝓdestrestituereuitam	seria ⁊ ad id quod decet aut ꝓdest restituere uitam
Qͥaut̃iustũrehensionilocũuid̃itea	Qͥ aut̃ iustũ re  hensioni locũ uid̃it ea
excaritatelicent̃utat᷑⁊deem̃datione	ex caritate licent̃ utat᷑ ⁊ de em̃datione
meaacquiratsibi⁊possideat	mea acquirat sibi ⁊ possideat
miumuiteScio	 mium uite Scio
enĩquiain	enĩ quia in
multiloquiopecc̃mñ	multiloquio pecc̃m ñ
deestsinuito⁊in	deest s  inuito ⁊ in
caritatedeiexhortorlectorẽqͦmeimemorinorationibussuis	caritate dei exhortor lectorẽ qͦ mei memor in orationibus suis
impetretut	impetret ut
filiusdeiuiui	filius dei uiui
⁊uirginisintemerate	⁊ uirginis intemerate
deushomomanifestetse	deus homo manifestet se
ipsũ⁊palamfaciat	ipsũ ⁊ palam faciat
uiamquanob̃incedendumẽinbñplacitosuo⁊	uiam qua nob̃ incedendum ẽ in bñplacito suo ⁊
dirigatin	dirigat in
eogressusnostrosAMeNQueaũ	eo gressus nostros AMeN Que aũ
Libersc̃emariepontiniaciFinitolibroreddanturiuramagistroD̃s	Liber sc̃e marie pontiniaci Finito libro reddantur iura magistro D̃s
quihodiernãdiẽapl̃orumtuorumpetri&	qui hodiernã diẽ apl̃orum tuorum petri &
paulimartirio	pauli martirio
consecrastidaeccl̃ietueeoruminomnibsequipreceptũ	consecrasti da eccl̃ie tue eorum in omnib  sequi preceptũ
ꝑquosreligionissumpsitexordiũꝑsc̃r	ꝑ quos religionis sumpsit exordiũ ꝑ sc̃r
Hostiasdñequasnominituosacrandasofferimusapl̃ica	Hostias dñe quas nomini tuo sacrandas offerimus apl̃ica
ꝓsequaturoratioꝑquamnosexpiaINCIPIT	ꝓsequatur oratio ꝑ quam nos expia INCIPIT
PREFACIOMAGISTRIGAUFRIDIMONEMUTENSISINhistoriaBRITONUMCUMmecũ	PREFACIO MAGISTRI GAUFRIDI MONEMUTENSIS IN historia BRITONUM CUM mecũ
multa⁊demultissepiusanimoreuoluensin	multa ⁊ de multis sepius animo reuoluens in
ystoriamregũbritannieincidereminmir̃q̃dĩframentionemquam	ystoriam regũ britannie inciderem in mir̃ q̃d ĩfra mentionem quam
deeisGildas	de eis Gildas
⁊bedaluculentotͣctufecerantnichilde	⁊ beda luculento tͣctu fecerant nichil de
regibquiante	regib  qui ante
incarnationẽxp̃i	incarnationẽ xp̃i
inhabitaũãtnichil	inhabitaũãt nichil
⁊̃dearturo	⁊ ̃ de arturo
cet̃isqcõpl̃ibqui	cet̃isq  cõpl̃ib  qui
p᷒incarnationẽsucceᷤserũtrepperissemetgesta	p᷒ incarnationẽ succeᷤserũt repperissem et gesta
eoꝝdignaet̃nitatislaudecõstarent	eoꝝ digna et̃nitatis laude cõstarent
⁊amultispopulisqͧasiinscͥptaiocunde⁊memorit̃	⁊ a multis populis qͧasi inscͥpta iocunde ⁊ memorit̃ 
dicenturtaliamͥ⁊detalib	dicentur tali a mͥ ⁊ de talib 
multocienscogitantioptulit	multociens cogitanti optulit
Walterusoxinefordensisarchidiacon᷒uirinoratoriaarte	Walterus oxinefordensis archidiacon᷒ uir in oratoria arte
atqinexoticisystoriiserudit᷒quendambrita	atq  in exoticis ystoriis erudit᷒ quendam brita
BRitanniainsularumoctdentaliocceanoint̃	BRitannia insularum oct dentali occeano int̃
gallniãsitadcccmiliainlonginlatũcõtinens	gall niã sita dccc milia in long in latũ cõtinens
quicquidusuicongruitindeficientteministratOm̃i	quicquid usui congruit in deficient te ministrat Om̃i
⁊enĩgeñcãposlatesparsosh̃t⁊	⁊ enĩ geñ cãpos late sparsos h̃t ⁊
collpollenticultureaptosindiũsitateᷤ	coll  pollenti culture aptos in diũsitateᷤ
ubertateglebetp̃ribniũt	ubertate glebe tp̃rib  niũt
h̃t⁊nemorauniũsisgeñibrepleta	h̃t ⁊ nemora uniũsis geñib  repleta
⁊quoꝝinsaltͥnandisanimaliũpastib.ueniũt	⁊ quoꝝ in saltͥ nandis animaliũ pastib . ueniũt
⁊auolantib.	⁊ a uolantib .
apib.ũsoꝝ	apib . ũsoꝝ
coloꝝmelladistͥbuit	coloꝝ mella distͥbuit
tasubaeriismontib	ta sub aeriis montib
.amenrentiainqͥb.fonteslucidiriuosleni	. amen rentia in qͥb . fontes lucidi riuos leni
murmuremann᷒suauissoporisinripisuenietisrequiem	murmure man n᷒ suauis soporis in ripis uenietis requiem
animabuestrisIugũenĩmeũsuaue	animab  uestris Iugũ enĩ meũ suaue
estetonusmeumleue	est et onus meum leue
Om̃ips̃sempiterne	Om̃ips̃ sempiterne
deusadestomagnepietatistuemisteriisadestosacramentiis	deus adesto magne pietatis tue misteriis adesto sacramentiis
etadcreandosnouospopl̃osquostibifons	et ad creandos nouos popl̃os quos tibi fons
baptismacisparturitsp̃madoptionis	baptismacis parturit sp̃m adoptionis
emitteUtquodnostre	emitte Ut quod nostre
humilitatisgenrendum	humilitatis genrendum
ẽmisteriotueuirtutisinpleatureffectuperdominũDñsuobiscum	ẽ misterio tue uirtutis inpleatur effectu per dominũ Dñs uobiscum
Etcũsp̃utuoSursum	Et cũ sp̃u tuo Sursum
cordaHabemusaddominũGr̃asagamusdominodeonostro	corda Habemus ad dominũ Gr̃as agamus domino deo nostro
DignũetiustumestprefatioUeredignũ&iustũest	Dignũ et iustum est prefatio Uere dignũ & iustũ est
equũ&salutareNoᷤtibisemꝑ&ubiq	equũ & salutare Noᷤ tibi semꝑ & ubiq 
gr̃asageredñesc̃epateromnipotens	gr̃as agere dñe sc̃e pater omnipotens
et̃ned̃sQuiinuisibili	et̃ne d̃s Qui inuisibili
potentiasasitcarnissubstãtiatestant᷑	potentia sa sit carnis substãtia testant᷑
sepuᷝchraQuisparẽtumamicoꝝfideliũꝙͣlib&dilectisui	sepuᷝchra Quis parẽtum amicoꝝ fideliũ ꝙͣlib & dilecti sui
tangerescaturienu͛mibcarnẽpotestCaroitaqcũ	tangere scaturien u͛mib  carnẽ potest Caro itaq  cũ
c̃cupiscitpset᷑qͥdsitexanimis&intelligit᷑	c̃cupiscit p set᷑ qͥd sit exanimis & intelligit᷑
qͥdamat᷑Nichilqͥppesadedomãdũcarnaliũdesid̃ioꝝappetitũ	qͥd amat᷑ Nichil qͥppe s ad edomãdũ carnaliũ desid̃ioꝝ appetitũ
ual&quãuun᷒qͥsq	ual & quã u un᷒qͥsq 
hocq̃duiuũdiligitquale	hoc q̃d uiuũ diligit quale
sitmortuũpensetConsid̃ata	sit mortuũ penset Consid̃ata
&enĩcorruptionecarnaliciti᷒cognoscit᷑qͥaillicitecarocõcupiscit᷑	& enĩ corruptione carnali citi᷒ cognoscit᷑ qͥa illicite caro cõcupiscit᷑
tabesdesid̃at᷑	tabes desid̃at᷑
Benegͦdeluxriosi	Bene gͦ de lux riosi
m̃tedr̃ddulcedoilli᷒	m̃te dr̃d dulcedo illi᷒
ũmis;qͥa	ũmis ; qͥa
isqͥindesid̃iocar	is qͥ in desid̃io car
liscorruptionisexestuatadfetorẽputredinisanhelHec	lis corruptionis exestuat ad fetorẽ putredinis anhel Hec
sic̃inhui᷒partist̃cie	sic̃ in hui᷒ partis t̃cie
initioꝓmisissememenisubbreuitatetͣnscurri	initio ꝓmisisse me me ni sub breuitate tͣnscurri
uteaqueinhocoꝑesec	ut ea que in hoc oꝑe sec
turqͥamagnaobscuritateimplicatas̃topitulantd̃olatius	tur qͥa magna obscuritate implicata s̃t opitulant d̃o latius
disseranturExplicitlibersext᷒deci	disserantur Explicit liber sext᷒ deci
parsterciLibermontis	pars terci Liber mon tis
sanctmarieuermenuelatõemIsqinitinerecum	sanct marie uer men uelatõem Isq  in itinere cum
ꝓph̃amaGabumrepperissetqͣntaseadu͛sitas	ꝓph̃am aGabum repperisset qͣnta se adu͛sitas
iniherosolimismaneretaudiuitScriptum÷	in iherosolimis maneret audiuit Scriptum ÷
qͥppeq̃didemaGabuszonampaulisuispedibinserens	qͥppe q̃d idem aGabus zonam pauli suis pedib  inserens
dixitVirumcui᷒heczonaestsicalligabuntin	dixit Virum cui᷒ hec zona est sic alligabunt in
iherusalemApauloaut̃ꝓtinus	iherusalem A paulo aut̃ ꝓtinus
respondeturEgonõsolumalligarisetiam	respondetur Ego nõ solum alligari s  etiam
moriinihrl̃mparatussumꝓnoĩeih̃u	mori in ihrl̃m paratus sum ꝓ noĩe ih̃u
Neqenim	Neq  enim
ciosioremfatioaĩam	 ciosiorem fatio aĩam
meamqͣmmeꝑceptionegͥreuelationis	meam qͣm me ꝑceptione gͥ reuelationis
iherosolimamꝑgensadũsacognoscittam̃heclibent̃appetitAudit	iherosolimam ꝑgens adũsa cognoscit  tam̃ hec libent̃ appetit Audit
quetimeats	que timeat s
adhecardentior	 ad hec ardentior
anhelatMoysesitaq	anhelat Moyses itaq 
adꝓsꝑadesuonilhabetcib	ad ꝓsꝑa de suo nil habet  cib 
renititurneisr̃liticeplebipreferat᷑Paulus	renititur ne isr̃litice plebi preferat᷑ Paulus
adadũsaetiamexsuouoto	ad adũsa etiam ex suo uoto
duciturmaloꝝimminentiũcognitionẽꝑcipit	ducitur  maloꝝ imminentiũ cognitionẽ ꝑcipit
sdeuotionesp̃setiamadacrioraferuescitIlle	s  deuotione sp̃s etiam ad acriora feruescit Ille
sentispotestatisgl̃amdeouoluit	 sentis potestatis gl̃am deo uoluit
iubentedeclinareiste	iubente declinare iste
deoasꝑaduradisponente	deo asꝑa  dura disponente
sestuduitadgrauiora	se studuit ad grauiora 
pararePreeuntegͦutrorumqducũinfractauirtute	parare Preeunte gͦ utrorumq  ducũ infracta uirtute
instituimurutsiobedientiepalmamapprehend̃e	instituimur ut si obedientie palmam apprehend̃e
ueracit̃nitim᷑ꝓsꝑish᷒scl̃iculu	ueracit̃ nitim᷑ ꝓsꝑis h᷒ scl̃i culu
alatronibuulñataꝑfidẽtrinitatxxiiiiinhoc	a latronib  uulñata ꝑ fidẽ trinitat xxiiii in hoc
deẜtoreꝑatuRAliusẜmo	deẜto reꝑatuR Alius ẜmo
eod̃dQUihabitat	eod̃ d QUi habitat
inadiutorioaltissiminꝓtectiõedeicelicõmorabiturInclinauit	in adiutorio altissim in ꝓtectiõe dei celi cõmorabiturInclinauit
altissim᷒celoset	altissim᷒ celos et
descẽditetadeodescẽditq̃din	descẽdit et adeo descẽdit q̃d in
sil̃itudinẽhoĩumfactusẽ	sil̃itudinẽ hoĩum factus ẽ
ethabituinuẽtusuth̃oAdeodescẽditq̃dsub	et habitu inuẽtus ut h̃o Adeo descẽdit q̃d sub
manuẜuihũiliauitsebaptizandũuñetbaptista	manu ẜui hũiliauit se baptizandũ uñ et baptista
cõtremuitcũuid̃etsub	cõtremuit cũ uid̃et sub
manibsuisinclinricaputtrem̃dũregib	manib  suis inclinri caput trem̃dũ regib
etpotestatib	 et potestatib 
adrandũAdeo	adrandũ Adeo
hũiliauitseutcũieiunassetesuriret	hũiliauit se ut cũ ieiunass et esuriret
aususẽad	ausus ẽ ad
eũacced̃e	eũ acced̃e
tẽptatouteisdẽiacul̃cofod̃etquibpͥmũhoĩemseuiuũ	tẽptatout eisdẽ iacul̃ cofod̃et quib  pͥmũ hoĩem se uiuũ
etuuln͛atũreliq̃rats	et uuln͛atũ reliq̃rat s 
uictusẽtptatoret	uictus ẽ t ptator et
uiciteũaltissim᷒Squoadiutorio	uicit eũ altissim᷒ S  quo adiutorio
ususẽaltissimusuteũuinc͛et	usus ẽ altissimus ut eũ uinc͛et
neususadiutoriopotẽtiesueNequaPoss	ne usus adiutorio potẽtie sue NequaPoss
enĩstatĩꝯterere	 enĩ statĩ ꝯterere
sathanãsiuelletsumemoriammĩeignorat	sathanã si uellet su memoriam mĩe ignorat
xliiCeperuntaũaqueminui	xlii Ceperunt aũ aque minui
p᷒centũquinqͣginta	p᷒ centũ quinqͣginta
dies&requieuitarchasuꝑmontesarmenieIn	dies & requieuit archa suꝑ montes armenie In
epl̃aadysatiumSeruataũitatehystorieqͥdẽaliudq̃d	epl̃a ad ysatium Seruata ũitate hystorie qͥd ẽ aliud q̃d
diluuiitemporegen᷒human᷒extͣarchammoritur	diluuii tempore gen᷒ human᷒ extͣ archam moritur
aduitãuͦinarchaseruaturnͥhoc	ad uitã uͦ in archa seruatur nͥ hoc
q̃dnc̃aꝑte	q̃d nc̃ aꝑte
cernimusquiain	cernimus quia in
fidelesquosqextraeccl̃iamundapeccati	fideles quosq  extra eccl̃iam unda peccati
suiꝑimit&fidelessuosinfide&caritatesc̃e	sui ꝑimit & fideles suos in fide & caritate sc̃e
eccl̃ieunitas	eccl̃ie unitas
qͣsiarcheconpagocustoditQueuidelicet	qͣsi arche conpago custodit Que uidelicet
archadelignisinputͥbilib	archa de lignis inputͥbilib 
cõpingit᷑defortib	cõpingit᷑  de fortib
animab&inbonosuoꝑseũantib	 animab & in bono suo ꝑseũantib
ARchainquahoĩes&reptilia	 ARcha in qua hoĩes & reptilia
temporediluscameccl̃iamfigurauit	tempore dilu scam eccl̃iam  figurauit
i&maliꝯueniuntꝑmixtasitatefilioꝝsic	i & mali ꝯueniunt ꝑmixta sitatefilioꝝ  sic
om̃sadfuttñom̃sꝑinmutatõemu	om̃s ad f ut tñ om̃s ꝑ inmutatõem u
temspiritalisgr̃eculpisexigducatViamitaqsentis	tem spiritalis gr̃e culpis exig ducat Viam itaq  sentis
scgim᷒tc̃aũdiscernem᷑cũacnerim᷒	sc gim᷒ tc̃ aũ discernem᷑ cũ ac nerim᷒
Boniuͦsisñmalisffecte	Boni uͦ si sñ malis f fecte
bonieẽ	boni eẽ
ñposs̃tmirgant᷑Ip̃a	ñ poss̃t  mir gant᷑ Ip̃a
aũsocietas	aũ societas
malotioẽbonoꝝTResfiliosnoe⁊	malo tio ẽ bonoꝝ TRes filios noe ⁊
iaphetarchacontinuitsDominicaprimainaduentu	iaphet archa continuit s  Dominica prima in aduentu
dominicapl̃mcuSupermontemexcelsumascende	domini capl̃m cu Super montem excelsum ascende
quieuuangelizassyonexaltainfortitudineuocemtuamqui	qui euuangelizas syon ex alta in fortitudine uocem tuam qui
euuangelyzashierusalemex	euuangelyzas hierusalem ex
altanolitimeredicciuitatib	alta noli timere dic ciuitatib
iudeeccedeusuesterEccediesueniunt	 iude ecce deus uester Ecce dies ueniunt
dicitdominusetsuscitabodauidgermeniustumetregnabitrex	dicit dominus et suscitabo dauid germen iustum et regnabit rex
etsapienseritetfacietiuditium	et sapiens erit et faciet iuditium
etiustitiaminterraethec	et iustitiam in terra et hec
estnomenquoduocabunteum	est nomen quod uocabunt eum
dominusiustusnosterIndiebusillissaluabitur	dominus iustus noster In diebus illis saluabitur
iudaetisrahelhabitabitconfidentes	iuda et israhel habitabit confidentes
EthocestnomenymnusConditor	Et hoc est nomen ymnus Conditor
almesyderumeternaluxcredentiumxpiste	alme syderum eterna lux credentium xpiste
redemptoromniumexaudices	redemptor omnium exaudi  ces
supplicumQuicondolensinteritumortisperireseculumsaluastimundum	supplicum Qui condolens interitu mortis perire seculum saluasti mundum
languidumdonansreisremedium	languidum donans reis remedium
Vergentemundi	Vergente mundi
uespereutisponsusdethalamo	uespere uti sponsus de thalamo
egressushonestissimauirginismatrisclausulaCuius	egressus honestissima uirginis matris clausula Cuius
fortipotentiegenucuruanturomniacelestiaterrestrianutufatentur	forti potentie genu curuantur omnia celestia terrestria nutu fatentur
subditaOcasumsolcustodienslunapalloremretinens	subdita Ocasum sol custodiens luna pallorem retinens
candorinastrisrelucenscertosobseruat	candor in astris relucens certos obseruat
limitesTedeprecamuragyeuentureiudexseculiconseruanos	limites Te deprecamur agye uenture iudex seculi conserua nos
intemporehostis	in tempore hostis
ateloperfidiLaushonoruirtus	a telo perfidi Laus honor uirtus
gloriadeopatri	gloria deo patri
etfilio	et filio
unacumsanctospiritu	una cum sancto spiritu
insempiternaseculaamenHorateceli	in sempiterna secula amen Horate celi
desuperetnubespluantiustumaperiaturcertaet	desuper et nubes pluant iustum aperiatur certa et
germinetsaluatoremIneug̃ãEccenomendominiuenitde	germinet saluatorem In eug̃ ã Ecce nomen domini uenit de
lonIncipitterciusliberFictilisintereauasisꝯpagesoluta	lon Incipit tercius liber Fictilis interea uasis ꝯpage soluta
carc̃ecorporeocognatisreddit᷒astͥsIlleolĩqui	carc̃e corporeo cognatis reddit᷒ astͥs Ille olĩ qui
ꝓpteropẽꝯtͣitalaregnaPetrũ	ꝓpter opẽ ꝯtͣ itala regna Petrũ
legaratadrianusppͣꝑegitextremosinpacediesm̃itiq	legarat adrianus ppͣ ꝑegit extremos in pace dies m̃itiq
ꝓbaticlerusapl̃ica	 ꝓbati clerus apl̃ica
fecitsedeleonemcuisiinsublimiꝯstaretadorsio	 fecit sede leonem cui si in sublimi ꝯstaret adorsio
rerũAd	rerũ Ad
sacrũfueratfacil̃	sacrũ fuerat facil̃
fortunacacumenSnon	fortuna cacumen S  non
blandasatis	blanda satis
nͨadomnẽꝓsꝑacasũSicinmundanisabsq	nͨ ad omnẽ ꝓsꝑa casũ Sic in mundanis absq
õiturbinerebnͨmeraleticiaẽnͨ	 õi turbine reb  nͨ mera leticia ẽ nͨ
letaoĩouoluptasPaxubinl̃la	leta oĩo uoluptas Pax ubi nl̃la
rataẽubi	rata ẽ ubi
gl̃ianl̃laquieta⁊nl̃lus	gl̃ia nl̃la quieta ⁊ nl̃lus
secur᷒honosexꝑtusinaltohocleoꝯscensu	secur᷒ honos exꝑtus in alto hoc leo ꝯscensu
ẽquitutiorimatenebatHuncinequocũiã	ẽ qui tutior ima tenebat Hunc in equo cũ iã
põpamducendosed̃etAppetiitmanuũuiolentainiectiotͣctũ	põpam ducendo sed̃et Appetiit manuũ uiolenta iniectio tͣctũ
Nequit̃⁊sacra	Nequit̃ ⁊ sacra
demaiestatereuulsũQuẽpredefunctipapeexcecareparentes	de maiestate reuulsũ Quẽ predefuncti pape excecare parentes
Excitoꝯtraseducteturbine	Excito ꝯtra seducte turbine
plebis	plebis 
sumpserenͨexocl̃isablata	sumpsere nͨ ex ocl̃is ablata
luc̃naẽ	luc̃na ẽ
sc̃issimiꝯf̃dignat᷒ẽmultamiracl̃aoꝑariꝓlog᷒CVm	sc̃issimi ꝯf̃ dignat᷒ ẽ multa miracl̃a oꝑari ꝓlog᷒ CVm
uetustatisincõmodo	uetustatis in cõmodo
nouercanteresferesingulasobsoleri	nouercante res fere singulas obsoleri
cõtingatcumnouem	cõtingat cum nouem
leꝓsoscurationepotitosnõparumreosintellexerimus	leꝓsos curatione potitos nõ parum reos intellexerimus
quiad̃igloriamtacueruntcumdecimo	quia d̃i gloriam tacuerunt cum decimo
reuertentedñmglorificantessuꝑ	reuertente dñm glorificantes suꝑ
hisqueaudiuim᷒⁊uidim᷒	his que audiuim᷒ ⁊ uidim᷒
queadñofactamirabiliafueruntin	que a dño facta mirabilia fuerunt in
occl̃isur̃isposteDcomitenr̃oRichrege	occl̃is ur̃is poste D comite nr̃o Rich rege
anglieuirouidelninenobilitatisnoti	anglie uiro uidel nine nobilitatis noti
cuiinegregia	cui in egregia
feritatesibicontemporaneũiconparandũortasunmata⁊	feritate sibi contemporaneũ i conparandũ orta sun mata ⁊
infamescontinterhomineshuiusHacdecausa	infames cont inter homines huius Hac de causa
quiadercessione⁊assignationeuersasꝑgerentconse	quia de r cessione ⁊ assignatione uersas ꝑgerent conse
ꝑsonasQuidãenĩabantur	ꝑsonas Quidã enĩ a bantur
ioh̃emiam	ioh̃em iam
dtiregisfratremregemsi	d ti regis fratrem regem si
uid̃isnudũoꝑieũ⁊pauꝑẽ⁊absq	uid̃is nudũ oꝑi eũ ⁊ pauꝑẽ ⁊ absq
tectoinducintab̃naculũtuumTuncerũpettemporanealux	 tecto induc in tab̃naculũ tuum Tunc erũpet temporanea lux
tua⁊sanitatestuecitoorient᷑Hocqͦq	tua ⁊ sanitates tue cito orient᷑ Hoc qͦq 
q̃dscͥptumẽinLxxmisitdebethelsarasar⁊	q̃d scͥptum ẽ in Lxx misit de bethel sarasar ⁊
ebeserrexnullusnr̃oꝝpotuitexponere	ebeser rex nullus nr̃oꝝ potuit exponere
Neq.enĩq̃d	Neq . enĩ q̃d
maleuersũẽexebreoullarationeexplanari	male uersũ ẽ ex ebreo ulla ratione explanari
pot̃Quisẽenĩiste	pot̃ Quis ẽ enĩ iste
sarasar⁊ebeserrex	sarasar ⁊ ebeser rex
autcui᷒ꝓuincie	aut cui᷒ ꝓuincie
autinquaul̃dequamisitbethelautcui᷒	aut in qua ul̃ de qua misit bethel aut cui᷒
bethelrexeẽpoterat	bethel rex eẽ poterat
ebeserqueolimcũiudeafueratdestituta⁊	ebeser que olim cũ iudea fuerat destituta ⁊
eotpr̃nequaquã	eo tpr̃ nequaquã
uocabat᷑bethelidẽdom᷒dñis	uocabat᷑ bethel id ẽ dom᷒ dñi s
betauen.i.dom᷒ydoli	 betauen . i . dom᷒ ydoli
Hocqͦqq̃dseqͥringressaẽin	Hoc qͦq  q̃d seqͥr ingressa ẽ in
m̃seqͥntosc̃ificatiosic̃fecerant	m̃se qͥnto sc̃ificatio sic̃ fecerant
iamꝑmultosannos	iam ꝑ multos annos
sicconant᷑exponeresc̃ificationẽingressãuasatẽpliq̃anabucodonosor	sic conant᷑ exponere sc̃ificationẽ ingressã uasa tẽpli q̃ a nabucodonosor
fuerantsublatainillotpr̃	fuerant sublata in illo tpr̃
restitutaDequinti	restituta De quinti
aut̃⁊septimiieiuniotemptauer̃referread	aut̃ ⁊ septimi ieiunio temptauer̃ referre ad
diesebdomadisS	dies ebdomadis S 
seqͥrdecimiieiuniumcõpulsis̃t	seqͥr decimi ieiunium cõpulsi s̃t
adm̃sesreferre⁊q̃dsitipsequinti⁊	ad m̃ses referre ⁊ q̃d sit ipse quinti ⁊
septimidecimũqm̃sisieiuniũomninosiluer̃	septimi decimũq  m̃sis ieiuniũ omnino siluer̃
utdeprioresim᷒explanationeꝯtenti⁊ñ	ut de priore sim᷒ explanatione ꝯtenti ⁊ ñ
indignem᷑adfalsoscommentantiũconatusqͥdeint̃pretationiserrore	indignem᷑ ad falsos commentantiũ conatus qͥ de int̃pretationis errore
uener̃Etfactũẽu͛bumdñi	uener̃ Et factũ ẽ u͛bum dñi
adzachariãdicensHecdic̃dñsexercituũdicensIudiciũiustũ	ad zachariã dicens Hec dic̃ dñs exercituũ dicens Iudiciũ iustũ
iudicate⁊miscdĩam&	iudicate ⁊ miscdĩam &
Sr̃cartã	Sr̃ cartã
caritatiᷤAntequãabbatiecist̃cien.florereinciperent	caritatiᷤ Antequã abbatie cist̃cien . florere inciperent
domnusstephanusabbasetfr̃ssui	domnus stephanus abbas et fr̃s sui
ordinaueruntut	ordinauerunt ut
nullomͦabbatieinalicui᷒antistitisdiocesi	nullo mͦ abbatie in alicui᷒ antistitis diocesi
fundarent᷑anteꝙͣip̃e	fundarent᷑anteꝙͣ ip̃e
decretumintercisterciensecenobiũ	decretum inter cisterciense cenobiũ
⁊ceteraexeonataexaratũ⁊confirmatũratumhabet	⁊ cetera ex eo nata exaratũ ⁊ confirmatũ ratum habet
ꝓpterscandalũinterpontficẽ⁊monachosdeuitandũInhoc	ꝓpter scandalũ inter pontficẽ ⁊ monachos deuitandũ In hoc
gͦdec͛todictifr̃smutue	gͦ dec͛to  dicti fr̃s mutue
pacisfutuꝝcauentesnaufragiũelucidaueruntetstatuer̃suisq	pacis futuꝝ  cauentes naufragiũ elucidauerunt et statuer̃ suisq 
posterisreliquer̃quopactoquouemͦimmo	posteris reliquer̃ quo pacto quoue mͦ immo
quacaritatemonachieoꝝ	qua caritate monachi eoꝝ
ꝑabbatiasindiu͛sismundipartib	ꝑ abbatias in diu͛sis mundi partib 
corporibdiuihomiñsub	corporib  diui homiñ sub
regularidisciplinaordinaueritnullãterrenecõmoditatis	regulari disciplina ordinauerit nullã terrene cõmoditatis
seureꝝtẽporaliũexactionẽimponimusProdesseenĩ	seu reꝝ tẽporaliũ exactionẽ imponimus Prodesse enĩ
ill̃õibqsc̃eeccl̃iefiliis	ill̃ õib  q  sc̃e eccl̃ie filiis
cupientesnilquodeosgrauet	cupientes nil quod eos grauet
nilq̃deorũsubstantiãminuatergaeosag̃edisponim᷒	nil q̃d eorũ substantiã minuat erga eos ag̃e disponim᷒
nedũnos	ne dũ nos
habundãtesdeeoꝝpauꝑtateeẽcupim᷒auariciemalũq̃dscd̃m	habundãtes de eoꝝ pauꝑtate eẽ cupim᷒ auaricie malũ q̃d scd̃m
apl̃mydoloꝝseruituscomꝓbatureuitarenon	apl̃m ydoloꝝ seruitus comꝓbatur euitare non
possim᷒Curãtñ	possim᷒ Curã tñ
aĩaꝝilloꝝgr̃acaritatisretinereuolumus	aĩaꝝ illoꝝ gr̃a caritatis retinere uolumus
utsiqnͦa	ut si qnͦ a
sc̃oꝓpositoetobseruantiasc̃eregl̃edeclinareq̃d	sc̃o ꝓposito et obseruantia sc̃e regl̃e declinare q̃d
absittẽptau͛ĩt	absit tẽptau͛ĩt
ꝑnr̃amsollicitudinẽadrecINdomino	ꝑ nr̃am sollicitudinẽ ad rec IN domino
confidoquomodoanimemeetransmigrainmosicutpasser	confido quomodo anime mee transmigra in mo sicut passer
Quoniameccepeccatoresintenarcumparaueruntsagittassuretraut	Quoniam ecce peccatores inten arcum parauerunt sagittas su retra ut
sagittentinobscuroreQuoniamqueꝑfecistidestruxerustusautem	sagittent in obscuro re Quoniam que ꝑfecisti destruxeru stus autem
quidfecitDominusintemplosanctosuoincelo	quid fecit Dominus in templo sancto suo in celo
sedeseiusOculieiusinpauꝑemrespiciuntbreeiusinterrogãt	sedes eius Oculi eius in pauꝑem respiciunt bre eius interrogãt
filioshomi	filios homi
Dominusinterrogat	Dominus interrogat
iustumetquiautem	iustum et qui autem
diligitiniquitateanimamsuamPluetsuꝑ	diligit iniquitate animam suam Pluet suꝑ
peccatoreslaqueosierisdabotͥ	peccatores laqueos i eris dabo tͥ
licdimidiũregnimeiQͤc̃exiss	lic  dimidiũ regni mei Qͤ c̃ exiss
dix̃matͥsueQͥd	 dix̃ matͥ sue Qͥd
petãetilladix̃cap̃	petã et illa dix̃ cap̃
ioh̃isbabtisteCũqĩtͦiss	ioh̃is babtiste Cũq  ĩtͦiss 
statĩc̃festinatiõe	statĩ c̃ festinatiõe
aRegẽpetiũdicẽsUolout	a  Regẽ petiũ dicẽs Uolo ut
ꝓtin᷒desmͥĩdisco	ꝓtin᷒ des mͥ ĩ disco
caputiohannisbabtisteEtꝯtͥstatu᷒÷Rexꝓpt̃	caput iohannis babtiste Et ꝯtͥstatu᷒ ÷ Rex ꝓpt̃
i᷒iurãdũ⁊ꝓpt̃	i᷒iurãdũ ⁊ ꝓpt̃
simulrecũbẽtesnoluiteãꝯtͥstareS	simul recũbẽtes noluit eã ꝯtͥstare S
missospiculatore	 misso spiculatore
cep̃afferri	 cep̃ afferri
cap̃ei᷒ĩdiscoEtdecollaũeũ	cap̃ ei᷒ ĩ disco Et decollaũ eũ
ĩcarc̃e⁊adtulitcap̃	ĩ carc̃e ⁊ adtulit cap̃
ei᷒ĩdisco	ei᷒ ĩ disco
⁊deditilludpuelle⁊puelladeditMatͥsueQͦ	⁊ dedit illud puelle ⁊ puella dedit Matͥ sue Qͦ
auditodiᷤscipl̃i	audito diᷤscipl̃i
ei᷒uener̃⁊tul̃ũtcorp᷒ei᷒⁊posuer̃illd̃	ei᷒ uener̃ ⁊ tul̃ũt corp᷒ ei᷒ ⁊ posuer̃ illd̃
ĩmonum̃toEtegͤss᷒÷ih̃s⁊	ĩ monum̃to Et egͤss᷒ ÷ ih̃s ⁊
discipl̃iei᷒	discipl̃i ei᷒
ĩcastellacesareephilippi	ĩ castella cesaree philippi
&ĩuiaĩt̃rogabat	& ĩ uia ĩt̃rogabat
discipl̃oᷤsuoᷤdicẽs	discipl̃oᷤ suoᷤ dicẽs
eisQͤmme	eis Qͤm me
dicũthoĩneseẽQͥrespõd̃ũt	dicũt hoĩnes eẽ Qͥ respõd̃ũt
illidicẽtesioh̃mbabtistã	illi dicẽtes ioh̃m babtistã
AliiheliãAliiuͦqͣsiunũdeꝓph̃isTc̃	Alii heliã Alii uͦ qͣsi unũ de ꝓph̃is Tc̃
dic̃ill̃VosuͦqͤmmedicitiᷤeẽRespõdẽsPetr᷒	dic̃ ill̃ Vos uͦ qͤm me dicitiᷤ eẽ Respõdẽs Petr᷒
aiteiTuesxp̃sEtꝯminat᷒	ait ei Tu es xp̃s Et ꝯminat᷒
÷eisnecͥdic̃ẽtd̃illo	÷ eis ne cͥ dic̃ẽt d̃ illo
&ĩt̃rogabãteũdicẽtesQͥdgͦdicũt	& ĩt̃rogabãt eũ dicẽtes Qͥd gͦ dicũt
pharisei⁊scͥbe	pharisei ⁊ scͥbe
qͥaheliã	qͥa heliã
oꝑtpͥmũvenireQͥRespõdẽs	oꝑt  pͥmũ venire Qͥ Respõdẽs
aitill̃Heliasc̃ueñitpͥmorestituetõia&	ait ill̃ Helias c̃ ueñit pͥmo restituet õia &
qͦmͦscͥptũ÷ĩfiliũhõiᷤũml̃tapaciat᷑	qͦmͦ scͥptũ ÷ ĩ filiũ hõiᷤ ũ ml̃ta paciat᷑
⁊ꝯtẽpnat᷑S	⁊ ꝯtẽpnat᷑ S
dicouob̃qͥa⁊heliasveñ	 dico uob̃ qͥa ⁊ helias veñ
⁊fec̃ũtilli	⁊ fec̃ũt illi
q̃c̃quoluer̃sic̃scͥptũ÷deeoExplicit	q̃c̃q  uoluer̃ sic̃ scͥptũ ÷ de eo Explicit
h̃scͥpsitBarmari᷒ãnoMͦCCͦXIIIͦ	h̃ scͥpsit B armari᷒ ãno MͦCCͦXIIIͦ
int̃dũ⁊forteꝗasanitasul̃infirmitas	int̃dũ ⁊ forte ꝗa sanitas ul̃ infirmitas
cõporisconsistitinquattuor⁊aĩe	cõporis consistit in quattuor ⁊ aĩe
intͥbutpredixim᷒Iñẽquod	in tͥb  ut predixim᷒ Iñ ẽ quod
stolacorpõisdr̃dfut᷑ainquattuorꝓpͥetatibcorpõis	stola corpõis dr̃d fut᷑a in quattuor ꝓpͥetatib  corpõis
gl̃ificati⁊stolaaĩepͥncipalit̃intͥb	gl̃ificati ⁊ stola aĩe pͥncipalit̃ in tͥb 
Erũtenĩquattuorprincipalesdotescorpõisgl̃ificatis	Erũt enĩ quattuor principales dotes corpõis gl̃ificati s
.subtilitas⁊	. subtilitas ⁊
agilitassplendor	agilitas splendor
⁊impassibilitasiux̃illd̃	⁊ impassibilitas iux̃ illd̃
ĩlibrosap̃iefulgebũtiustisic̃solĩregͦ	ĩ libro sap̃ie fulgebũt iusti sic̃ sol ĩ regͦ
pa.m̃i⁊tãꝙͣscin.ĩa.	pa . m̃i ⁊ tãꝙͣ scin . ĩ a .
di.fulgeb̃tꝑsplẽdorẽsic̃solꝑ	di . fulgeb̃t ꝑ splẽdorẽ sic̃ sol ꝑ
ĩmutabilitatemadueritatẽsiueĩpassibilitatẽsol	ĩmu tabilitatem ad ueritatẽ siue ĩpassibilitatẽ  sol
ĩsuanat᷑aẽĩmutabilis⁊ĩpassibil̃taꝙͣ	ĩ sua nat᷑a ẽ ĩmutabilis ⁊ ĩpassibil̃ taꝙͣ
scĩtilleꝑsubtilitatẽdiscũrẽtꝑ	scĩtille ꝑ subtilitatẽ discũrẽt ꝑ
agilitatẽHasqͣttuoͬꝓͥetatesgl̃ificaticoͬꝑisĩargum̃tatiõe	agilitatẽ Has qͣttuoͬ ꝓͥetates gl̃ificati coͬꝑis ĩ argum̃tatiõe
fut᷑egl̃ificatiõis⁊̃ĩcaͬnemoͬtalixᷤost̃nditclaritatẽ	fut᷑e gl̃ificatiõis ⁊ ̃ ĩ caͬne moͬtali xᷤ ost̃ndit claritatẽ
qñsetͣnsfiguraũĩmõte⁊resplẽunt	qñ se tͣnsfiguraũ ĩ mõte ⁊ resplẽunt
faciesei᷒sic̃solSubtilitatẽqñclauso	facies ei᷒ sic̃ sol Subtilitatẽ qñ clauso
sigͣcl̃ouirginalitãꝙͣspõsusꝓcessitde	sigͣcl̃o uirginali tãꝙͣ spõsus ꝓcessit de
tha.suoAgilitatẽsiueleuitatẽqñaliãlitt̃amubi	tha . suo Agilitatẽ siue leuitatẽ qñ aliã litt̃am ubi
noshabem᷒quismundũde	nos habem᷒ quis mundũ de
inmundoconceptũinfansuniusdieiẽsinepecc̃o⁊	inmundo conceptũ infans unius diei ẽ sine pecc̃o ⁊
pm᷒naturafiliiireabhactñqui	p m᷒ natura filii ire ab hac tñ qui
pͥuilegiatifuer̃mũdatiañnatinut̃ismatrũut	pͥuilegiati fuer̃ mũdati añ nat in ut̃is matrũ ut
Ieremias⁊Io	Ier emias ⁊ Io
annesquiexut̃omatrisQuoꝝutͥoc	annes qui ex ut̃o matris Quoꝝ utͥ  oc
Pͥusquãteformarẽin	Pͥus quã te formarẽ in
ut̃onouexiresd̃ũntresc̃ificauitequod⁊̃	ut̃o nou exires d̃ ũntre sc̃ificaui te quod ⁊ ̃
tendũtdeiacob	tendũt de iacob
⁊b̃atauͥgineq	⁊ b̃ata uͥgine q
habeat᷑exssumVeniale	habeat᷑ ex  ssum Veniale
peccaad	pecca ad
illicitacitraconsensũratõiseẽnõpossumus	illicita citra consensũ ratõis eẽ nõ possumus
ꝗasemꝑIebuseint̃ranr̃aque	ꝗa semꝑ Iebuse in t̃ra nr̃a que
nob̃spinas⁊tͥbu	nob̃ spinas ⁊ tͥbu
nitg͛minare	nit g͛minare
d̃hocaitb̃atusioannes	d̃ hoc ait b̃atus io annes
Sidix̃imus	Si dix̃imus
quodpeccatũñh̃emseducim᷒	quod peccatũ ñ h̃em se ducim᷒
⁊ũitas	⁊ ũitas
innob̃ñẽMorInepistolisbeatipauliapostoli	in nob̃ ñ ẽ Mor In epistolis beati pauli apostoli
PRIMUMQUERITURquareposteugl̃iaquesupplementũlegis	PRIMUM QUERITUR quare post eugl̃ia que supplementũ legis
sunt⁊inquib᷒nobisexempla⁊	sunt ⁊ in quib᷒ nobis exempla ⁊
ceptauiuendi	cepta uiuendi
plenissimedigestasunt	plenissime digesta sunt
uolueritapl̃shasepl̃asadsingulasęccl̃as	uoluerit apl̃s has epl̃as ad singulas ęccl̃as
destinareHacaut̃causauidet᷑factũ	destinare Hac aut̃ causa uidet᷑ factũ
Scilicetutinicionascentis	Scilicet ut inicio nascentis
ęccl̃ęnouiscausisexistentib&	ęccl̃ę nouis causis existentib &
sentia⁊mienciaresequaretuicia⁊utpostfuturasexcluder	sentia ⁊ miencia resequaret uicia ⁊ ut post futuras excluder
&questionesexemploꝓphetarũqͥposteditã	& questiones exemplo ꝓphetarũ qͥ post editã
legẽmoysiin	legẽ moysi in
quaõiadeimandatalegebant᷑	qua õia dei mandata legebant᷑
nichilomin᷒dedoctrinasuarediuiuasemꝑppl̃iconpresserepeccata	nichilomin᷒ de doctrina sua rediuiua semꝑ ppl̃i conpressere peccata
tͣnsmigrationẽierl̃minmense	tͣnsmigrationẽ ierl̃m in mense
qͥntor̃Istisuntdies	qͥnto r̃ Isti sunt dies
quosobseruaredebetistemꝑibussuisqͣrtadecimadie	quos obseruare debetis temꝑibus suis qͣrtadecima die
aduesꝑmpaschadñiẽ̃ĩqͥntadecima	ad uesꝑm pascha dñi ẽ  ̃ ĩ qͥntadecima
sollempnitatẽcelebrabitis	sollempnitatẽ celebrabitis
altissimodñoũLoquutusẽ	altissimo dño ũ Loquutus ẽ
dñsadmoysendicensloquere	dñs ad moysen dicens loquere
filiisisr̃ldices	filiis isr̃l  dices
adeosQͣrtal̃scd̃aEtfc̃mẽ	ad eos Qͣrta l̃ scd̃a Et fc̃m ẽ
ũbumdominiadme	ũbum domini ad me
dicensPriusꝙͣteformareminutero	dicens Priusꝙͣ te formarem in utero
nouite	noui te 
anteꝙͣexiresdeuuluasanctificaui	anteꝙͣ exires de uulua sanctificaui
teꝓph̃amingentibdedi	te  ꝓph̃am in gentib  dedi
teEtdixi	te Et dixi
a.a.a.dñedeus	a . a . a . dñe deus
Eccenescioloquipueregosumr̃Multiplicatisunt	Ecce nescio loqui  puer ego sum r̃ Multiplicati sunt
quitͥbulantmedicuntñ	qui tͥbulant me  dicunt ñ
ẽsalusip̃iindeoer̃Exurgedñe	ẽ salus ip̃i in deo er̃ Exurge dñe
saluuᷤmefacdeusm̃uᷤQuitͥbulantme	saluuᷤ me fac deus m̃uᷤ Qui tͥbulant me
exultabuntsimot᷒fueroegoaut̃	exultabunt si mot᷒ fuero ego aut̃
ĩmĩatuasꝑauiEtdix̃dominus	ĩ mĩa tua sꝑaui Et dix̃ dominus
admeNolidic̃epuersũl̃	ad me Noli dic̃e  puer sũ l̃
IIIͣExurge	IIIͣ Exurge
qm̃adõiaquemittamteibisuniũsa	qm̃ ad õia que mittam te ibis  uniũsa
q̃cumqmandauerotͥloquerisNetimeasa	q̃cumq  mandauero tͥ loqueris Ne timeas a
facieeoꝝ	facie eoꝝ 
tecumegosumut	tecum ego sum ut
eruamtedicitdic̃dominusEtmisitdominusmanũ	eruam te dicit dic̃ dominus Et misit dominus manũ
suamtetigitosmeumr̃Quicustodiebant	suam  tetigit os meum r̃ Qui custodiebant
aĩammeamꝯsiliũfecer̃tĩunumdicentesD̃sdereliqͥt	aĩam meam ꝯsiliũ fecer̃t ĩ unum dicentes D̃s dereliqͥt
eumꝑseqͥminiꝯhenditeeum	eum ꝑseqͥmini  ꝯ  hendite eum 
ñẽqͥlibereteumdeusm̃sneelonges	ñ ẽ qͥ liberet eum deus m̃s ne elonges
amedeusm̃sĩadiutoriũmeumĩtende	a me deus m̃s ĩ adiutoriũ meum ĩtende
ũOmnesinimicimeiadũsum	ũ Omnes inimici mei adũsum
medicentesD̃sl̃iiiiͣEtdix̃dominusad	me dicentes D̃s l̃ iiiiͣ Et dix̃ dominus ad
meEccedediũbameainore	me Ecce dedi ũba mea in ore
tuoecceconstituitehodiesuꝑgentesegyptum	tuo ecce constitui te hodie suꝑ gentes egyptum
etestoibiusq	et esto ibi usq 
dũdicamtͥFuturumẽenimutherodesquerat	dũ dicam tͥ Futurum ẽ enim ut herodes querat
puerũadꝑdendũ	puerũ ad ꝑdendũ
eumQuiconsurgensaccepitpuerũ	eum Qui consurgens accepit puerũ
⁊matremei᷒nocte	⁊ matrem ei᷒ nocte
etsecessitinegiptũEt	et secessit in egiptũ Et
eratibiusqadobitumherodisutadimpleret᷑q̃d	erat ibi usq  ad obitum herodis ut adimpleret᷑ q̃d
dictũẽadñoꝑꝓph̃amdicentẽEx	dictũ ẽ a dño ꝑ ꝓph̃am dicentẽ Ex
egiptouocauifiliũmeumTunc	egipto uocaui filiũ meum Tunc
herodesuidens	herodes uidens
qm̃illususeẽtamagisiratusest	qm̃ illusus eẽt a magis iratus est
ualdeEtmittensocciditom̃spuerosqͥerantin	ualde Et mittens occidit om̃s pueros qͥ erant in
bethleem⁊inom̃ibfinibei᷒	bethleem ⁊ in om̃ib  finib  ei᷒
abimatu⁊infrascd̃m	ab imatu ⁊ infra scd̃m
tempusq̃dexquisieratamagisTuncadimpletumẽquod	tempus q̃d exquisierat a magis Tunc adimpletum ẽ quod
dictumẽꝑieremiamꝓph̃amdicentemVoxinrama	dictum ẽ ꝑ ieremiam ꝓph̃am dicentem Vox in rama
auditaẽploratus⁊ululatus	audita ẽ ploratus ⁊ ululatus
multusrachelploransfiliossuosEtnoluit	multus rachel plorans filios suos Et noluit
consolariquianonsunt.coll̃	consolari quia non sunt . coll̃
DeuscuiushodiernaInl̃aHerodesiratusoccidit	Deus cuius hodierna In l̃ a Herodes iratus occidit
multospuerosinbethleem	multos pueros in bethleem
iudeciuitatedauid	iude ciuitate dauid
cap̃Uidisupͣmontẽsyon	cap̃ Uidi supͣ montẽ syon
agnumstantẽetcũeocentumquadragintaqͣtuormiliahabentes	agnum stantẽ et cũ eo centum quadraginta qͣtuor milia habentes
nomeneiusetnom̃	nomen eius et nom̃
patͥseiusscriptũinfrontibsuis	patͥs eius scriptũ in frontib  suis
r̃ExultentiustiũIustiin	r̃ Exultent iusti ũ Iusti in
ꝑpetuumAdbñaHisuntquicũmulierib	ꝑpetuum Ad bñ a Hi sunt qui cũ mulierib 
ñsuntcoinquinatiuͥginesenĩs̃t⁊secunt᷑agnũ	ñ sunt coinquinati uͥgines enĩ s̃t ⁊ secunt᷑ agnũ
qͦcũqieritcoll̃utsupͣAdiͣa	qͦcũq  ierit coll̃ ut supͣ Ad iͣ a
Angl̃ieorũsemꝑuidentfaciempatrisAdiiiͣa	Angl̃i eorũ semꝑ uident faciem patris Ad iiiͣ a
Voxinramaaudita	Vox in rama audita
ẽplorat᷒	ẽ plorat᷒
⁊ululat᷒rachel	⁊ ululat᷒ rachel
ploransfiliossuoscap*⁊coll	plorans filios suos cap *⁊ coll
*sicutin	* sicut in
l*AdviͣaSubt	l * Ad viͣ a Sub t
hronod̃i	h rono d̃i
sc̃iclamabantuindica	sc̃i clamabant uindica
sanguinẽnr̃md̃snr̃capitulum	sanguinẽ nr̃m d̃s nr̃ capitulum
Hiisuntqui	Hii sunt qui
cũmulierib	cũ mulierib 
ñsuntcoinquinatiuirginesenĩsunthi	ñ sunt coinquinati uirgines enĩ sunt hi
secunt᷑agnũqͦcũq	secunt᷑ agnũ qͦcũq
ierituoĩfeudumñsuccedatnisiprius	 ierit uo ĩ feudum ñ succedat nisi prius
ddomino	d domino
sat̃fec̃itp̃rimodoꝓ	sat̃fec̃it p̃ri  modo ꝓ
õib.idomesticis	õib . i domesticis
suishocfaciatIllud	suis hoc faciat Illud
quocipimus	quo  cipimus
utsiuassallusdefeudosuoaliumuassallũ	ut si uassallus de feudo suo alium uassallũ
h̃ũitetuassalusuassallidñmdñisuioffẽd̃itnisiꝓ	h̃ũit et uassalus uassalli dñm dñi sui offẽd̃it nisi ꝓ
ẜuitõalt̃ius	ẜuitõ alt̃ius
dominisuih̃fec̃itq̃msñ	domini sui h̃ fec̃it q̃m sñ
fraudeañah̃ũitfeudosuoppriuetur⁊addñm	fraude aña h̃ũit feudo suo p priuetur ⁊ ad dñm
suũaquo	suũ a quo
ip̃etenebatreũtaturnisirequisitusabeopactusfũit	ip̃e tenebat reũtatur nisi requisitus ab eo pactus fũit
sat̃fac̃emaioridñoꝙ̃offendit⁊nisiuassallusid̃	sat̃fac̃e maiori dño ꝙ̃ offendit ⁊ nisi uassallus id̃ 
asuodominorequisituseũ	a suo domino requisitus eũ
quimaiorẽdominũoffenditrequisieritutsatis	qui maiorẽ dominũ offendit requisierit ut satis
faciatsuumfeudũ	faciat suum feudũ
amittatt̃easidefeudoint̃duosuassallossit	amittat  t̃ea si de feudo int̃ duos uassallos sit
ꝯtroũsiadomini	ꝯtroũsia domini
sitꝯgnitõ⁊pereum	sit ꝯgnitõ ⁊ per eum
ꝯtroũsiat̃minetur	ꝯtroũsia t̃minetur
Siuõĩt̃dñmetuassallũlisoriat᷑	Si uõ ĩt̃ dñm et uassallũ lis oriat᷑
ꝑparescurieaddomĩos̃odebitofidelitatisꝯiuraitos	ꝑ pares curie a d domĩo s̃o debito fidelitatis ꝯiuraitos
t̃mineturIllud	t̃minetur Illud
quos̃cimuᷤ	quo  s̃cimuᷤ
utinomnisac̃m̃tofidelitatis	ut in omni sac̃m̃to fidelitatis
nominatiminmperatorexcipiaturExplicitliberautenticorumExplicitlib̃autenticorum	nominatim inmperator excipiatur Explicit liber autenticorum Explicit lib̃ autenticorum
videbr̃siñfastidioamabr̃siñfatigatõelaudabr̃	videbr̃ siñ fastidio amabr̃ siñ fatigatõe laudabr̃
hocmun᷒ceterumquifuturi	hoc mun᷒ ceterum qui futuri
suntꝓm̃itis	sunt ꝓ m̃itis 
miorum⁊gradobonorũatq	miorum ⁊ grado bonorũ atq
gl̃iarumquisestydo᷒cogitareqͣnto	 gl̃iarum quis est ydo᷒ cogitare qͣnto
mag̃dic̃etm̃fut᷑umsint	mag̃ dic̃e  tm̃ fut᷑um sint
ñẽãbigend̃atqita⁊̃bt̃a	ñ ẽ ãbigend̃ atq  ita ⁊ ̃ bt̃a
illaciuitasmagnuminsedonumuidebitq̃dnullisuperiori	illa ciuitas magnum in se donum uidebit q̃d nulli superiori
nullusinf̃iorinuidebitsic̃ñ	nullus inf̃ior inuidebit sic̃ ñ
ĩuidẽtarchãgl̃isãgl̃icet̃iTamnolleteẽun᷒ꝗsq	ĩuidẽt archãgl̃is ãgl̃i cet̃i Tam nollet eẽ un᷒ꝗsq 
q̃dñaccepitqͣmuissitpacatissimouinculo	q̃d ñ accepit qͣmuis sit pacatissimo uinculo
cõcordieeiquiaccep̃obstrictusqͣmnecĩ	cõcordie ei qui accep̃ obstrictus qͣm nec ĩ
corꝑeuultoculius	corꝑe uult ocul i u s
eẽquiẽdigituscumme	eẽ qui ẽ digitus cum me
brumutr̃q	 brum utr̃q 
contineattocipartispaccatacompago	contineat toci  partispaccata compago
sicitaqhabebitdonũalialiomin	sic itaq  habebit donũ ali  alio min
uthocqͦdonũh̃atne	 ut hoc qͦ  donũ h̃at ne
ul̃itampliusviciapersapientiedoctͥna	ul̃it amplius vicia per sapientie doctͥna
alit̃ꝑinsipiẽtispessimamuitãita⁊obliuionesmaloꝝ	alit̃ ꝑ insipiẽtis pessimam uitã ita ⁊ obliuiones maloꝝ
dues̃tAlr̃eanamqobliuiscitur	due s̃t Alr̃ ea namq  obliuiscitur
eruditus⁊doctus	eruditus ⁊ doctus
Alit̃expert⁊passIlle	Alit̃ expert ⁊ pass  Ille
sipericiamnegligatistesimiseriacareat.Scd̃m	si periciam negligat iste si miseria careat . Scd̃m
hãcobliuiõequãpost̃iorelocoposuinõeruntmemores	hãc obliuiõe  quã post̃iore loco posui nõ erunt memores
sc̃ipreteritorummaloꝝ	sc̃i preteritorum maloꝝ
Carebũteĩom̃ib.	Carebũt eĩ om̃ib .
itautpenitdeleatur	ita ut penit  deleatur
eorumsensibusEttm̃potẽtiascĩeq̃m̃gñĩeis	eorum sensibus Et tm̃ potẽtia scĩe q̃ m̃gñ ĩ eis
eritñsolũsuat̃itas⁊	erit ñ solũ sua  t̃ita s ⁊
̃dãpñtoꝝ	̃ dãpñtoꝝ
eossẽpit̃ñmiẜiañlateb̃ĩuocabim⁊uidebim᷒	eos sẽpit̃ñ miẜia ñ lateb̃ ĩuocabim ⁊ uidebim᷒
⁊am̃bim᷒am̃bim᷒⁊laudabim᷒Ecceꝙer̃	⁊ am̃bim᷒ am̃bim᷒ ⁊ laudabim᷒ Ecce ꝙ er̃
ĩfĩesũ	ĩ fĩe sũ
fineExplicitHũclibꝝ	fine Explicit Hũc libꝝ
fec̃scͥbidñsBdecastãeto	fec̃ scͥbi dñs B de castãeto
d̃igr̃aep̃salbieñannodñimͦ	d̃i gr̃a ep̃s albieñ anno dñi mͦ
cccͦorganiciineodẽinstãti	cccͦ organici in eodẽ instãti
inquodesunteẽ	in quo desunt eẽ
talisꝑs	talis ꝑs
desinitibiesseaĩanecsequit᷑	desinit ibi esse aĩa nec sequit᷑
p̃phocq̃dinedem	p̃p hoc q̃d in edem
instãtiibisit	instãti ibi sit
nõsitnecĩimo	 nõ sit  nec ĩ imo
ĩstãtipesuelmanusestꝑsul̃nõꝑs	ĩstãti pes uel manus est ꝑs ul̃ nõ ꝑs
ip̃iuscorꝑisutrumãimasitsimpliciorom̃ibaliis	ip̃ius corꝑis utrum ãima sit simplicior om̃ib  aliis
formisSEcundoquerit᷑utrumaĩasitsimplicõr	formis SEcundo querit᷑ utrum aĩa sit simplicõr
om̃ibaliisformisvidet᷑	om̃ib  aliis formis  videt᷑
q̃dnõ	q̃d nõ 
formaqueestpluribmodiscõpoĩtaqͣm	forma que est  plurib  modis cõpoĩta qͣm
alieestꝯpositõriillis	alie est ꝯpositõr i illis
saĩahũanacõpoĩtaestexeẽ	s  aĩa hũana cõpoĩta est ex eẽ
eẽnciaformeaut̃em	 eẽncia forme aut̃em
q̃educit᷑depotẽciamat͛ieñ	q̃ educit᷑ de potẽcia mat͛ie ñ
sũtexeẽ	sũt ex eẽ
eẽnͣꝯpoĩtecũeisnõꝯpetateẽ	 eẽnͣ ꝯpoĩte cũ eis nõ ꝯpetat eẽ
gͦaĩaestcõpoĩcõreis	gͦ aĩa est cõpoĩcõr eis
Pͣeẽunũcõpoĩci᷒aliodicitqddqͦsdam	Pͣ eẽ unũ cõpoĩci᷒ alio dicit qdd qͦsdam
gͣduss	gͣdus s 
nulliforͤ	nulli forͤ
sb̃alicõpetith̃re	sb̃ali cõpetit h̃re
gradusẜmeẽmͣcũquelibtalissimplici	gradus ẜm eẽmͣ cũ quelib  talis simplici
ĩuariabl̃ieẽnͣ	 ĩuariabl̃i eẽnͣ
cõsistatnecẜmeẽq̃dh̃tinsb̃o	cõsistat nec ẜm eẽ q̃d h̃t in sb̃o
cũsb̃mformesb̃alis	cũ sb̃m forme sb̃alis
sitip̃m	sit ip̃m
ylegͦsaltẽformissb̃alibaĩaip̃anõ	yle gͦ saltẽ formis sb̃alib  aĩa ip̃a nõ
eritsimplicõrpͣforͣillaq̃pot̃	erit simplicõr pͣ forͣ illa q̃ pot̃
dicihocaliqͥdẽcõpoĩtõrilla	dici hoc aliqͥd ẽ cõpoĩtõr illa
q̃hocaͥd	q̃ hoc aͥd
dicinõpot̃	dici nõ pot̃
saĩahũana	s  aĩa hũana
sinecorꝑepot̃dicihocaͥdcũsitĩdiduũin	sine corꝑe pot̃ dici hoc aͥd cũ sit ĩdiduũ in
gen͛esb̃egͦerit	gen͛e sb̃e gͦ erit
cõpoĩtõraliisformisquibind̃iduatõsine	cõpoĩtõr aliis formis quib  ind̃iduatõ sine
mͣuelcorꝑe	mͣ uel corꝑe
nõtingitꝯͣriũestaug̃VIde	nõ tingit ꝯͣriũ est aug̃ VI de
tͥni.caͦ	tͥni . caͦ
VIuͥdicit	VI uͥ dicit
q̃dcreaturasp̃ualissic̃estaĩaincõrꝑatõe	q̃d creatura sp̃ualis sic̃ est aĩa in cõ r ꝑatõe
quidẽcorꝑissimplicõrẽlicet	quidẽ corꝑis simplicõr ẽ licet
ĩcõꝑatõedeisitmultiplexquelaliaforma	ĩ cõꝑatõe dei sit multiplex  quel  alia forma
potestdicicorꝑaliscũmolecorꝑisdiffundat᷑Id̃osequit᷑q̃d	potest dici corꝑalis cũ mole corꝑis diffundat᷑ Id̃o sequit᷑ q̃d
aĩaaliis	aĩa aliis
formissitsimplicõrR̃nsiodd̃q̃dtriasũtilla	formis sit simplicõr R̃nsio dd̃q̃d tria sũt illa
queadsimplicitaterequirũt᷑	que ad simplicitate requirũt᷑
pͥmũ̃ĩd̃isibl̃itaqua·H·lib̃tatep᷒s̃t	pͥmũ  ̃ ĩd̃isibl̃ita qua · H · lib̃tate p᷒s̃t
alioscorriꝑedũtacitesibir̃ndentse	alios corriꝑe dũ tacite sibi r̃ndent se
ead̃corrigũtꝯmissiseqm̃ñpͭhortatoreẽuiduitatis	ead̃ corrigũt ꝯmissise qm̃ ñ pͭ hortator eẽ uiduitatis
qͥꝯiugiaf	qͥ ꝯiugia f
taũitIneuãg̃qͦꝓbat᷑eũqͥtͣbẽgestat	taũit In euãg̃ qͦ  ꝓbat᷑ eũ qͥ tͣbẽ gestat
ĩocl̃osuoñp᷒sefes	ĩ ocl̃o suo ñ p᷒se fes
educ̃deocl̃ofr̃issui	educ̃ de ocl̃o fr̃is sui
It̃d̃dpcc̃oriãdixͭde᷒	It̃ d̃d pcc̃ori ã dixͭ de᷒
qr̃tuenar.i᷒ticiasetassũistest̃ͫm	qr̃ tu enar . i᷒ticias et assũis test̃ͫ m
.ꝑostuũEt	. ꝑ os tuũ Et
ẜgg̃ͫc᷒	ẜ gg̃ͫ c᷒
uitadespic᷑ꝯrestatutdicatõꝯdẽpnet᷑hĩc	uita despic᷑ ꝯ re stat ut  dicatõ ꝯdẽpnet᷑ hĩc
ẽeĩꝙysaiasa	ẽ eĩ ꝙ ysaias a
dñoaddicand̃	dño ad  dicand̃
mittend᷒pͥ᷒abtatemũda᷑	mittend᷒ pͥ᷒ ab tate mũda᷑
etose᷒calcl̃otãgi᷑qͥ	et os e᷒ calcl̃o tãgi᷑ qͥ
forcipetolli᷑dealtaripri᷒gͥdebsac̃doteserrata	forcipe tolli᷑ de altari pri᷒ gͥ deb sac̃dotes errata
suacorrig̃ep᷒moͫadalienadiluendafestĩarNã	sua corrig̃e  p᷒moͫ ad aliena diluenda festĩar Nã 
gall᷒pͥ᷒seipͫalaꝝũb̃ecorripitdeiñ	gall᷒ pͥ᷒ se ipͫ alaꝝ ũb̃e corripit  deiñ
adhorascinendasceditsac̃dotes·	ad horas  cinendas cedit sac̃dotes ·
H·pler̃exemͦ	H · pler̃  exemͦ
suepassiõisaccendũtqͦss̃uit	sue passiõis accendũt qͦs s̃uit
doctͥnediuti᷒ꝯfͬmareñp᷒s̃tetuitadisciplinisñerudita	doctͥne diuti᷒ ꝯfͬmare ñ p᷒s̃t et uita disciplinis ñ erudita
exẽpreligiõisdese	exẽp religiõis de se
pr̃arenescͭq̃ĩse	pr̃are nescͭ q̃ ĩ se
ip̃aexꝑimẽtoñdidicͭUtguita	ip̃a exꝑimẽto ñ didicͭ Ut g uita 
ꝯũsaͦur̃airrehẽsibl̃isappareatcet͛isluceat	ꝯũsaͦ ur̃a irre  hẽsibl̃is appareat  cet͛is luceat
ꝑplũexpedituͭsitiuxͣeccͣmcellaur̃anl̃lus	ꝑ plũ expedit uͭ sit iuxͣ eccͣm cella ur̃a nl̃lus
ur̃marmal̃glaadferiend̃	ur̃m arma l̃ gla ad feriend̃
feratnͥfortetpr̃guerrel̃exꝓbabl̃ic̃a	ferat nͥ forte tpr̃ guerre l̃ ex ꝓbabl̃i c̃a
timornl̃l᷒	timor nl̃l᷒
comãnutͥatnebarbãetun᷒qͥs	comã nutͥat ne  barbã et un᷒qͥs
coronãtõsurãhꝯgͧentesquas	 coronã  tõsurã h ꝯgͧentes quas 
̃ꝯiugatiñbigami	̃ ꝯiugati ñ bigami
pͥuilegiocl̃icaliguaud̃etespubliceportentnl̃lusautcanũaut	pͥuilegio cl̃icali guaud̃e tes publice portent nl̃lus aut canũ aut
auiũiocisĩs͛uiatnl̃lutatibcrapulis	auiũ iocis ĩs͛uiat nl̃lu tatib  crapulis
.i.gulositatibuslitibscurrilitatib᷒	. i . gulositatibus litib  scurrilitatib᷒
ꝑcussiõib᷒et	ꝑcussiõib᷒ et
blasfemiisunull᷒spͨtacl̃isaliqͥbq̃autĩ	blasfemiis u null᷒ spͨtacl̃is aliqͥb  q̃ aut ĩ
nuptiisautĩcenisfũitexhĩtersits	nuptiis aut ĩ cenis fũit exh ĩtersit s 
põpasscl̃iꝯuiuianotapucafugiat	põpas scl̃i  ꝯuiuia nota puca fugiat
pͥuatauͦñpudicas⁊sobria	pͥuata uͦ ñ pudica s ⁊ sobria
colatUn᷒qͥs	colat Un᷒qͥs
ur̃mdolos	 ur̃m dolos
ꝯiuratõescodiũeml̃atõesobtͤctatõesatĩuidiãeffugiat	 ꝯiuratões c odiũ eml̃atões obtͤctatões at  ĩuidiã effugiat
ñuagisoc	ñ uagis oc
effͤnatalĩguaautpetulãtifluidoq	effͤnata lĩgua aut petulãti fluidoq 
ĩgestuĩcedats	ĩ gestu ĩcedat s 
puacueꝯdiãmẽtissĩplicih̃itu	pu ac ueꝯdiã mẽtis sĩplici h̃itu
ĩcessuqost̃ndatobscenitatẽboꝝmẽbroꝝ	ĩcessuq  ost̃ndat obscenitatẽ boꝝ  mẽbroꝝ
sic̃operũ	sic̃  operũ
pẽit᷒execret᷑senioribdebitatob̃iamn	pẽit᷒ execret᷑ seniorib  debit at ob̃iam n
ulloiactãciestudioseipͫattollatbonismo	 ullo iactãcie studio se ipͫ attollat bonis mo
studeatabõibillicitiscoraclĩguã	studeat  ab õib  illicitis cor ac lĩguã 
corp᷒adeot̃reꝯsõis·H	corp᷒ adeo t̃re ꝯs õis · H
·iactãciaatĩmod̃atõabõis÷	· iactãcia at  ĩmod̃atõ a bõis ÷
moribalienanull᷒ꝑq̃dꝓuocem᷑ad	morib  aliena null᷒ ꝑ q̃d ꝓuocem᷑ ad
hũilitatemexemplosueconũsatõisꝑq̃dĩformem᷑adsc̃itatẽ	hũilitatem exemplo sue conũsatõis ꝑ q̃d ĩformem᷑ ad sc̃itatẽ
Etmemoriapassionisꝑq̃dincitemuradkaritatẽ	Et memoria passionis ꝑ q̃d incitemur ad karitatẽ
Qͣrtoscribiturinhoctemplocordissp̃ualealphabetũsiuesp̃ualis	Qͣrto scribitur in hoc templo cordis sp̃uale alphabetũ siue sp̃ualis
scripturaHecãscͥpturaq̃ibiscͥbitur	scriptura Hec ã scͥptura q̃ ibi scͥbitur
triplexests.dictamĩafaciendoꝝtestiõa	triplex est s . dictamĩa faciendoꝝ testiõa
diuinoꝝbñficioꝝꝓpͥoꝝ	diuinoꝝ bñficioꝝ ꝓpͥoꝝ
acc̃atõdelictoꝝDe	acc̃atõ delictoꝝ De
hiistribusRIICIIGentesquelegẽ	hiis tribus R II C II Gentes que legẽ
nõh̃ntnaturalr̃quelegissuntfaciunthi᷒	nõ h̃nt naturalr̃ que legis sunt faciunt hi᷒
legemnõhabentesipi	legem nõ habentes ipi
sibisuntlexquiostendũtopuslegisscriptũin	sibi sunt lex qui ostendũt opus legis scriptũ in
cordibsuisEccepͥmũ	cordib  suis Ecce pͥmũ
test̃millisReddenteꝯscĩaipoꝝeccescd̃m	test̃m illis Reddente ꝯscĩa ipoꝝ ecce scd̃m
etintrasecogitatõem	et intra se cogitatõem
accusantiũul̃etiã	accusantiũ ul̃ etiã
deffẽdenciũecceterciumQuintodebent	deffẽdenciũ ecce tercium Quinto debent
pingicruces.i.assumipñieasꝑritates	pingi cruces . i . assumi pñie asꝑritates
queqͥdemdebẽt	que qͥdem debẽt
inungietigneillustrarinõsolumferendesuntpacienter	inungi et igne illustrari  nõ solum ferende sunt pacienter
setiãlibent̃	s  etiã libent̃
q̃dꝑunctionẽetardenterperignem	q̃d ꝑ unctionẽ et ardenter per ignem
UñB᷒Quiminatur	Uñ B᷒ Qui minatur
terrorecrucemxp̃iportatpacient̃quiꝑficitĩspe	terrore crucem xp̃i portat pacient̃ qui ꝑficit ĩ spe
portatlibent̃squiꝯsumaturinkaritateamplectituriam	portat libent̃ s  qui ꝯsumatur in karitate amplectitur iam
ardenterb̃multiuidentcrucesnr̃as	ardenter b̃ multi uident cruces nr̃as
snonuidentunctionesnr̃asqui	s  non uident unctiones nr̃as qui
gͥhocinsehabebituere	gͥ hoc in se habebit uere
templũadhonoremdeidedicatumeritDignusplaneĩ	templũ ad honorem dei dedicatum erit Dignus plane ĩ
quoxp̃sh̃itetꝑgr̃am	quo xp̃s h̃itet ꝑ gr̃am
uttand̃ineohabitate	ut tand̃ in eo habitate
digneturꝑgl̃amQ̃dipenobisprestaredignet᷑Qui	dignetur ꝑ gl̃am Q̃d ipe nobis prestare dignet᷑ Qui
uiuitetregnat	uiuit et regnat
deusperom̃iascl̃ascl̃oꝝameNHicliberscriptus	deus per om̃ia scl̃a scl̃oꝝ ameN Hic liber scriptus
fuitapudcysterciumAnnodomini	fuit apud cystercium Anno domini
millesimoCCCͦIIIIͦdecimokalẽdasmarciiExpliciunt	mil lesimo CCCͦ IIIIͦ decimo kalẽdas marcii Expliciunt
legendesanctoꝝul̃	legende sanctoꝝ ul̃
passionaleadbreuiatumScriptoremgratumfaciatd̃satqbeatumEt	passionale adbreuiatum Scriptorem gratum faciat d̃s atq  beatum Et
sibipͥmatumtribuat	sibi pͥmatum tribuat
deleatinreatum	deleat in reatum
amẽScriberequifecithunclibrumnon	amẽ Scribere qui fecit hunc librum non
malefecitIlle	malefecit Ille
diuduretpostmortem	diu duret post mortem
syderacuretamẽHuncdegillentoCscripsitnonpede	sydera curet amẽ Hunc de gillento C scripsit non pede
lentoQuemdeus	lento Quem deus
ĩcelistradatmanib	ĩ celis tradat manib
michaelisAMENutrũtaliaob̃aꝯc̃ꝯstãciistalibb	 michaelis AMEN utrũ talia ob̃a ꝯ c̃ꝯstãciis talibb 
sͨsintd̃isas.ꝙaliqͥs	sͨ sint d̃isa s . ꝙ aliqͥs
sicẽdispoĩt᷒ꝙtalebonũnõfac̃etꝯtemplacõneminoris	sic ẽ dispoĩt᷒ ꝙ tale bonũ nõ fac̃et ꝯtemplacõne minoris
boniul̃malis	boni ul̃ mali s
solũcõtẽplatõnemaiorisputaꝓuitãdo	 solũ cõtẽplatõne maioris puta ꝓ uitãdo
dãpnoXIId̃	dãpno XII d̃
nõiretadeccamsꝓuitãda	nõ iret ad eccam s  ꝓ uitãda
unaũb̃atõneĩcapitl̃obñiretali᷒	una ũb̃atõne ĩ capitl̃o bñ iret ali᷒
aut̃sicestdispoĩt᷒ꝙtl̃e	aut̃ sic est dispoĩt᷒ ꝙ tl̃e
bonũopusnõfac̃etꝯtẽplatõne	bonũ opus nõ fac̃et ꝯtẽplatõne
maiorisboniul̃mali	maioris boni ul̃ mali
ssolũminorisputaꝓuitãdauna	s  solũ minoris puta ꝓ uitãda una
ũb̃atõeĩ	ũb̃atõe ĩ
capl̃onõ	capl̃o nõ
iretsꝓuitãdodãpnoamusionisXIId̃bñ	iret s  ꝓ uitãdo dãpno amusionis XII d̃ bñ
iretlñ	iret l  ñ
sinealt̃oilloꝝnãsic̃ob̃aapuddiũsos	sine alt̃o illoꝝ nã sic̃ ob̃a apud diũsos
sich̃ntdiũsasc̃ꝯstãcias	sic h̃nt diũsas c̃ꝯstãcias
itaꝙiͤh̃tob̃mꝯ	ita ꝙ iͤ h̃t ob̃m ꝯ
talic̃ꝯstanciailleueroaliatũcfacilr̃	tali c̃ꝯstancia ille uero alia tũc facilr̃
pot̃im᷒ꝯꝑareact᷒ad	pot̃im᷒ ꝯꝑare act᷒ ad
ĩuicẽsiuõc̃ꝯstãcieutͦbiq	ĩuicẽ si uõ c̃ꝯstãcie utͦbiq
sĩttõisdeb̃etamitt̃etXIId̃si·H	 sĩt tõis deb̃et amitt̃et XII d̃ si · H
·gͣuit̃pcc̃atcui᷒uolũtastẽtõne	· gͣuit̃ pcc̃at cui᷒ uolũtas tẽtõne
uiliorisfinisĩclinatpcc̃andũitam᷒ũtuoseaqͥ	uilioris finis ĩclinat pcc̃andũ ita  m᷒ ũtuose a qͥ
exmi᷒bonofineĩclinat᷑afaciẽdũ	ex mi᷒ bono fine ĩclinat᷑ afaciẽdũ
si·H·ut̃q	si · H · ut̃q 
taliũeq̃lũtarieul̃ĩuolũtarieferaip̃mbonũuolitũꝙͣntũ	taliũ eq̃ lũtarie ul̃ ĩuolũtarie fera ip̃m bonũ uolitũ ꝙͣntũ
adh̃nõur̃d	ad h̃ nõ ur̃d
magisul̃m᷒bñfaꝙͣ	magis ul̃ m᷒ bñ fa ꝙͣ
ali᷒ẜrõmipi᷒uolũtariis	ali᷒ ẜ rõm ipi᷒ uolũtarii s
ꝯtĩgitexrõnec̃ꝯstãcieaddUñsic̃fortitudoẽũtus	ꝯtĩgit ex rõne c̃ꝯstãcie add Uñ sic̃ fortitudo ẽ ũtus
nobꝙͣlib̃alitasauariciapei᷒	nob ꝙͣ lib̃alitas  auaricia pei᷒
uꝙͣtimiditas	u ꝙͣ timiditas
amareẜ	 amare ẜ
rõnũcorꝑisẽmeli᷒	rõ nũ corꝑis ẽ meli᷒
ꝙͣamare	ꝙͣ amare
ext̃ioraẜ	ext̃iora ẜ
rõmsb̃diẜappeꝑamorẽĩordinatũ	rõm  sb̃di ẜ appe ꝑ amorẽ ĩordinatũ
bonisexbẽpei᷒ꝙͣ	bonis ex b  ẽ pei᷒ ꝙͣ
sb̃diẜappetitũANnodñiMͦ	sb̃di ẜ appetitũ  ANno dñi Mͦ
CCͦNonagͦVͦnõfuitcelebratũ	CCͦ Nonagͦ Vͦ nõ fuit celebratũ
capͫgñaleꝓpt̃mortẽ	capͫ gñale ꝓpt̃ mortẽ
ueñabilispr̃ismagistriordinisfr̃issteph̃idebisũcioquiobiitĩ	ueñabilis pr̃is magistri ordinis fr̃is steph̃i debisũcio qui obiit ĩ
ꝯuẽtuluchanoromaneꝓuĩcieĩ	ꝯuẽtu luchano romane ꝓuĩcie ĩ
festosc̃ececilieuirginisetmartirisAnno	festosc̃e cecilie uirginis et martiris Anno
dñiMͦCCͦNonagͦIIIIͦ	dñi Mͦ CCͦ Nonagͦ IIIIͦ
ANnodñiMͦCCͦNonagͦVIͦcelebratũfuit	ANno dñi Mͦ CCͦ Nonagͦ VIͦ celebratũ fuit
LXXIcapͫgñale	LXXI capͫ gñale
ĩargẽtinaĩꝓuinciatheutõieinqͦcapͦ	ĩ argẽtina ĩ ꝓuincia theutõie in qͦ capͦ
fuitelc̃us	fuit elc̃us
inmagistrũordinis	in magistrũ ordinis
ueñabilispater	ueñabilis pater
dñsfraterNycholausdetriuisioqͥtũceratpͥorꝓuĩcialis	dñs frater Nycholaus de triuisio qͥ tũc erat pͥor ꝓuĩcialis
lõbardieANnodñiMͦ	lõbardie ANno dñi Mͦ
CCͦNonagͦVIIͦcelebratũ	CCͦ Nonagͦ VIIͦ celebratũ
fuitLXXIIcapͫgñaleueneciisinꝓuĩcialõbardieANno	fuit LXXII capͫ gñale ueneciis in ꝓuĩcia lõbardie  ANno
dñiMͦCCCIͦcelebratum	dñi Mͦ CCCIͦ celebratum
fuitLXXVcapͫgñalecolõieinꝓuĩciath̃otoniein	fuit LXXV capͫ gñale colõie in ꝓuĩcia th̃otonie in
quocapͦfuitelc̃usinmagistrũ	quo capͦ fuit elc̃us in magistrũ
ordinisfrat̃B̃nard᷒deiuzicodyoc̃	ordinis frat̃ B̃nard᷒ de iuzico dyoc̃
uasaceñdeꝓuĩciatholosanaquitũcerat	uasaceñ de ꝓuĩcia tholosana qui tũc erat
pͥorꝓuĩcialisꝓuĩcienõdũdiuiseANnodñiMͦCCCIIͦcelebratum	pͥor ꝓuĩcialis ꝓuĩcie nõdũ diuise ANno dñi Mͦ CCCIIͦ celebratum
fuitLXXVI	fuit LXXVI
capͫgñalebononieĩꝓuĩcialõbardieafatomagr̃o	capͫ gñale bononie ĩ ꝓuĩcia lõbardie a  fato magr̃o
͛quiobiitpostdictũcapͫĩꝯuẽtutreũensi	͛ qui obiit post  dictũ capͫ ĩ ꝯuẽtu treũensi
ĩꝓuĩciatheutonieXVͦkls̃	ĩ ꝓuĩcia theutonie XVͦ kls̃
octobrisin	octobris in
festob̃tilamb̃ti	festo b̃ti lamb̃ti
ANnodñiMͦCCCIIIIͦcelebratũfuitLXXVIIIcapͫ	ANno dñi Mͦ CCCIIIIͦ celebratũ fuit LXXVIII capͫ
gñaletholosexp̃ianusIlleuerexp̃ianusestqͥom̃ib	gñale tholose xp̃ianus Ille uere xp̃ianus est qͥ om̃ib
mĩamfacitquinullaoĩomouet᷑ĩiuriaqui	 mĩam facit qui nulla oĩo mouet᷑ ĩiuria qui
alienũdolorẽtãqͣmꝓpͥumsentitcui᷒mensãnl̃lus	alienũ dolorẽ tãqͣm ꝓpͥum sentit cui᷒ mensã nl̃lus
paup̃ignoratquicorãhõibingl̃iushabet᷑	paup̃ ignorat qui corã hõib  ingl̃ius habet᷑
utcorã	ut corã
deoangelisgl̃iet᷑qui	deo  angelis gl̃iet᷑ qui
t̃renaꝯtempnitut	t̃rena ꝯtempnit ut
possith̃recelestiaquioppͥmiͭpauꝑẽ	possit h̃re celestia qui oppͥmiͭ pauꝑẽ
sesentenõ	se  sente nõ
patit᷑quimis̃issb̃uenitqui	patit᷑ qui mis̃is sb̃uenit qui
adfletumfletib	ad fletum fletib 
ꝓuocat᷑alienisq̃dbenefaciebat	ꝓuocat᷑ alienis q̃d bene faciebat
paulusquisĩfirmat᷑ego	paulus quis ĩfirmat᷑  ego
uõĩfirmoraug̃liodeuita	uõ ĩfirmor aug̃ lio de uita
xp̃ͥanaxp̃ianinom̃illefrustͣsortit᷑quixp̃m	xp̃ͥana xp̃iani nom̃ ille frustͣ sortit᷑ qui xp̃m
m̃imeĩmitat᷑quid·H·tͥ	m̃ime ĩmitat᷑ quid · H · tͥ
ꝓdestuocariꝙnõesnom̃	ꝓdest uocari ꝙ nõ es  nom̃
uiuatcruxestatquemrty	uiuat crux est atque mrty
magxim᷒ĩs̃natal̃dñiubifidesũitasf	magxim᷒ ĩ s̃ natal̃ dñi ubi fides ũitas f
xp̃saEsuriuitxp̃sqͥom̃spa	xp̃s a Esuriuit xp̃s qͥ om̃s pa
sitiuitꝑ	sitiuit ꝑ
quemcausat᷑ontusqui	quem causat᷑ on tus  qui
sp̃ualit̃paniserienciũfonsqsitientiũa	sp̃ualit̃ panis e rienciũ fonsq  sitientiũ a
t̃restͥfatigat᷒estquisenob̃uiã	t̃restͥ fatigat᷒ est qui se nob̃ uiã
fecitĩcelũ	fecit ĩ celũ
uelumutuitobsurduitcorãciantib	uelu mutuit  obsurduit corã ciantib
ꝑquẽmut᷒	 ꝑ quẽ mut᷒
locusurd᷒	locu  surd᷒
audiuituinct᷒est	audiuit uinct᷒ est
deĩfirmitatũuincl̃isnossol	de ĩfirmitatũ uincl̃is nos sol
flagellat᷒estquiom̃iflagloꝝdehoĩm	flagellat᷒ est qui om̃i flag loꝝ de hoĩm
corꝑibexpulitfix᷒estquicruciat᷒	corꝑib  expulit fix᷒ est qui cruciat᷒
nr̃osfimortuu᷒estqͥmortuossuscs	nr̃os fi mortuu᷒ est qͥ mortuos susc s 
resurrexitnũꝙͣmoritu	resurrexit nũꝙͣ moritu
Acidissealiquẽĩmocredũtpectora	Acidisse aliquẽ ĩmo credũt pectora
brachia⁊uultũ	brachia ⁊ uultũ
ipugen᷒cibi⁊exhocauctor	ipu gen᷒ cibi ⁊ ex hoc auctor
exclamãdodicit	exclamãdo dicit
gͦꝗddic̃et	gͦ ꝗd dic̃et
pictaul̃quonõfugeretsiuidẽthecmõstra	picta ul̃ quo nõ fugeret si uidẽt hec mõstra
quiabstinuitcũctisb.tanꝙͣabhoĩenec	qui abstinuit cũctis b . tanꝙͣ ab hoĩe nec
indulsituentri	indulsit uentri
om̃elegum̃qiͣdicatagorascredebatessemagnũ	om̃e legum̃ qiͣ dica tagoras credebat esse magnũ
nephasnocomed̃ehoĩegiptiisedmanducareaĩalia⁊	nephas no  comed̃e hoĩ egiptii sed manducare aĩalia ⁊
õialegumina	õia legumina
ꝙforti᷒ẽĩiinger̃eretardabat	ꝙ forti᷒ ẽ ĩ i inger̃e retardabat
finitolibrositlaus⁊	finito libro sit laus ⁊
gl̃axp̃o	gl̃a xp̃o
am̃Isteliberquisenatori᷒uocat᷑fuitscͥpt᷒ꝑ	am̃ Iste liber qui senatori᷒ uocat᷑ fuit scͥpt᷒ ꝑ
menicolaũolimdeꝑ	me nicolaũ olim de ꝑ
annodñimillͦcccͦviiͦindictiõevͣ	anno dñi millͦ cccͦ viiͦ indictiõe vͣ
tp̃redñiclem̃tisp	tp̃re dñi clem̃tis p
annoei᷒ẜomẽsis	anno ei᷒ ẜo mẽsis
alisdie	a  lis die
xixͣ⁊fuitꝯpilat᷒quoad	xixͣ ⁊ fuit ꝯpilat᷒ quo ad
lectinobilẽ⁊illustrẽuirũdñm	lecti nobilẽ ⁊ illustrẽ uirũ dñm
Gentilẽdefiliisursitpr̃suisenat᷒PAsce	Gentilẽ de filiis ursi tpr̃ sui senat᷒ P Asce
ouesmeas	oues meas
inio.Sicutestinoꝑib	in io . Sicut est in oꝑib 
mechanicisitaestinoꝑibusnostre	mechanicis ita est in oꝑibus nostre
salutissuomodoSeduidemus	salutis suo modo Sed uidemus
quodqñartifexaͥcuiusartismechãice	quod qñ artifex aͥcuius artis mechãice
debetaͥcubiꝓficisciinstruitaͥꝙͤdearte	debet aͥcubi ꝓficisci instruit aͥꝙͤ de arte
suapͤcipueetinforͣtcuicõmittitofficiũsuũ	sua pͤcipue et inforͣt cui cõmittit officiũ suũ
postrecessũsuũexeꝙͤdumSic	post recessũ suũ exeꝙͤdum Sic
fecitdñsih̃sxp̃sipe·H·qui	fecit dñs ih̃s xp̃s ipe · H · qui
eratinhocmũdorectoretpastorouiũtociusgͤgis	erat in hoc mũdo rector et pastor ouiũ tocius gͤgis
eccͤrecessurusamũdoet	eccͤ recessurus a mũdo et
ascensurusincelũloco	ascensurus in celũ loco
suiinstituitadregim̃suigregisb̃tmapl̃msuũ	sui instituit ad regim̃ sui gregis b̃tm apl̃m suũ
petr̃etdemodoregis	petr̃ et de modo regis
inforͣuitdicenspasceouesmeasin	inforͣuit dicens pasce oues meas in
quibũbis	quib  ũbis
tͥanoͣntur	tͥa noͣntur
pͥm̃est	pͥm̃ est
auctoͣspͤlatipͤsidentispascescd̃mest	auctoͣs pͤlati pͤsidentis pasce scd̃m est
condc̃opp̃obedientisouest̃ciũ	condc̃o pp̃ obedientis oues t̃ciũ
estaffc̃oxͥꝯ	est affc̃o xͥ ꝯ
mͭtentisineasobligaciopͤsidentis	mͭtentis in eas obligacio pͤsidentis
estinsubuẽiendo	est in subuẽiendo
cũsollicitudĩeCondc̃opp̃estinobediendocũmansuetudineaffc̃o	cũ sollicitudĩe Condc̃o pp̃ est in obediendo cũ mansuetudine affc̃o
cõmͭtentisestincõmendandocũten͛itudĩePͥm̃gͦ	cõmͭtentis est in cõmendando cũ ten͛itudĩe Pͥm̃ gͦ
quodnoͣturinũbisꝓpoĩtisestobligaciopͤlati	quod noͣtur in ũbis ꝓpoĩtis est obligacio pͤlati
pͤsidentisqueconsistitinsubuẽiendocũsollicitudĩeinh̃quod	pͤsidentis que consistit in subuẽiendo cũ sollicitudĩe in h̃ quod
dicit᷑pasceAdhoc·H·obligant᷑	dicit᷑ pasce Ad hoc · H · obligant᷑
pͤsidentesetpͤlatiutgͤgem	pͤsidentes et pͤlati ut gͤgem
sͥcõmissũsollicitepascant	sͥ cõmissũ sollicite pascant
nõuttondeantuel	nõ ut tondeant uel
excorientdehocpͭ	excorient de hoc pͭ
expõiquoddr̃dIͣpe	expõi quod dr̃d Iͣ pe
.Vpascitequiinuobisestgͤgemcõmissũs	. V pascite qui in uobis est gͤgem cõmissũ s
.pͣcõnisũbout	. pͣcõnis ũbo ut
indilectionedeiet	in dilectione dei et
cogͥtionesuiꝓficiatcõũsacionisexonegͤgemin	cogͥtione sui ꝓficiat cõũsacionis exo ne gͤgem in
uiamoꝝerrarefaciatAmbulateindilc̃one	uia moꝝ errare faciat Ambulate in dilc̃one
sicutetxᷤdilexitnosadephesᷤVsapiensin	sicut et xᷤ dilexit nos ad ephesᷤ V sapiens in
ꝓũbiisuitam	ꝓũbiis uitam
iusticõꝑatluce.	iusti cõꝑat luce .
ꝓu͛biisiiiiiustoꝝsemita	ꝓu͛ biis iiii iustoꝝ semita
q.luxsplendẽs	q . lux splendẽs
proceditetcͤscitusadꝑfc̃mdiem	procedit et cͤscit us  ad ꝑfc̃m diem
luxaũdieisic	lux aũ diei sic
seh̃tquodsemꝑcͤscitueldecͤscitnõꝙͣineod̃	se h̃t quod semꝑ cͤscit uel decͤscit nõꝙͣ in eod̃
statuꝑmanetSic	statu ꝑmanet Sic
estdeuita	est de uita
iustisemꝑ·H·	iusti semꝑ · H ·
cͤsc̃ueldecͤscit	cͤsc̃ uel decͤscit
inbonosicutdicitBernardus	in bono  sicut dicit Ber nardus
inuiadeinõ	in uia dei nõ
ꝓgͤdiregͤdiestetidcircoapl̃usinũbisꝓpoĩtisnon	ꝓgͤdi regͤdi est et idcirco apl̃us in ũbis ꝓpoĩtis non
hortaturad	hortatur ad
ꝓficiendũinuia	ꝓficiendũ in uia
moꝝdicẽsambulateetc̃Inquibusũbispͦnoshortatur	moꝝ dicẽs ambulateetc̃ In quibus ũbis pͦ nos hortatur
apl̃usadꝓfectumcontinuũambulate	apl̃us ad ꝓfectum continuũ ambulate
scd̃osubditmodũꝯgruũindilectione	scd̃o subdit modũ ꝯgruũ in dilectione
deit̃ciosubiũg̃exẽplũpͤcipuũSicut	dei t̃cio subiũg̃ exẽplũ pͤcipuũ Sicut
etxᷤdilexit	et xᷤ dilexit
nosPrimogͥ	nos Primo gͥ
noshortaturapl̃usadꝑfc̃mcontinuũcũdiciturambulate	nos hortatur apl̃us ad ꝑfc̃m continuũ cũ dicitur ambulate
nõpedibuscorporissedoꝑibusuirtutisꝑficiendo	nõ pedibus corporis sed oꝑibus uirtutis ꝑficiendo
s.deuirtute	s . de uirtute
inuirtutemnõiacendocũuoluptuosis	in uirtutem nõ iacendo cũ uoluptuosis
ꝑcarnalemcõcupĩamnõsedendo	ꝑ carnalem cõcupĩam nõ sedendo
cũinsidiosisꝑintentionismalitiamnõ	cũ insidiosis ꝑ intentionis malitiam nõ
stãdocũaccidiosisperignauiametpigͥtiamnõequitando	stãdo cũ accidiosis per ignauiam et pigͥtiam nõ equitando
cũpõposisetambitiosisꝑelacõmet	cũ põposis et ambitiosis ꝑ elacõm et
suꝑbiamsedambulãdocũlaboriosis	suꝑbiam sed ambulãdo cũ laboriosis
etfestinantibus	et festinantibus
adpr̃iamdeistoꝑfc̃ũambul̃onisdr̃d	ad pr̃iam de isto ꝑfc̃ũ ambul̃onis dr̃d
MicheeVIiudicabotͥohomo	Michee VI iudicabo tͥ o homo
geliiSecunduMatheumix	gelii Secundu Matheum ix
INillotp̃reAngl̃s	IN illo tp̃re Angl̃s
dñiapparuitinsõnisiosephdicẽsSurge	dñi apparuit in sõnis ioseph dicẽs Surge
accipepuerũetmatrẽeius	 accipe puerũ et matrẽ eius 
fugeinegiptũ	fuge in egiptũ
estoibiusqdũdicamtibiEtrel̃	 esto ibi usq  dũ dicam tibi Et rel̃
homelialectiõiseiusdemin	homelia lectiõis eiusdem in
xpmamariũfidmẽeꝑ	xp ma mari ũ fid mẽ e ꝑ
proreddramꝑegͥnusꝑficiopericl̃mperiuriũperseũanͣpeticio	pro redd ram ꝑegͥnus ꝑficio pericl̃m periuriũ perseũanͣ peticio
petr᷒apl̃spetr᷒martirpietaspigriciapiscatorpollucio	petr᷒ apl̃s petr᷒ martir pietas pigricia piscator pollucio
potenciapotuspreceptũpredestinacõpredicaciopredicator	potencia potus preceptũ predestinacõ predicacio predicator
predoprelatus	predo prelatus
prelaciopositussciencia	prelacio  positus  sciencia
sermoserpenss̃uiciũseũitassignũ	sermo serpens s̃uiciũ seũitas signũ
silenciũsiluest̃simiasymonmag᷒symon	silenciũ siluest̃ simia symon mag᷒ symon
iudassymoniasĩplicitassimulaciosingl̃aritassitissobrietassompn᷒sortilegiũ	 iudas symonia sĩplicitas simulacio singl̃aritas sitis sobrietas sompn᷒ sortilegiũ
spectacl̃msolitudo	spectacl̃m solitudo
soluciosponsaliastatusFinishuicueniteccenũcuenit	solucio sponsalia status Finis huic uenit  ecce nũc uenit
hi᷒alphabetifinisilli	hi᷒ alphabeti finis illi
gr̃asqui÷alpha	gr̃as qui ÷ alpha
opͥncipiũfinisꝘ	 o pͥncipiũ  finis Ꝙ
qͥhũclibꝝ	qͥ hũc libꝝ
lecturisuntoraredeuotedignent᷑uthoꝝ	lecturi sunt orare deuote dignent᷑ ut hoꝝ
ꝯpilatorc᷒nom̃ĩꝓlogoꝯtinet᷑eoꝝ	ꝯpilator c᷒ nom̃ ĩ ꝓlogo ꝯtinet᷑ eoꝝ
oracõibadiutusfinẽlegatũ	oracõib  adiutus finẽ legatũ
ꝯsequim̃eat᷑Ꝙipepr̃aredignetur	ꝯsequi m̃eat᷑ Ꝙ ipe pr̃are dignetur
sc̃atrinitasun᷒de᷒sñfinebenedc̃usinscl̃ascl̃oꝝ	sc̃a trinitas un᷒ de᷒ sñ fine benedc̃us in scl̃a scl̃oꝝ
amenAnnodñimͦcccmoviiiFRatrẽGuill̃mpetri	amen Anno dñi mͦ cccmo viii FRatrẽ Guill̃m petri
degodinobaioneñ	de godino baioneñ
ord̃fr̃mdicatoꝝmagr̃mĩtheologiaꝑisĩassũpsitin	ord̃ fr̃m  dicatoꝝ magr̃m ĩ theologia ꝑisĩ assũpsit in
presbiteriumcardinalẽtitulisc̃ececilieidemdñsclemens	presbiterium cardinalẽ tituli sc̃e cecilie idem dñs clemens
ppͣv᷒sabb̃oinieiuniisiiiiortp̃oꝝ	ppͣ v᷒ sabb̃o in ieiuniis iiiior tp̃oꝝ
inaduẽtu	in aduẽtu
xͦkls̃ianuariiAnnodñimͦcccͦxiiͦpõtificat	xͦ kls̃ ianuarii Anno dñi mͦ cccͦ xiiͦ põtificat
suiannoviiiͦEratãttc̃	 sui anno viiiͦ Erat ãt tc̃
l̃ctorsacripalaciiuͥlegerat	l̃ctor sacri palacii uͥ legerat
iãviannisfueratqpͥor	iã vi annis fueratq  pͥor
ꝓuĩcial̃ĩꝓuinciaꝓuĩcieord̃	ꝓuĩcial̃ ĩ ꝓuincia ꝓuĩcie ord̃ 
dic̃primoetinꝓuinciatholosanahũcp᷒modũ	dic̃ primo et in ꝓuincia tholosana hũc p᷒modũ
fec̃ep̃m	fec̃ ep̃m
cardinalẽsabinẽcẽdñsioh̃espapa	cardinalẽ sabinẽcẽ dñs ioh̃es papa
hicfec̃construitotãeccamt̃capusfr̃m	hic fec̃ construi totã eccam  t̃ capus fr̃m 
d̃tholosesuissũptibetexpẽcis	d̃ tholose suis sũptib  et expẽcis
Ratrẽmatheũdeurssinisde	Ratrẽ matheũ de urssinis de
c̃itateromana	c̃itate romana
magr̃mĩtheulogiaꝑisĩdecui	magr̃m ĩ theulogia ꝑisĩ de cui
ospicioañlongefuerãtassũptia	 ospicio añ longe fuerãt assũpti a
qͥdampapeet	qͥdam pape et
eciãinperatoresnͨnõetplurescardinalesassũpsitin	eciã inperatores nͨ nõ et plures cardinales assũpsit in
presbiteꝝcardinalemtͥtͥsc̃oꝝioh̃isetpaulidñsioh̃es	presbiteꝝ cardinalem tͥtͥ sc̃oꝝ ioh̃is et pauli dñs ioh̃es
papainieiuniis	papa in ieiuniis
iiiiortẽpoꝝaduẽtusxiiiiͦkl̃ianuariiannodñi	iiiior tẽpoꝝ aduẽtus xiiiiͦ kl̃ ianuarii anno dñi
mͦcccͦxxͦviiͦistefuitin	mͦ cccͦ xxͦ viiͦ iste fuit in
viicapogñaliburdegal̃celebratoanno	vii capo gñali burdegal̃ celebrato anno
dñimͦcccͦxxͦiiiiͦerateĩpͥorꝓuĩcial̃	dñi mͦ cccͦ xxͦ iiiiͦ erat eĩ pͥor ꝓuĩcial̃
romaneꝓuĩcieinquocapl̃ofuitgrauit̃	romane ꝓuĩcie in quo capl̃o fuit grauit̃
infirmFr̃emGeraldũdedomaroBriueñ	infirm  Fr̃em Geraldũ de domaro Briueñ
ord̃fr̃mdicaꝝmagr̃mĩtheologiaꝑisĩassũpsit	ord̃ fr̃m  dicaꝝ magr̃m ĩ theologia ꝑisĩ assũpsit
ĩbr̃mcard̃tͥtͥsc̃esabine	ĩ  br̃m card̃ tͥtͥ sc̃e sabine
dñsclemenspapavi᷒	dñs clemens papa vi᷒
sasab̃toĩieiuniisiiiiorfest̃exaltacõissc̃ecrucis	sa sab̃to ĩ ieiuniis iiiior fest̃ exaltacõis sc̃e crucis
cũuomitucipueinegͥtudinib	cũ uomitu  cipue in egͥtudinib
acutis	 acutis
ethoriscrisisEtqñestcũ	et horis crisis Et qñ  est cũ
cõitateñuoꝝuenientiũadeaac̃ebro	cõitate ñuoꝝ uenientiũ ad ea a c̃ebro
nuchacũꝯũitatequãc̃ebꝝh̃t	 nucha cũ ꝯũitate quã c̃ebꝝ h̃t
cũeisFennouadedispositionibusgutturiscuius	cũ eis Fen noua de dispositionibus gutturis cuius
estunustractatuscõtinenstresdecimcapitula	est unus tractatus cõtinens tresdecim capitula
CapitulũprimũestdeanathomiagutturiᷤPErgutturintelligim᷒spatiũ	Capitulũ primũ est de anathomia gutturiᷤ PEr guttur intelligim᷒ spatiũ
ĩquosunt	ĩ quo sunt
meat᷒hanelit᷒	meat᷒ hanelit᷒
etcibiEtdeeosuntadditõque	et cibi Et de eo sunt additõ que
estunaEt	est una Et
amigdaleEtgalsamathiEt	amigdale Et galsamathi Et
tuquid̃iamsciuistianathomiãmery	tu quid̃ iam sciuisti anathomiã mery
etanͣmepyglotisUnauõest	et anͣm epyglotis Una uõ est
sub̃iacarnosapendenssuprasupremãꝑtẽepiglotissicutuelam̃	sub̃ia carnosa pendens supra supremã ꝑtẽ epiglotis sicut uelam̃
Eteiusquid̃	Et eius quid̃
iuuam̃tũestgͣdatõaerisut	iuuam̃tũ est gͣdatõ aeris ut
nonꝑcutiatsuofrigorepl̃monemsubitoEtꝓh̃eatpulũem	non ꝑcutiat suo frigore pl̃monem subito Et ꝓh̃eat pulũem
fumũEtutsitꝑcutiensuocemquaconfortet᷑et	 fumũ Et ut sit ꝑcutiens uocem qua confortet᷑ et
magnificeturqiͣipasitportacustodienssuꝑexitũuocis	magnificetur qiͣ ipa sit porta custodiens suꝑ exitũ uocis
qͣntitatesua	qͣntitate sua
Etp̃phocuocetei᷒incisiouoci	Et p̃p hoc uocet ei᷒ incisio uoci
etꝑatpl̃monẽ	et  ꝑat pl̃monẽ
adrecipiendũfrig᷒etnocum̃tũei᷒ettussimabeo	ad recipiendũ frig᷒ et nocum̃tũ ei᷒ et tussim ab eo
Dueuõamigdale	Due uõ amigdale
suntduecarnesnateinradicelinguetendentesad	sunt due carnes nate in radice lingue tendentes ad
suꝑioraac	suꝑiora ac
dubiumnonestIdemqͣrediedominicosac̃dotũ	dubium non est Idem qͣre die dominico sac̃dotũ
ordinacõescelebrant᷑QUodindiedñicoordinacionessac̃dotũep̃oꝝcelebrãtur	ordinacões celebrant᷑ QUod in die dñico ordinaciones sac̃dotũ ep̃oꝝ celebrãtur
nõtm̃exconsuetudĩeseteciãexapl̃icanouim᷒	nõ tm̃ ex consuetudĩe set eciã ex apl̃ica nouim᷒
uẽiredoctrinascripturaact᷒xiiiũsuspͥnmãifestante	uẽire doctrina scriptura act᷒ xiii ũsus pͥn mãifestante
q̃dcũapl̃i	q̃d cũ apl̃i
paulũbarnabamexsp̃ssc̃i	paulũ  barnabam ex sp̃s sc̃i 
ceptoadeuͣngl̃iumgentibmitt̃ent	cepto ad euͣngl̃ium gentib  mitt̃ent 
dicandũieiunantes	dicandũ ieiunantes
orantesimposũunteismanusutintl̃ligamusqͣnta	 orantes imposũunt eis manus ut intl̃ligamus qͣnta 
danciũaccipienciũdeuocionecurand̃	danciũ  accipienciũ deuocione curand̃
sitnetantebñdc̃onissacr̃mneggligent̃uideat᷑impletũ	sit ne tante bñdc̃onis sacr̃m neggligent̃ uideat᷑ impletũ 
iõpielaudabl̃rapl̃icismorẽgesẜisinstitutissihͣnc	iõ pie  laudabl̃r apl̃icis morẽ gesẜis institutis si hͣnc
ordinãdorũsac̃doctũforͣm	ordinãdorũ sac̃do c tũ forͣm
ꝑeccl̃iasquibusdñsesse	ꝑ eccl̃ias quibus dñs  esse
teuoluit	te uoluit
̃ipeẜuaũisiciiac	 ̃ ipe ẜuaũis icii ac
medianeebdomadesabb̃i	mediane ebdomade  sabb̃i
ieiuniocircauesꝑasip̃as	ieiunio circa uesꝑas ip̃as
ordĩacõesnoũitiscelebͣndasNeccuiuslibutilitatisc̃a	ordĩacões noũitis celebͣndas Nec cuiuslib  utilitatis c̃a
pbr̃mseudyaconẽhiisferreaudeantqui	pbr̃m seu dyaconẽ hiis  ferre audeant qui
añiposfũintordinatidist̃lxxviQUib	añ ipos fũint ordinati dist̃ lxxvi QUib 
tp̃ribieiuniacelebͣnda	tp̃rib  ieiunia celebͣnda
suntcalixtusppͣdet̃minatscͥbensbñdc̃oep̃oquib	sunt calixtus ppͣ det̃minat scͥbens bñdc̃o ep̃o quib
tp̃ribieiuniacelebrenturIEiuniũq̃dteriap̃	 tp̃rib  ieiunia celebrentur IEiuniũ q̃d ter i ap̃
nosinannocelebraredidicistisꝯuẽienciusnob̃	nos in anno celebrare didicistis ꝯuẽiencius nob̃
nũcꝑqͣtuortemꝑaf̃i	nũc ꝑ qͣtuor temꝑa f̃i
dec̃nim᷒utsic̃annusꝑqͣtuor	dec̃nim᷒ ut sic̃ annus ꝑ qͣtuor
uoluit̃tpr̃sicnosqͣternũsollempne	uoluit̃ tpr̃ sic  nos qͣternũ sollempne
agam᷒ieiuniũꝑqͣtuorãnitpr̃Item	agam᷒ ieiuniũ ꝑ qͣtuor ãni tpr̃ Item
excon.magociẽsi	ex con . magociẽsi
deeodẽConstituim᷒utqͣtuortpr̃anni	de eodẽ Constituim᷒ ut qͣtuor tpr̃ anni
abõibhom̃ibꝯInpari	ab õib  hom̃ib  ꝯ In pari
delictouelcausapocior	delicto uel causa pocior
estconditõpossidentisIDem	est conditõ possidentis IDem
CUmconstatper	CUm con stat per
eumquomin᷒conditõimpleatur	eum quomin᷒ conditõ impleatur
h̃ridꝑinde	h̃ri d  ꝑinde
acsiimpletafuissIDemQuodalicuisuo	ac si impleta fuiss  IDem Quod alicui suo
nonlicetnoĩenecalieno	non licet noĩe nec alieno
licebitIDemPotest	licebit IDem Potest
quisperaliumquodpotestfac̃eꝑ	quis per alium quod potest fac̃e ꝑ
seip̃mIDemInmalispromissis	se ip̃m IDem In malis promissis
fidemnõexpedit	fidem nõ expedit
obẜuariIDemInalt̃natiuisdebitorisẽelectõ	obẜuari IDem In alt̃natiuis debitoris ẽ electõ
etsufficitalt̃madĩpleriIDemQuiad	et sufficit alt̃m adĩpleri IDem Qui ad
agendũadmittit᷑ẽadexcipiẽdũml̃tomagisadmittẽd᷒	agendũ admittit᷑ ẽ ad excipiẽdũ ml̃to magis admittẽd᷒
IDemQuifacitꝑalium	IDem Qui facit ꝑ alium
estꝑindeacsifaciatꝑseip̃m	est ꝑinde ac si faciat ꝑ se ip̃m
IDemFactũlegitime.i.ꝯpleteretractarinõdebet	IDem Factũ legitime . i . ꝯplete retractari nõ debet
licetcasusposteaeueniatexactumit̃mexigaturIDemCUm	licet casus postea eueniat exactum it̃m exigatur IDem CUm
quiduna	quid una
uianõprohibeturalicuiadidalia	uia nõ prohibetur alicui ad id alia
nõdadmittiIDemContractusexconuẽtõne	nõ d  admitti IDem Contractus ex conuẽtõne
legemacciꝑedinoscũt᷑IDeDanpnũquodquissuaculpa	legem acciꝑe dinoscũt᷑ IDe  Danpnũ quod quis sua culpa
sentitsibidnõaliisĩputari	sentit sibi d  nõ aliis ĩputari
IDeInfamibportenõpateãt	IDe  Infamib  porte nõ pateãt
dignitumIDemCertumestꝙis	dignitum IDem Certum est ꝙ is
ꝯmͭtitinlegemqui	ꝯmͭtit in legem qui
legisuerba	legis uerba
cõplectenscontra	cõplectens contra
legisnittitur	legis nittitur
uoluntatemExplicitlibersextusdecretaliumconpletusper	uoluntatem Explicit liber sextus decretalium conpletus per
dieluneĩuigiliab̃timartinihyemalis	die lune ĩ uigilia b̃ti martini hyemalis
deogracias	deo gracias
annodñimͦ	anno dñi mͦ
cccͦxvͦInstudio	cccͦ xvͦ In studio
dictihicẽuerꝓpheta	dicti hic ẽ uer  ꝓpheta
quiuẽturĩmũdũEstaut̃ualdeꝯuẽens	qui uẽtur  ĩ mũdũ Est aut̃ ualde ꝯuẽens
ꝙaduẽtdñiĩ	ꝙ aduẽt  dñi ĩ
cedẽtedñicainchoet᷑ut	 cedẽte dñica inchoet᷑ ut
ecciaad	eccia ad
aduẽtũxp̃ieic̃tifica	aduẽtũ xp̃i ei  c̃tifica
ꝓmissiõeꝯsolatarespirãsdeuoci⁊	ꝓmissiõe ꝯsolata respirãs deuoci ⁊
uericlamatAtteleuauiaĩameãAd	ueri  clamat At te leuaui aĩa  meã Ad
cuiꝯtẽplacõeaĩe	cui  ꝯtẽplacõe  aĩe
nr̃esicleuẽt᷑ut	nr̃e sic leuẽt᷑ ut
ĩaduẽtudistrictiiudic̃beat̃	ĩ aduẽtu districti iudic̃ beat̃
sociẽt᷑ꝙgraciosenob̃ꝯcedat	sociẽt᷑ ꝙ graciose nob̃ ꝯcedat
quisñfĩeuiuit⁊regnatamen	qui sñ fĩe uiuit ⁊ regnat amen
aͦdñimͦccccͦistoãno	aͦ dñi mͦ ccccͦ isto ãno
finit⁊ꝯpletẽistelib̃laustibisit	finit ⁊ ꝯplet  ẽ iste lib̃ laus tibi sit
xp̃equoniamliberexplicitistepermanusiohãnisleufferswillen	xp̃e quoniam liber explicit iste per manus iohãnis leufferswillen
scriptorẽnos	scriptorẽ nos
tiamconsideransdicitquidet̃raestdeterra	tiam considerans dicit qui de t̃ra est de terra
loquiturqͥdecelouenitsuperomnes	loquitur qͥ de celo uenit super omnes
ẽTuautemdominer̃Descẽdetdominussicutpluuiain	ẽ Tu autem domine r̃ Descẽdet dominus sicut pluuia in
uellusOrieturindieb	uellus Orietur in dieb 
eiusi᷒ticiaethabundanciapacis	eius i᷒ticiaet habundancia pacis
ũEtadorabunteumomnesregesom̃sgentes	ũ Et adorabunt eum omnes reges om̃s gentes
seruienteiOrieturl̃viiiͣ	seruient ei Orietur l̃ viiiͣ
Curincarc̃epositusmittensdiscipulosrequirittu	Cur in carc̃e positus mittens discipulos requirit tu
esquiuenturus	es qui uenturus
eᷤanalium	eᷤ an alium
expectamustãꝙͣsiignoretquemõnderatetanipesit	expectamus tãꝙͣ si ignoret quem õnderat et an ipe sit
nesciatquem	nesciat quem
ip̃meẽꝓph̃andobaptisandoostendendoclamauerats	ip̃m eẽ ꝓph̃ando baptisando ostendendo clamauerat s 
hecciciusquestiosoluitursigeste	hec cicius questio soluitur si geste
reitempusetordopenseturTuautẽ	rei tempus et ordo pensetur Tu autẽ
r̃monteᷤremanip̃eueniatrequiritnon	r̃ monteᷤ rem an ip̃e ueniat requirit non
quiaip̃meẽmundiredemptorẽdubitat	quia ip̃m eẽ mundi redemptorẽ dubitat
sedquerit	sed querit
utsciatsiisquipersein	ut sciat si is qui per se in
mundumueneratperseeciamadinferniclaustradescendat	mundum uenerat per se eciam ad inferni claustra descendat
Quemenimprecurrensmundonunciauerathuncmoriendoetadinferos	Quem enim precurrens mundo nunciauerat hunc moriendo et ad inferos
currebatTuaut̃r̃Ecceradix	 currebat Tu aut̃ r̃ Ecce radix
iesseascendetinsalutempopulorumip̃mgentes	iesse ascendet in salutem populorum ip̃m gentes
deprecabunturEterit	deprecabuntur Et erit
nomẽeius	nomẽ eius
gloriosumũDabitillidominusdeus	gloriosum ũ Dabit illi dominus deus
sedemdauidpr̃iseiusetregnabit	sedem dauid pr̃is eius et regnabit
domoiacobĩet̃num	domo iacob ĩ et̃num
EteritGloriapr̃ir̃Ecce	Et erit Gloria pr̃i r̃ Ecce
radixũañl̃OstendeInl̃ãUeniet	radix ũ añ l̃ Ostende In l̃ ã Ueniet
dominusetnõtardabitetilluminabitdumscelestisprimoq	dominus et nõ tardabit et illuminabit dum scelestis primoq 
christiquadringentesimonatidiequeresecundauicesima	christi quadringentesimo nati dieq  uere secunda uicesima
ianiAntoniusdictussanciicognominefultusIspanusnatuastigiefõte	iani Antonius dictus sancii cognomine fultus Ispanus natu astigie fõte
perunctushunclibrumscripsit	perunctus hunc librum scripsit
iussusanctissimipatrisQui	iussu sanctissimi patris Qui
cunctispanditcelestiaRegnabeatisProhuiusstatu	cunctis pandit celestia Regna beatis Pro huius statu
oretplebschristifidelisQuiuteamsaluetpressuras	oret plebs christi fidelis Qui ut eam saluet pressuras
subitinterrisymout	subit in terris ymo ut
plebischristusabstergat	plebis christus abstergat
peccataPiuspastor	peccata Pius pastor
oretqui	oret qui
estdignusuitabeataQui	est dignus uita beata Qui
fec̃hosũsusdeuotusnim᷒ꝓhẽialit̃	fec̃ hos ũsus deuotus nim᷒ ꝓhẽialit̃
dictasinttantaDIcamusautemresumẽtesquoniam	dicta sint tanta DIcamus autem resumẽtes quoniam
omniscogͥtioet	omnis cogͥtio et
electiobonũaliq̃ddesideratquidesthocq̃ddicimus	electio bonũ aliq̃d desiderat quid est hoc q̃d dicimus
Ciuilemdesiderareetquidestomnium	Ciuilem desiderare et quid est omnium
operatorumsũmũbonũNominequidẽig᷑fereapl̃imiscõfessũ	operatorum sũmũ bonũ Nomine quidẽ ig᷑ fere a pl̃imis cõfessũ
estfelicitatem	est felicitatem
enietmultietexcellentesdicũtbeneuiũe	eni  et multi et excellentes dicũt bene uiũe
aut̃etbñ	aut̃ et bñ
oꝑariidemexistimãteiq̃destessefelicemdefelicitate	oꝑari idem existimãt ei q̃d est esse felicem de felicitate
aut̃29De	aut̃ 29 De
qͣlitateuisionisquaĩfuturoscl̃osc̃i	qͣlitate uisionis qua ĩ futuro scl̃o sc̃i
deumuidebunt30Deeterna	deum uidebunt 30 De eterna
felicitateciuitatisdeisabb̃oqꝑpetuo	felicitate ciuitatis dei sabb̃oq  ꝑpetuo
31Deoꝑisꝯsũmatõnecumgr̃aꝝactione	31 De oꝑis ꝯsũmatõne cum gr̃aꝝ actione
Explicittabulalibrideciuitatedeibt̃iAugustiniquescripta	Explicit tabula libri de ciuitate dei bt̃i Augustini que scripta
fuitAnnodñiMͦCCCCͦpͥMarciidie26ͣ	fuit Anno dñi Mͦ CCCCͦ pͥ Marcii die 26ͣ
uigentescismateetppͣbenedc̃o13ͦ	uigente scismate et ppͣ benedc̃o 13ͦ
inpalatio	in palatio
Auinioneñsubclausuraiam	Auinioneñ sub clausura iam
perbienniũdetẽtoꝓ	per bienniũ detẽto ꝓ
thdolorCe	th dolor Ce
escripstGuyllemin	escripst Guyllemin
Cronierpourdesprelatsle	Cronier pour des prelats le
permierEtsebienson	per  mier Et se bien son
nomweulzscavoirPrenleRougeetlaysse	nom weulz scavoir Pren le Rouge et laysse
lenoirOmortaliummiserandaconditioquesemperin	le noir O mortalium miseranda conditio que semper in
arduumlabentiuminanitertendisutlapsu	arduum labentium inaniter tendis ut lapsu
grauioreruasQuerishicfulgentiadunores	grauiore ruas Queris hic fulgentia du nores
eximioslongosq	eximios longosq 
potentatusubinullapotentiapotenseuerushonosnullumconsistens	potentatus ubi nulla potentia potens e uerus honos nullum consistens
dyademasomniacasus	dyadema s  omnia casus
humanetquicquidinaltumfortunatulit	human et quicquid in altum fortuna tulit
ruituraleuatRespiceregesetregnaquonperiainterlaudantium	ruitura leuat Respice reges et regna quon peria inter laudantium
oraatqmirantiumrepentecorruisseutdeturinte	ora atq  mirantium repente corruisse ut detur inte
sectanturnonadidquotendunteuolant	sectantur non ad id quo tendunt euolant
sadymadedecorose	s  ad yma dedecorose
sepissimeiuxtaeuangelicumdictumQuise	sepissime iuxta euangelicum dictum Qui se
exaltathumiliabitur	exaltat humiliabitur
lucexiiiiQuisꝗsmes	luce xiiii Quisꝗs mes
uirtutumesseconcupiscitstabilifixoqgradu	uirtutum esse concupiscit stabili fixoq  gradu
manereinterradiant	manere inter radiant
chorosfelicitercollocarinormamuirtutumuthic	choros feliciter collocari normam uirtutum ut hic
duxnosterfecitdiscat	dux noster fecit discat
uniutinquitTulliusinphilippicisOmniaaliaincertasunt	uni ut inquit Tullius in philippicis Omnia alia incerta sunt
caducaetmobiliaestunaaltissimisinfixaradicibus	caduca et mobilia est una altissimis infixa radicibus
quenullauilabefactaripotest	que nulla ui labefactari potest
necdimoQuicũq	nec dimo Quicũq 
gͦuirtutisuestigiasequeturut	gͦ uirtutis uestigia sequetur ut
hicduxinclitusmeritosibidicetur	hic dux inclitus merito sibi dicetur
quprincipio	qu principio
diximusposuiteumducemuirtutumuniuersarum	diximus posuit eum ducem uirtutum uniuersarum
q̃dfuit	q̃d fuit
thcuiusdeclaratione	th cuius declaratione
potesttalisratioformariQuisꝗscomposite	potest talis ratio formari Quisꝗs composite
mentisinpresentis	mentis in presentis
eterniducissignasequituranimose	eterni ducis signa sequitur animose
illumdeus	illum deus
ponitducemuiruersarum	ponit ducem uir uersarum
sduxnosterinclitusmente	s  dux noster inclitus mente
celodedituseterniducissignamucutus	celo deditus eterni ducis signa mu cutus
ergoillumdeusposuitducemuirtutumuniuersarumPrimapars	ergo illum deus posuit ducem uirtutum uniuersarum Prima pars
anpatetperilludapostolisecundethesalõicensespͥmoNon	an patet per illud apostoli secunde thesalõicenses pͥmo Non
enimdeditnobisdeustimorissed	enim dedit nobis deus timoris sed
uirtutisEteccͥxluirtutesexaltantcor.	uirtutis Et eccͥ xl uirtutes exaltant cor .
Ethecpaucadeprimapdetissecũdaparsantecedẽtis	Et hec pauca de prima p detis secũda pars antecedẽtis
queests	que est s
duxnosterĩclitus⁊c̃patetperilld̃io	 dux noster ĩclitus ⁊ c̃ patet per illd̃ io
INpͥncipioẽatũbũetũbũ	IN pͥncipio ẽat ũbũ et ũbũ
ẽataputd̃mdeusẽatũbũhocẽat	ẽat aput d̃m  deus ẽat ũbũ hoc ẽat
inpͥncipioaput	in pͥncipio aput
d̃mOm̃iaꝑip̃mfc̃a	d̃m Om̃ia ꝑ ip̃m fc̃a
s̃tsine	s̃t  sine
ipofc̃m÷nichilQͦtfc̃m÷	ipo fc̃m ÷ nichil Qͦt fc̃m ÷
inipouitaẽatEtuita	in ipo uita ẽat Et uita
ẽatluxhoĩm	ẽat lux hoĩm
Etluxin	Et lux in
tenebͥslucettenebre	tenebͥs lucet  tenebre
eãnonꝯ	eã non ꝯ
henderũt	 henderũt
fuithomomissusa	fuit homo missus a
deocuinomẽẽatiohãnesHicuenitĩtestimõiͫut	deo cui nomẽ ẽat iohãnes Hic uenit ĩ testimõiͫ ut
testimõͫꝑhib̃etdelumĩeutom̃escred̃ent	testimõͫ ꝑhib̃et de lumĩe ut om̃es cred̃ent
ꝑillũNonẽatilleluxs	ꝑ illũ Non ẽat ille lux s 
uttestimomꝑhib̃et	ut testimom ꝑhib̃et
delumĩe	de lumĩe
Ẽatlux	Ẽat lux
ũaq̃illuĩatom̃emhomĩem	ũa q̃ illuĩat om̃em homĩem
uenientẽinhũcmũdumInmundoillumsed	uenientẽ in hũc mũdum In mundo illum sed
seasidioneprocreatumVerumpostꝙͣ	se asidione procreatum Verum postꝙͣ
asillanauiolenciacesarianaequitas	a sillana uiolencia cesariana equitas
reduxitgubernaculaRomaniImperiiiustioreprincipeoptinenteinpubca	reduxit gubernacula Romani Imperii iustiore principe optinente in pubca
custodiasp̃umposuitEodempreside	custodia sp̃um posuit Eodem preside
R.pubce	R . pubce
inconsiml̃imendaciomuliebristemẽitasrepressaestSiquidemcumse	in consiml̃i mendacio muliebris temẽitas repressa est Siquidem cum se
prorubriaquedam	pro rubria quedam
perindeacfalsocreditaessincendio	perinde ac falso credita ess  incendio
perpetinichiladseꝑtinentib	perpeti nichil ad se ꝑtinentib 
bonisinser̃etneq	bonis inser̃et neq 
eiautsplendiditestesautcohortisAugustifauor	ei aut splendidi testes aut cohortis Augusti fauor
deesspropterinexpungnabl̃emCesarisconstanciamirritapropoĩtinefarii	deess  propter inexpungnabl̃em Cesaris constanciam irrita propoĩti nefarii
abiitIdembarbarumquendamproptereximiamsil̃itudinemCapadocie	abiit Idem barbarum quendam propter eximiam sil̃itudinem Capadocie
Regnumaffectantemtamꝙͣ	Regnum affectantem tamꝙͣ
AriathesessquemaM.	Ariathes ess  quem a M .
Antoniointeremptum	Antonio interemptum
luceclariuseratꝙͣꝙͣpenetociusorientisCiuitatium	luce clarius erat ꝙͣꝙͣ pene tocius orientis Ciuitatium
etgentiumcredulasuffragacõnefultumcaputdementerImpẽioinminensiusto	et gentium credula suffragacõne fultum caput dementer Impẽio inminens iusto
Impendisupplicio	Impendi supplicio
coegitExplicitUaleriusMaximusAnnomͦccccmoterciocͥca	coegit Explicit Ualerius Maximus Anno mͦ ccccmo tercio cͥca
festũassupͦͥᷤMariaFilimandatadataquesuntcongrualaudi	festũ assupͦͥᷤ Maria Fili mandata data que sunt congrua laudi
IncipitspeculũsacerdotũcclesiesancteRegimẽ	Incipit speculũ sacerdotũ cclesie sancte Regimẽ
quiduc̃esancte	qui duc̃e sancte
uishecmetralegede	uis hec metra lege de
sc̃aꝯditalegeQue	sc̃a ꝯdita lege Que
siꝑleg̃ebñuis⁊corde	si ꝑleg̃e bñ uis ⁊ corde
tenereactiꝯplerepot̃isbona	tenere acti ꝯplere pot̃is bona
semꝑhaberehocspeculũclarũcurãmõstransaĩarũCondotibi	semꝑ habere hoc speculũ clarũ curã mõstrans aĩarũ Condo tibi
carũplusꝙͣsitgẽmauelaurũ	carũ plusꝙͣ sit gẽma uel aurũ
Quopossisaĩassacͣmẽt̃redderemũdasCrimina	Quo possis aĩas sacͣmẽt̃ reddere mũdas Crimina
uitareuirtutesmultiplicareutbñuiuẽdosubiectissanctadocendoTandem	uitare uirtutes multiplicare ut bñ uiuẽdo subiectis sancta docendo Tandem
leterisincelis⁊speculerisadducẽdogregẽsũmũ	leteris in celis ⁊ speculeris adducẽdo gregẽ sũmũ
ꝑsecularegẽhocꝯcedente	ꝑ secula regẽ hoc ꝯcedente
dñobñcũctaregenteprimotñdñmrogotrinũ	dño bñ cũcta regente primo tñ dñm rogo trinũ
sẽꝑ⁊unũ	sẽꝑ ⁊ unũ
aquocũctabonamanãtutdetmichidona	a quo cũcta bona manãt ut det michi dona
Cũquibhocspeculũ	Cũ quib  hoc speculũ
ualeãꝯplerenouellũ	ualeã ꝯplere nouellũ
utilemũdanisaĩabusedificandis	utile mũdanis aĩabus edificandis
demodo⁊	de modo ⁊
formahui᷒libriDetitulopandã	forma hui᷒ libri De titulo pandã
tibiprimoꝯmodaquedãutẜues	tibi primo ꝯmoda quedã ut ẜues
uitãposthecdicetur	uitã post hec dicetur
honestamQuedebesscirefaciãpostistasubirehincꝙ	honestam Que debes scire faciã post ista subire hinc ꝙ
ineccl̃aresidenciasitfaciendaQue	in eccl̃a residencia sit facienda Que
sũtofficiatibisubiũgãfugienda	sũt officia tibi subiũgã fugienda
posthecofficiatibidebitaiũgonouenaScilic	post hec officia tibi debita iũgo nouena Scilic 
insacra	in sacra
dignetractes	digne tractes
sac̃mentautmissascelebresdeuoteposteacernesposteamonstratur	sac̃menta ut missas celebres deuote post ea cernes postea monstratur
quidquomodoꝯfiteaturQuomododoctrinã	quid quomodo ꝯfiteatur Quomodo doctrinã
tradastransportatieẽnt⁊easuplem̃toadductoquoãpli᷒duab	tradas transportati eẽnt ⁊ ea suplem̃to adducto quo ãpli᷒ duab
.legionib.ꝙͣx	. legionib . ꝙͣ x
milia⁊quadringẽtipeditessexcenti	milia ⁊ quadringẽti pedites sexcenti
eꝗteseẽnt⁊sociũlat̃inoĩisduodecĩmiliasexcẽti	eꝗtes eẽnt ⁊ sociũ lat̃i noĩis duodecĩ milia sexcẽti
eꝗtesquoꝝ	eꝗtes quoꝝ
fortioꝑaadũsusceltiberosliisususꝗnt᷒fului᷒eẽt	forti oꝑa adũsus celtiberos  liis usus ꝗnt᷒ fului᷒ eẽt
quossiuideret᷑secũdeportaret⁊suplicatõesdec̃teꝙis	quos si uideret᷑ secũ deportaret ⁊ suplicatões dec̃te ꝙ is
ꝓspererempublicãgesisset⁊	ꝓspere rem publicã gesisset ⁊
cet̃itoresĩꝓuĩciasꝗntofabio	cet̃i  tores ĩ ꝓuĩcias ꝗnto fabio
butroniꝓrogatũingalliãimꝑiũ	butroni ꝓrogatũ in galliã imꝑiũ
ẽoctolegiones	ẽ octo legiones
terex̃citũuet̃emꝗĩligurib.	 ter ex̃citũ uet̃em ꝗ ĩ ligurib .
ĩspeꝓpinquamissiõis	ĩ spe ꝓpinqua missiõis
erãteoãnoeẽplacuit⁊isipe	erãt eo ãno eẽ placuit ⁊ is ipe
ex̃cit᷒egreexplebat᷑	ex̃cit᷒ egre explebat᷑
ꝑꝑpestilentia	ꝑꝑ pestilentia 
q̃t̃ciũ	q̃ t̃ciũ
iããnuurbẽroͣnaatqitaliãuastabat	iã ãnu  urbẽ roͣna  atq  italiã uastabat
tortit᷒	 tor tit᷒
minuti᷒⁊hautita	minuti᷒ ⁊ haut ita
ml̃top᷒ꝯsulgne᷒calfurni᷒morit᷑ml̃tiq	ml̃to p᷒ ꝯsul gne᷒ calfurni᷒ morit᷑ ml̃tiq 
aliiõiuordinũillustres	alii õiu  ordinũ illustres
uiripost̃moꝓdigiilocoeacladesh̃riceptagne᷒	uiri post̃mo ꝓdigii loco ea clades h̃ri cepta gne᷒
ẜuili᷒pontifexmaxi᷒piaculairedeũꝯꝗr̃e	ẜuili᷒ pontifex maxi  ᷒ piacula ire deũ ꝯꝗr̃e
iussixuirilibrosinspic̃eꝯsulapol̃iexculapiosalutis	iussi x uiri libros inspic̃e ꝯsul apol̃i exculapio salutis
donauouere⁊daresignaĩaurataq̃uouit	dona uouere ⁊ dare signa ĩaurata q̃ uouit
deditqxuirisuplicationẽĩbiduũualitudinis	deditq  x uiri suplicationẽ ĩ biduũ ualitudinis
c̃a⁊ꝑõiaforaꝯciliabulaqedixerunt	c̃a ⁊ ꝑ õia fora ꝯciliabulaq  edixerunt
NUncitaqquoniamprincipaleserroresnõhabentiũlegẽin	NUnc itaq  quoniam principales errores nõ habentiũ legẽ in
premissahui᷒opusculiꝑte	premissa hui᷒ opusculi ꝑte
satisuidẽtureuersiAdiugulandũerroreslegemhabentiũEritulterius	satis uidẽtur euersi Ad iugulandũ errores legem habentiũ Erit ulterius
insistendũPorroiudeiint̃legẽh̃ntesPrimũ	insistendũ Porro  iudei int̃ legẽ h̃ntes Primũ
sibiarrogantlocũpͥmiĩ	sibi arrogant locũ pͥmi ĩ
hacẜaparteaggrediẽdisuntSciendumigit᷑Q̃diudeis	hac ẜa parte aggrediẽdi sunt Sciendum igit᷑ Q̃d iudeis
scissuradecẽtribuũhoc	scissura decẽ tribuũ hoc
nom̃inposuitAnteaquippehebreiul̃ysraeldicebãturExquo	nom̃ inposuit Antea quippe hebrei ul̃ ysrael dicebãtur Ex quo
autẽinduoregnapopulusillediuisusest	autẽ in duo regna populus ille diuisus est
Quicũqex	Quicũq  ex
eisregeshabuerũt	eis reges habuerũt
destirpeiudeseudetribuiudaIudei	de stirpe iude seu de tribu iuda Iudei
ddictisũt	d dicti sũt
Decemuõtrib.etquicũq	Decem uõ trib . et quicũq 
insamariaIhẽoboam	in samaria Ihẽoboam
regẽsibiconstituerũtIsraelisunt	regẽ sibi constituerũt Israel i sunt
uocatiQuib.yeroboãduosuitulosaureos	uocati Quib . yeroboã duos uitulos aureos
fatiẽsUnũposuit	fatiẽs Unũ posuit
indanetalteꝝ	in dan et alteꝝ
inbethelDixitqeisregnũtelorũSedtamen	in bethel Dixitq  eis regnũ telorũ Sed tamen
dc̃iIudeiexpectauerunt⁊credideruntuenturũsicutpatres	dc̃i Iudei expectauerunt ⁊ crediderunt uenturũ sicut patres
eorũantiquicrediderũt	eorũ antiqui crediderũt
EttñininfernofuerũtEtqui	Et tñ in inferno fuerũt Et qui
siuixissentusqadtempusaduentusꝓphetexp̃i	si uixissent usq  ad tempus aduentus ꝓphete xp̃i
tãtũcredidissentipixp̃m	tãtũ credidissent ipi xp̃m
quãtumetisticrediderũtCũxp̃s	quãtum et isti crediderũt Cũ xp̃s
ꝓph̃ãaggrauaredebebatcordaIudeorũ	ꝓph̃ã aggrauare debebat corda Iudeorũ
eteorũoculosexcecareetauresclaudere	et eorũ oculos excecare et aures claudere
utysa.vi	ut ysa . vi
Etperconsequens	Et per consequens
crederenonpoterantutIo.xiiNonneantiquipr̃es	credere non poterant ut Io . xii Nonne antiqui pr̃es
eorũĩterfecer̃tsanctos	eorũ ĩterfecer̃t sanctos
ꝓph̃asetiãadeomissossicutysayam	ꝓph̃as etiã a deo missos sicut ysayam
etIeremiãetaliosꝙͣpluressed	et Ieremiã et alios ꝙͣ plures sed
tñdicti	tñ dicti
antiquietsanctipatresininfernodãpnatifueruntin	antiqui et sancti patres in inferno dãpnati fuerunt in
sanguĩetestam̃tisaluatideinfernoergoet	sanguĩe testam̃ti saluati de inferno ergo et
istiDicitemichioIusticiaquidhabuit	isti Dicite michi o Iusticia quid habuit
significaredelaterexp̃iiudicisnostri	significare de latere xp̃i iudicis nostri
sanguĩemetclarãaquamemanasseAitIusticianescioAitmisericordia	sanguĩem et clarã aquam emanasse Ait Iusticia nescio Ait misericordia
PostꝙͣnescistedoceboEtaitipasãguĩeille	Postꝙͣ nescis te docebo Et ait ipa sãguĩe ille
fuitsanguisfederisde	fuit sanguis federis de
quosupͣdc̃mestInquosanguĩe	quo supͣdc̃m est In quo san guĩe
om̃escircũcisosnonpreuaricatoreslegisetadeoetlegis	om̃es circũcisos non preuaricatores legis et adeo et legis
nonfornicatoreseduceredebebatdeinferno	non fornicatores educere debebat de inferno
Aquailla	Aqua illa
fuitfederisgentiũpopuliInquaaquaipe	fuit federis gentiũ populi In qua aqua ipe
dc̃asgentesinppl̃metregnumdebebathereditareutysaye	dc̃as gentes in ppl̃m et regnum debebat hereditare ut ysaye
liiSicingloriosuseritinteruirosaspectus	lii Sic ingloriosus erit inter uiros aspectus
etformaeiusinterfilioshoĩmipeasꝑgetgentes	et forma eius inter filios hoĩm ipe asꝑget gentes
multassuꝑip̃mcõtinebunt᷑regesossuũ	multas suꝑ ip̃m cõtinebunt᷑ reges os suũ
quiaquib᷒non	quia quib᷒ non
estnarratũnondeeouidebunt	est narratũ non de eo uidebunt
etquinonaudieruntcontemplatisuntetetiãipe	et qui non audierunt contemplati sunt et etiã ipe
xp̃squidebuitexpͥmicũsemperinteristos	xp̃s qui debuit expͥmi cũ semper inter istos
duospopulosfũitdistinctioutgẽxxvet	duos populos fũit distinctio ut gẽ xxv et
esterxdequibussanguĩeetaquahabeturfiguraleui	ester x de quibus sanguĩe et aqua habetur figura leui
xiiiicinfineubi	xiiii c in fine ubi
sacerdoslegisinsanguĩe	sacerdos legis in sanguĩe
etaquisuiuentibaspergebatleprosũet	et aquis uiuentib  aspergebat leprosũ et
mũdabaturItaxp̃elegissacerdos	mũdabatur Ita xp̃e legis sacerdos
aspergensde	aspergens de
suolateresanguĩem⁊aquãuiuam	suo latere sanguĩem ⁊ aquã uiuam
mũdũleꝓsũinpc̃tismũdauit	mũdũ leꝓsũ in pc̃tis mũdauit
⁊mũdabitAs	⁊ mũdabit As
illusquosdicis	illus quos dicis
detribussceleribusetdequarto⁊c̃TuIusticia	de tribus sceleribus et de quarto ⁊ c̃ Tu Iusticia
debesscireteOratiosanctiambrosii	debes scire te Oratio sancti ambrosii
quedebetdiciante	que debet dici ante
missamSummesacerdosetuerepontifexquite	missam Summe sacerdos et uere pontifex qui te
obtulistideo	obtulisti deo
patrihostiampurametimmaculataminaracrucis	patri hostiam puram et immaculatam in ara crucis
pronobismiserispcc̃oribusquiq	pro nobis miseris pcc̃oribus quiq 
dedistinobiscarnemtuamadmanducandumetsanguinemtuũ	dedisti nobis carnem tuam ad manducandum et sanguinem tuũ
adbibendumetposuisti	ad bibendum et posuisti
misteriumistudinuirtutespiritus	misterium istud in uirtute spiritus
sãctidicens	sãcti dicens
hecquocienscũqfeceritisinmeimemoriam	hec quocienscũq  feceritis in mei memoriam
faNecletheosseuaperamnesUosfata	fa Nec letheos seua per amnes Uos fata
trahentsedcũsũmasExigethorasconsumptadies	trahent sed cũ sũmas Exiget horas consumpta dies
Iteradsuperos	Iter ad superos
gl̃iapandetSedtu	gl̃ia pandet Sed tu
domitormagneferaꝝOrbisqsiml̃	domitor magne feraꝝ Orbisq  siml̃
pacatorades	pacator ades
Nũcquoqnr̃asrespiceterrasEtsiquanoua	Nũc quoq  nr̃as respice terras Et si qua noua
beluauultuQuatietppl̃osterroregrauiTufulminib.frange	belua uultu Quatiet ppl̃os terrore graui Tu fulminib . frange
trisulcisFortiusipo	trisulcis Fortius ipo
genitoretuoFulminamittesExpliciunt	genitore tuo Fulmina mittes Expliciunt
TragedieSeneceDeoGraciasAmen	Tragedie Senece Deo Gracias Amen
Scripteacconpleteper	Scripte ac conplete per
manusIohãnisTenNordedeDoetinchemClericiTraiecteñdyoc̃Sub	manus Iohãnis Ten Norde de Doetinchem Clerici Traiecteñ dyoc̃ Sub
AnnodñiMͦccccͦviiiiDiedecimanonaMensis	Anno dñi Mͦ ccccͦ viiii Die decimanona Mensis
IanuariiEpitaphiuSenece	Ianuarii Epitaphiu  Senece
Curalabormeritusũptiꝓmunere	Cura labor meritu  sũpti ꝓ munere
honoresIte	honores Ite
aliasposthanc	alias post hanc
solicitateanimas	solicitate animas
Meproculauob̃deuseuocatilicet	Me procul a uob̃ deus euocat ilicet
actisRebusterrenishospitaterraualeCorpusauara	actis Rebus terrenis hospita terra uale Corpus auara
tñsolẽpnib.accipesaxisNamq	tñ solẽpnib . accipe saxis Namq
aĩamceloreddim᷒ossatibiExpliciuntuocabulaugucionisincipientia	 aĩam celo reddim᷒ ossa tibi Expliciunt uocabula ugucionis incipientia
aZXplicitExpositio	a Z Xplicit Expositio
uocabulorumexsententia	uocabulorum ex sententia
ugutionisꝯpilacioneIacobiꝯdamMag̃riIsaacphisicide	ugutionis ꝯpilacione Iacobi ꝯdam Mag̃ri Isaac phisici de
paduacompleta	padua completa
clugieAnno	clugie Anno
xp̃iMcccxxiiide	xp̃i Mcccxxiii de
ms̃nouembris	ms̃ nouembris
Etscriptaꝑme	Et scripta ꝑ me
Iohannemꝯdam	Iohannem ꝯdam
d̃Siluestrideluxaueneciaruoriginariu	d̃ Siluestri de luxa ueneciaru  originariu
⁊teruisiiciuempublicumImperiali	⁊ teruisii ciuem publicum Imperiali
Auct̃enotarium⁊tũcCancelarium	Auct̃e notarium ⁊ tũc Cancelarium
Magnifici⁊potentisdñidñiNicolaiMudatiopro	Magnifici ⁊ potentis dñi dñi Nicolai Mudatio pro
ẜenisimo⁊excellentissimoducalidñioveneciaꝝtociusInsulecretehonorabilis	ẜenisimo ⁊ excellentissimo ducali dñio veneciaꝝ tocius Insule crete honorabilis
capitañgeneralis⁊CompletaInciuitatecandideAnnonatiuitatisdñi	capitañ generalis ⁊ Completa In ciuitate candide Anno natiuitatis dñi
nr̃iih̃uxp̃iMccccxiiIndic̃quĩta	nr̃i ih̃u xp̃i Mccccxii Indic̃ quĩta
dieSabatixviimensisdecembrisciosa	die Sabati xvii mensis decembris ciosa
qualiasunt	qualia sunt
õiasignamortẽꝓnosticiaQueuõinparteauferũt	õia signa mortẽ ꝓnosticia Que uõ in parte auferũt
uelauferrisignificant	uel auferri significant
utsigna	ut signa 
nũciãtiatorturãuelꝑalisimaut	nũciãtia torturã uel ꝑalisim aut
appoͣ̃uelcardiacã	appoͣ̃ uel cardiacã
aͭsil̃iapessimaquidẽsuntsmĩorismalicie	aͭ sil̃ia pessima quidẽ sunt s  mĩoris malicie
ꝙͣillaquecisemortẽꝓnosticãtDeqͥb	ꝙͣ illa que  cise mortẽ ꝓnosticãt De qͥb 
om̃ibspãlr̃ꝑtractãenõ	om̃ib  spãlr̃ ꝑtractãe nõ
spectatintͦduconumpñtiũformesiuetenori	spectat intͦduconum pñtiũ forme siue tenori
spredc̃isꝯtentigr̃as	s  predc̃is ꝯtenti gr̃as
r̃ferimdñoih̃uxp̃oqͥꝯsid̃acõesintͦductoriaspͥme	r̃ferim  dño ih̃u xp̃o qͥ ꝯsid̃acões intͦductorias pͥme
partismenequetheoricadr̃dadimpleuitEtquiiãin	partis mene que theorica dr̃d adimpleuit Et qui iã in
r̃giͭͦsanitatisnr̃o	r̃giͭͦ sanitatis nr̃o
⁊affomisdeIngeniosanitatish̃undanterinchoauit	⁊ affomis de Ingenio sanitatis h̃undanter inchoauit
consid̃acõespraticenecc̃as⁊sꝑamcũdeuocõeꝙipe	consid̃acões pratice necc̃as ⁊ sꝑam  cũ deuocõe ꝙ ipe
ꝑficietinꝯto	ꝑficiet in ꝯto
dc̃oꝝaffoꝝ⁊inaliisaffomis	dc̃oꝝ affoꝝ ⁊ in aliis affomis
ꝑticuterexpͥmentibquepermedicũsapientem	ꝑticuter expͥmentib  que per medicũ sapientem
consid̃andasuntinmorbis	consid̃anda sunt in morbis
quoꝝdãm̃brorumꝑticuriuminquibuelutinexemplo	quoꝝdã m̃brorum ꝑticurium in quib  uelut in exemplo
siuespeculoclarouiarc̃ꝓcessus	siue speculo claro uia rc̃ ꝓcessus
incetẽisaꝑtissime	in cetẽis aꝑtissime
cognoscaͬa	cognoscaͬ a
cũctisamatõibusũitatis	cũctis amatõibus ũitatis
ducentumparuulosad	ducentum paruulos ad
uiamqueducitad	uiam que ducit ad
xp̃mQuiconuertifeceritpeccatoremaberroreuie	xp̃m Qui conuerti fecerit peccatorem ab errore uie
suesaluabitaĩameiusamorteetoperitmultitudinem	sue saluabit aĩam eius a morte et operit multitudinem
peccatorumExhocuerbo	peccatorum Ex hoc uerbo
traherepotuitgregoriusnullumessedeoaccepciussacrificiumꝙͣ	trahere potuit gregorius nullum esse deo accepcius sacrificium ꝙͣ
zelumanimarumꝙsitanta	zelum animarum ꝙ si tanta
sollicitudinisinquietudinesitotuigiliisetcuriis	sollicitudinis inquietudine si tot uigiliis et curiis
ĩmortalibuspermedia	ĩmortalibus per media
uitepericulaquerunthominessaluateresuanasiam	uite pericula querunt homines saluate res uanas iam
iamperituras	iam perituras
sicolligeresataguntuilesterrenarũopum	si colligere satagunt uiles terrenarũ opum
sarcinulasquas	sarcinulas quas
apostolusarbitrabaturut	apostolus arbitrabatur ut
stercoraEtdumhecaguntlaudantur	stercora Et dum hec agunt laudantur
utindustriiutdiligẽtesutofficiosietutilesrei	ut industrii ut diligẽtes ut officiosi et utiles rei
publiceUideteoroquantaestuelinherciauelinfidelitasde	publice Uidete oro quanta est uel inhercia uel infidelitas de
animarumĩmortaliumsalutenoncurare	animarum ĩmortalium salute non curare
xp̃ianosymoqualisillaestimpudentissimaperuersitaseosinculpare	xp̃ianos ymo qualis illa est impudentissima peruersitas eos inculpare
Dñsqnunc	Dñs q  nunc
apertisnuncoccultisprepedirequiducereparuulossatagũtaiat	apertis nuncoccultis prepedire qui ducere paruulos satagũt aiat
ArdisTanta	Ardis Tanta
ardebatcurautarchitectopermiserituelutsuãpecuniam	ardebat cura ut architecto permiserit uel ut suã pecuniam
consumeretdũmodo	consumeret dũmodo
perduceretspecusepistrinisinmareabiectamolequaestus	perduceret specus epistrinis in mare abiecta mole qua estus
bisquotidieabexorͭaluna	bis quotidie ab exorͭa luna
adproximũnouãintroireacredire	ad proximũ nouã introire ac redire
rursusinmarepossetacrefrigerarepiscinasNos	rursus in mare posset ac refrigerare piscinas Nos
cumhęc&eccestrepitusdestraatq	cum hęc & ecce strepitus destra atq
.leuacandidatusnosterdesignatusĘdilisadest	. leua candidatus noster designatus Ędilis adest
aduillãCuinosoccidimus&	ad uillã Cui nos occidimus &
gratulatiĩ	gratulati ĩ
CapitoliũpersequimurIlloindecunctosuãdomũnos	Capitoliũ persequimur Illo inde cuncto suã domũ nos
nostrãOppinioninostrosermonedepastioneuillaticasumatim	nostrã Oppinioni nostro sermone de pastione uillatica sumatim
hocquẽ	hoc quẽ
exposuihabitoM	exposui habito M
TerrenciiUarronisrerũ	Terrencii Uarronis rerũ
rusticarumdeuillaticispastionibuslibertercius	rusticarum de uillaticis pastionibus liber tercius
explicitfeliciter	explicit feliciter
1414MTCEPISTOLARŨADATTICŨL	1414 M T C EPISTOLARŨ AD ATTICŨ L
XIIIINCIPITFELICITERCICEROatticosal.Adciceronem	XIII INCIPIT FELICITER CICERO attico sal . Ad ciceronem
itascripsistiutneqseueriusneqtemperatius	ita scripsisti ut neq  seuerius neq  temperatius
scribipotueritnecmagisꝙͣ	scribi potuerit nec magis ꝙͣ
quẽado	quẽad o
modũegomaximeuellemprudentissimeet̃ad	modũ ego maxime uellem prudentissime et̃ ad
tulliosquareautistaproficientautaliudagamusDe	tullios quare aut ista proficient aut aliud agamus De
pecuniauͦuideoate	pecunia uͦ uideo a te
omnẽdiligentiamadhiberi	omnẽ diligentiam adhiberi
uelpotiusiamadhibitãesse	uel potius iam adhibitã esse
efficisatehortoshabeonecuͦullumgenus	efficis a te hortos habeo nec uͦ ullum genus
possessionisestquodmalimmaximescilicetobeamcausam	possessionis est quod malim maxime scilicet ob eam causam
quaesusceptaest	quae suscepta est
cuiusfestinationemihitollis	cuius festinatione mihi tollis
qm̃deestatepollicerisuelpotiusrecipisdeindeet̃	qm̃ de estate polliceris uel potius recipis deinde et̃
adκαταβίuitã	ad καταβί uitã
MarciTullii	Marci Tullii
CiceroniscontraCatilinamOracionesiiiiorQuousq	Ciceronis contra Catilinam Oraciones iiiior Quo usq
tandemabut̃e	 tandem abut̃e
catilinapac̃ianr̃a	catilina pac̃ia nr̃a
QuãdiufuroristetuusnoseludetQuẽ	Quãdiu furor iste tuus nos eludet Quẽ
adfinemeffrenataseseiactabitaudaciaNichilnenocturnũpresidiũ	ad finem effrenata sese iactabit audacia Nichil ne nocturnũ presidiũ
palaciinichilurbisvigilienichiltimoresppl̃inichil	palacii nichil urbis vigilie nichil timores ppl̃i nichil
concursusbonoꝝoĩmnichilhicmunitissim᷒habendisenatus	concursus bonoꝝ oĩm nichil hic munitissim᷒ habendi senatus
loc᷒nich̃hoꝝorauultusq	loc᷒ nich̃ hoꝝ ora uultusq 
mouerũtPateretuaconsilianonsentis	mouerũt Patere tua consilia non sentis
Constrictãiam	Constrictã iam
hoꝝomniũscienciatenericoniuracionẽ	hoꝝ omniũ sciencia teneri coniuracionẽ
tuãnõuidesQͥdꝓxima	tuã nõ uides Qͥd ꝓxima
quidsuperiorinocteegerisubifuerisquidconsiliiceperis	quid superiori nocte egeris ubi fueris quid consilii ceperis
quoscõuocauerisquẽnr̃mignorarearbitraris	quos cõuocaueris quẽ nr̃m ignorare arbitraris
Otp̃rao	O tp̃ra o
moressenat᷒hocintelligit	mores senat᷒ hoc intelligit
consuluidethic	consul uidet hic
tamenuiuituiuitImmoueroin	tamen uiuit uiuit Immo uero in
senatũuenitfitpublicicõsiliiparticeps	senatũ uenit fit publici cõsilii particeps
Notat⁊designat	Notat ⁊ designat
oculisadcedẽunũqͤnqnr̃mNosautẽfortesuiri	oculis ad cedẽ unũqͤnq  nr̃m Nos autẽ fortes uiri
satisfac̃ereipubliceuidem᷑	satisfac̃e rei publice uidem᷑
siistiustelaacfuroremuitem᷒Admortemtecatilina	si istius tela ac furorem uitem᷒ Ad mortem te catilina
duciiussuconsulisiãpͥdemoportebatIntecõferri	duci iussu consulis iã pͥdem oportebat In te cõferri
pestemistamꝙͣ	pestem istam ꝙͣ
tuĩnosom̃siãmachinarisAnuero	tu ĩ nos om̃s iã machinaris An uero
uiramplissim᷒pscipiopõtifexmaxim᷒tiberinũgracchũ	uir amplissim᷒ p scipio põtifex maxim᷒ tiberinũ gracchũ
mediocriterlabefactãtestatũr	mediocriter labefactãte statũ r
.paepͥuatusinterfecitCatilinaueroorbemterrecedeatq	. pae pͥuatus interfecit Catilina uero orbem terre cede atq
incendiͦuastarecupientẽnosꝯsulesperferem᷒	 incendiͦ uastare cupientẽ nos ꝯsules perferem᷒
Namillanimisantiqͣpret̃eo	Nam illa nimis antiqͣ pret̃eo
q̃dqsercaderetUoluit	q̃dq  ser caderet Uoluit
enĩinexcelsumleuari	enĩ in excelsum leuari
adconiũut	ad co niũ ut
ruenteillũdeexcelsooculiom̃iũꝑuigitur	ruente illũ de excelso oculi om̃iũ ꝑui gitur
estiniquitas	est iniquitas
elatõnisut	elatõnis ut
inaltũselimeseerigatSedsc̃aoratio	in altũ se lime se erigat Sed sc̃a oratio
omnẽhumiamuniũsamdeicit	omnẽ humi am uniũsam deicit
uanitatẽItemsermoBEatoꝝ	uanitatẽ Item sermo BEatoꝝ
martyrũclaragestaetsmina	martyrũ  clara gesta et s mina
fideliumincitam̃tasunte	fidelium incitam̃ta sunt e
Armanturenĩfilioꝝanimidũpturtriumphi	Armantur enĩ filioꝝ animi dũ p tur triumphi
Clamatutiqxp̃ianoꝝcorpioꝝ	Clamat utiq  xp̃ianoꝝ cor pioꝝ
sanguissp̃ualiũbellatoꝝqͣntũamartria	sanguis sp̃ualiũ bellatoꝝ qͣntũ amar tria
hecMaioraũhisestcaritasxiiiiSectaminicaritatẽEmulamini	hec Maior aũ his est caritas xiiii Sectamini caritatẽ Emulamini
sp̃ualiamagis	sp̃ualia magis
autẽutꝓph̃etisQͥenĩloquitur	autẽ ut ꝓph̃etis Qͥ enĩ loquitur
linguanõhõibloquit᷑seddeoNemoenĩaudit	lingua nõ hõib  loquit᷑ sed deo Nemo enĩ audit
Sp̃saũloquiturmyst̃iaNãquiꝓph̃athõibloquitur	Sp̃s aũ loquitur myst̃ia Nã qui ꝓph̃at hõib  loquitur
adedificatõemetexhortatõemetconsolationẽQͥloquitur	ad edificatõem et exhortatõem et consolationẽ Qͥ loquitur
linguasemet	lingua semet
ip̃medificatQͥautemꝓph̃ateccl̃amdeiedificat	ip̃m edificat Qͥ autem ꝓph̃at eccl̃am dei edificat
Uoloaũuosom̃sloquilinguismagisaũ	Uolo aũ uos om̃s loqui linguis magis aũ
proph̃areNammaiorestquiproph̃atquãquiloquiturlingua	proph̃are Nam maior est qui proph̃at quã qui loquitur lingua
nisiforteinterteturuteccl̃aedificatõemaccipatNunc	nisi forte inter  tetur ut eccl̃a edificatõem accipat Nunc
aũfr̃essiueñoaduoslinguisloquensquiduoꝓdero	aũ fr̃es si ueño ad uos linguis loquens quid uoꝓdero
nisiuobisloquarautinreuelatõeautin	nisi uobis loquar aut in reuelatõe aut in
scĩaaumenet	scĩa au men et
illesũĩuẽit	illesũ ĩuẽit
Gestaãthuisc̃iiulianiadintegrũhabere	Gesta ãt hui  sc̃i iuliani ad integrũ habere
neqͥuimadmanũSC̃ebrigideuirg̃iskl̃isfebroariiex	neqͥuim  ad manũ SC̃e brigide uirg̃is kl̃is febroarii ex
gestiseiusBEatabrigidaortafuitĩscociadebona	gestis eius BEata brigida orta fuit ĩ scocia de bona
ꝓsapiaex	ꝓsapia ex
patredubtochomatrebrocaꝓgehec	patre dubtocho  matre broca ꝓgehec
asuapuericiabonaꝝrerumstudiisinoleuitpudicicie	a sua puericia bonaꝝ rerum studiis inoleuit pudicicie
acsobrietatiintentasemꝑdebonisadmelioracrescebat	ac sobrietati intenta semꝑ de bonis ad meliora crescebat
etabipapuellarietateuirtutũ	et ab ipa puellari etate uirtutũ
signisextititadmirandaCũenĩa	signis extitit admiranda Cũ enĩ a
matresua	matre sua
trãsmissaeẽtutdeuaccaꝝlactebutirumcõgregaretet	trãsmissa eẽt ut de uaccaꝝ lacte butirum cõgregaret et
adpondusredderetsicutaliepuelleĩillisregionib	ad pondus redderet sicut alie puelle ĩ illis regionib
fac̃esolebãt	 fac̃e solebãt
heciamtũcuirgohospitalismagisuolẽs	hec iam tũc uirgo hospitalis magis uolẽs
obediredeoꝙͣhõibpauꝑib	obedire deo ꝙͣ hõib  pauꝑib 
hospitib᷒tamlacꝙͣbutirumlargit᷑	hospitib᷒ tam lac ꝙͣ butirum largit᷑
distribuerecepitEtcumtp̃s	distribuere cepit Et cum tp̃s
aduenissetutom̃sredderentfructumuaccaꝝcooꝑatriceseiusmonstrauerunt	aduenisset ut om̃s redderent fructum uaccaꝝ cooꝑatrices eius monstrauerunt
oꝑasuacõpletaUentum	oꝑa sua cõpleta Uentum
estadbrigidam	est ad brigidam
utredderetopussuũ	ut redderet opus suũ
Quenonhabensquidredderettotũpauꝑib᷒erogauerat	Que non habens quid redderet  totũ pauꝑib᷒ erogauerat
timorematrispauidatotamsecõINnomine	timore matris pauida totam se cõ IN nomine
dominiamenPateatuniuersissensinstrumẽtumpublicuminspecturis	domini amen Pateat uniuersis  sens instrumẽtum publicum inspecturis
q̃danno	q̃d anno
dñimillesimotrecentesimotͥcesimoseptimodie	dñi millesimo trecentesimo tͥcesimo septimo die
uicesimasextamensisIuniiindictõnequinta	uicesima sexta mensis Iunii indictõne quinta
Pontificat᷒sanctissimiinxp̃o	Pontificat᷒ sanctissimi in xp̃o
pr̃isacdñinr̃idñibñdictisacͦsancteRomane	pr̃is ac dñi nr̃i dñi bñdicti sacͦsancte Romane
acuniuersaliseccesũmipontificisxiiannot̃cioapd̃	ac uniuersalis ecce sũmi pontificis xii anno t̃cio apd̃
monasteriumsanctipetͥ	monasterium sancti petͥ
decult᷑acenom̃ordinissanctibñdicticapituloꝓuincialiAllatummonast̃ioꝝ	de cult᷑a cenom̃ ordinis sancti bñdicti capitulo ꝓuinciali Allatum monast̃ioꝝ
monachoꝝnigroꝝꝓuincierothomageñetturoneñauct̃e	monachoꝝ nigroꝝ ꝓuincie rothomageñ et turoneñ auct̃e
apl̃icacongregatofuitin	apl̃ica congregato fuit in
meiinfrascriptipublicinotariiettestium	mei infrascripti publici notarii et testium
subscriptoꝝsenciaexꝑteueñabiliumpatrum	subscriptoꝝ  sencia ex ꝑte ueñabilium patrum
dñoꝝd̃igr̃amaiorismoͣst̃iituroñet	dñoꝝ d̃i gr̃a maioris moͣst̃ii turoñ et
sanctiflorenciidesalmuroaudegaueñ	sancti florencii de salmuro audegaueñ
dioc̃adidꝑsedemapl̃icamspecialr̃deputatoꝝabAgnelli	dioc̃ ad id ꝑ sedem apl̃icam specialr̃ deputatoꝝ ab Agnelli
debentimmolariquiaagnusfuturusẽ	debent immolari quia agnus futurus ẽ
crucifigiquitollitpcc̃amundiSoues	crucifigi qui tollit pcc̃a mundi S  oues
ululãtmr̃esquiaagnosꝑduntsñuocebalantes	ululãt mr̃es quia agnos ꝑdunt sñ uoce balantes
Grandemartiriũ	Grande martiriũ
crudelespectaculũ	crudele spectaculũ
lc̃vͣEximiturmacheranulla	lc̃ vͣ Eximitur machera  nulla
int̃uenͭc̃aSolastridetinuidiacũquinatusẽnulli	int̃uenͭ c̃a Sola stridet inuidia cũ qui natus ẽ nulli
faciatuiolenciãS	faciat uiolenciã S
ouescernimus	 oues cernimus
mr̃esque	mr̃es que
suꝑantagnoslugentesUoxinramaauditaẽ	suꝑant agnos lugentes Uox in rama audita ẽ
ploratusululatusmagnuspignorasunt	ploratus  ululatus magnus pignora sunt
nõcreditased	nõ credita sed
creatanõ	creata nõ
depositasedexpositatestisẽipan᷑aquepugnabatin	deposita sed exposita testis ẽ ipa n᷑a que pugnabat in
mr̃escũtyrãn᷒iactaret	mr̃es cũ tyrãn᷒ iactaret
ĩfãteslc̃vͣMater	ĩfãtes lc̃ vͣ Mater
crinescapitisdissipabatqueornamentũcapitisamͭtebatQuantis	crines capitis dissipabat que ornamentũ capitis amͭtebat Quantis
modisinfantẽuolebatabscondereipeseinfantulus	modis infantẽ uolebat abscondere  ipe se infantulus
publicabatNesciebattac̃e,quiaciamineternu	publicabat Nesciebat tac̃e , quia ciam in eternu
AmenAmenExplicitor̃osc̃i	Amen Amen Explicit or̃o sc̃i
ambrosiiquedicit᷑antemissamOrateprohenrico	ambrosii que dicit᷑ ante missam Orate pro henrico
pauꝑeclerico	pauꝑe clerico
quicõpleuithũclibrumAnnodñiMͦcccͦxlͦ	qui cõpleuit hũc librum Anno dñi Mͦ cccͦ xlͦ
viiiͦIncrastinofesti	viiiͦ In crastino fe sti
bt̃imartinihyemalisProdñoludowicodecanometñeccl̃ie	bt̃i martini hyemalis Pro dño ludowico decano metñ eccl̃ie
rigritaꝝGetuloꝝqpassimuagantiumNelittoraꝗinfecundas̃t	rigritaꝝ Getuloꝝq  passim uagantium Ne littora ꝗ infecunda s̃t
p᷑pura&muriceefficass̃isad	p᷑pura & murice efficass̃is ad
tingendum&ubiqq̃ĩtinxereclarissima	tingendum & ubiq  q̃ ĩtinxere clarissima
Reliqͣestoramauritanięext̃ior&ĩfinẽ	Reliqͣ est ora mauritanię ext̃ior & ĩ finẽ
suifastigãtisseafricęnouissimus	sui fastigãtis se africę nouissimus
angulusiisdemopibussminusdiuesCęt̃umsoloditiõ	angulus iisdem opibus s  minus diues Cęt̃um solo ditiõ
&ad̃oestfertilisutfrugũgñanõcũserant᷑	& ad̃o est fertilis ut frugũ gña nõ cũ serant᷑
modobenignissimeꝓcreetsq̃damꝓfũdat&̃	modo benignissime ꝓcreet s  q̃dam ꝓfũdat & ̃
notahicAntheus	nota hic Antheus
regnassedicit᷑	regnasse dicit᷑
Etsignũq̃dfabulęprorsus	Et signũ q̃d fabulę prorsus
õnditurclaꝝcollismodicusresupinihõisimagĩeiacẽtisilliusut	õnditur claꝝ collis modicus resupini hõis imagĩe iacẽtis illius ut
ĩcolęferũt	ĩcolę ferũt
tumulusUndeuͥaliqͣꝑseruptaestsolentimbres	tumulus Unde uͥ aliqͣ ꝑs erupta est solent imbres
sꝑgi&donec	sꝑgi & donec
effossarepleant᷑euẽiunthoĩumꝑs	effossa repleant᷑ euẽiunt hoĩum ꝑs
siluasfreq̃ntãtminusꝙͣquosm̃odiximusuagiꝑsĩ	siluas freq̃ntãt minus ꝙͣ quos m̃o diximus uagi ꝑs ĩ
urbibusagũtqͣꝝut	urbibus agũt qͣꝝ ut
ĩt̃ꝑuasopulẽtissimęh̃nt᷑procula	ĩt̃ ꝑuas opulẽtissimę h̃nt᷑ procul a
mariGilodanoDulbritaniaꝓpius	mari Gilodano Dulbritania ꝓpius
autemsola&lixiofluminilimoꝓxima	autem sola & lixio flumini limo ꝓxima
Ultraestcolonia&fluuiusGnaEtundeinitiumfecimus	Ultra est colonia & fluuius Gna Et unde initium fecimus
Ampelusiaĩnostrũiamfretum	Ampelusia ĩ nostrũ iam fretum
uergensꝓmontoriũoꝑishuiusatatlanticilittoristerminus	uergens ꝓmontoriũ oꝑis huius at  atlantici littoris terminus
ΤέλοςXXIIIIAprilis1450AntheusAntheitulusGNA	Τέλος XXIIII Aprilis 1450 Antheus Anthei tu lus GNA
flAmpelusiarenturinanesalique	fl Ampelusia rentur inanes alique
fuissequefurtieẽntexcicatesictuet̃sic	fuisse que furti eẽnt excicate sic tu et̃ sic
q̃dscribesscribitotm̃nefurtũcessationisquesimile	q̃d scribes scribito tm̃ ne furtũ cessationis que simile
videasUaldeeĩmi	videas Ualde eĩ mi
semꝑetueraet	semꝑ et uera et
dulciatuisepl̃isnũcianturAmanos	dulcia tuis epl̃is nũciantur Ama nos
etualeQuintus	et uale Quintus
CiceroTironisuosal̃p	Cicero Tironi suo sal̃ p
.dicitMIrificauimi	. dicit MIrificaui mi
uerberationemcessatiõisepl̃adedisti	uerberationem cessatiõis epl̃a dedisti
Namquefraterꝑtiusꝑscripseratuerecondiau	Nam que frater ꝑtius ꝑscripserat uerecondia u 
etproꝑationeeãtusine	et proꝑatione eã tu  sine
assensioneuterantde	assensione ut erant de
mescripsistietmaximecoss.designatisquosego	me scripsisti et maxime coss . designatis quos ego
pẽitusnouilibidinũet	pẽitus noui libidinũ et
langoriseteffeminatissimiãiplenosqui	langoris et effeminatissimi ãi plenos qui
ubiagubernaculisrecesẜintmaxĩu	ubi a gubernaculis recesẜint maxĩu
abuniuersonaufragioꝑiculũestIncredibileest	 ab uniuerso naufragio ꝑiculũ est Incredibile est
queegoillosscioappoĩtisgallorucastris	que ego illos scio appoĩtis galloru  castris
ĩestiuisfecissequosillelatroubialiquidfirmiusfuit	ĩ estiuis fecisse quos ille latro ubi aliquid firmius fuit
societateuitiorũdeliniet	societate uitiorũ deliniet
ResestauttribunicisconsiliisminuendaNamisti	Res est aut tribunicis consiliis minuenda Nam isti
duouixsuntdigniquibus	duo uix sunt digni quibus
alteriCossutiͣnarumtabernarumfundamentacredas	alteri Cossutiͣnarum tabernarum fundamenta credas
TeutdixiferecelerisEgouos	Te ut dixi fere celeris Ego uos
adIIIIkl̃uidebotuosqoculoset	ad IIII kl̃ uidebo tuosq  oculos et
siteueniesĩmedioforouideo	si te uenies ĩ medio foro uideo
dissamabor.MeamaUale	dissamabor . Me ama Uale
LXVDeoGratiasAmen1450ciscentisdominiiniutãnecem	LXV Deo Gratias Amen 1450 ciscentis domini iniutã necem
interfectus&huic	interfectus & huic
maiorutroq	maior utroq 
hanibalimperatorAmilcarisfiliussucceditsiquidẽresgestasutriusq	hanibal imperator Amilcaris filius succedit siquidẽ res gestas utriusq 
suꝑgressusuniuersamhyspaniãdomuitInderomanis	suꝑgressus uniuersam hyspaniã domuit Inde romanis
illatobelloytaliamꝑ	illato bello ytaliam ꝑ
annossexdecimuariiscladibusfatigauitCuminterea	annos sexdecim uariis cladibus fatigauit Cum interea
RomanimissisinhyspaniaScipionibusprimo	Romani missis in hyspania Scipionibus primo
poenosprouinciaexpuleruntposteacũipsis	poenos prouincia expulerunt postea cũ ipsis
hyspanisgrauia	hyspanis grauia
bellagesseruntNecpriusꝑdomiteprouincieiugumqhyspani	bella gesserunt Nec prius ꝑdomite prouincie iugumq  hyspani
acciperepotueruntꝙͣCesar	accipere potuerunt ꝙͣ Cesar
Augustusperdomito	Augustus perdomito
orbeuictriciaadeosarma	orbe uictricia ad eos arma
transtulitpopulumqferumac	transtulit populumq  ferum ac
barbarumlegibusadcultioremuiteusum	barbarum legibus ad cultiorem uite usum
traductuminformãprouincieredegitDEO	traductum in formã prouincie redegit DEO
GRATIASHISPANIIUSTINIXXXXIIIIorUOLUMINUMTROGI	GRATIAS HISPANI IUSTINI XXXXIIIIor UOLUMINUM TROGI
POMPEIABREVIATORISLIBEREXPLICITScriptumpermedominicũMacth̃i	POMPEI ABREVIATORIS LIBER EXPLICIT Scriptum per me dominicũ Macth̃i
deReatemanuꝓͥaREATEMCCCCLIIIIIIIkl̃MaiiRISSIMUM	de Reate manu ꝓͥa REATE MCCCCLIII IIII kl̃ Maii RISSIMUM
IMPERATOREMACILLUSTRISSIMUMPRINCIPEMCOMITEMFRANCISCUM	IMPERATOREM AC ILLUSTRISSIMUM PRINCIPEM COMITEM FRANCISCUM
SFORTIAMVICECOMITEMFrancisciAleardiueronẽsislaudatioNONdubito	SFORTIAM VICECOMITEM Francisci Aleardi ueronẽsis laudatio NON dubito
foreꝑmultosPrincepsillustrissimequirerumtuarũ	fore ꝑ multos Princeps illustrissime qui rerum tuarũ
magnitudinemadmiratipręstantiingeniouirilitteriset	magnitudinem admirati pręstanti ingenio uiri litteris et
monumentissuis	monumentis suis
easmandareetillustrareconabunturpartimut	eas mandare et illustrare conabuntur partim ut
gratiamtuãquam	gratiam tuã quam
uelsũmisopibus	uel sũmis opibus
uelamplissĩsdiuitiismeritoanteponantfaciliuscõsequanturPartimut	uel amplissĩs diuitiis merito anteponant facilius cõsequantur Partim ut
intuisrebusmendandisuelingeniasua	in tuis rebusmendandis uel ingenia sua
exerceantuelinte	exerceant uel in te
collaudandomateriamnacticopiosissimamnomensuumquoq.ĩmortalitati	collaudando materiam nacti copiosissimam nomen suum quoq . ĩmortalitati
transmittantDeniq.nõincideret&	transmittant Deniq . nõ incideret &
uoxinde	uox inde
erupit&sanguissicutdocetOuidi᷒	erupit & sanguis sicut docet Ouidi᷒
driadesuõs̃tquęĩterarboreshabitanthoc	driades uõ s̃t quę ĩter arbores habitant hoc
aut̃adsuꝑioraꝑtinetquędixeratmixtislustrabomenala	aut̃ ad suꝑiora ꝑtinet quę dixerat mixtis lustrabo menala
nimphisNeccarmina	nimphis Nec carmina
uobisipaplacẽtdixerat	uobis ipa placẽt  dixerat
carminapastorissiculimodulaborauenaIpsęrursus	carmina pastoris siculi modulabor auena Ipsę rursus
cõceditesiluęꝑꝑilludIammihiꝑ	cõcedite siluę ꝑꝑ illud Iam mihi ꝑ
rupesvideorlucosq	rupes videor lucosq 
sonãtesNecsifrigorib.mediuebrũqbibamus	sonãtes Nec si frigorib . mediu  ebrũq  bibamus
manifestehocdicitamor̃secarer̃nõposse	manifeste hoc dicit amor̃ se carer̃ nõ posse
Necsiebrum	Nec si ebrum
Tracięfluuiũmediisfrigorib.bibatnecestib	Tracię fluuiũ mediis frigorib . bibat nec estib
.nimiisfiuntĩardẽtiꝓuincia	. nimiis fiunt ĩ ardẽti ꝓuincia
dicitaut̃hocẜmphisicos	dicit aut̃ hoc ẜm phisicos
quimorbosaut	qui morbos aut
aꝯtrariisautasimilib.asserũtpossedepelliSitionasq	a ꝯtrariis aut a similib . asserũt posse depelli Sitionasq
niuesSiton	 niues Siton
monsẽtracięlibercorticisparsĩteriorUersemur	mons ẽ tracię liber corticis pars ĩterior Uersemur
pascamushecsateritIamadmusasloquiturgracilifiscellã	pascamus hec sat erit Iam ad musas loquitur gracili fiscellã
texitibiscoacsidiceretnisihacreoccupat᷒minime	texit ibisco ac si diceret nisi hac reoccupat᷒ minime
canerẽallegoricosaut̃significatsecõposuissehunc	canerẽ allegoricos aut̃ significat se cõposuisse hunc
libellũtenuissimostiloquãtumuerenououiridissesubicit	libellũ tenuissimo stilo quãtum uere nouo uiridis se subicit
alnusAmoinquitGallũsedlatentersicut	alnus Amo inquit Gallũ sed latenter sicut
arborescrescũtnamoꝑatioistahocsignificatꝑꝑcęsarẽ	arbores crescũt nam oꝑatio ista hoc significat ꝑꝑ cęsarẽ
Etfrugib.umbręquãtomagis	Et frugib . umbrę quãto magis
hõib.uñ&̃ĩgeorgicis	hõib . uñ & ̃ ĩ georgicis
&aurisoptati	& auris optati
fpuItedomũSaturęuenithesꝑusite	f p u Ite domũ Saturę uenit hesꝑus ite
capellęuerecũdesecapellaꝝdicitpastorẽ	capellę uerecũde se capellaꝝ dicit pastorẽ
.i.uilissimoꝝ	. i . uilissimoꝝ
animaliuNam	animaliu  Nam
buccolicascribẽs	buccolica scribẽs
debuitsedicer̃boumeẽ	debuit se dicer̃ boum eẽ
pastorẽsuitãsãogãtiamultimũ	pastorẽ s  uitãs ãogãtiam ultimũ
seuoluiteẽprincipẽĩscribẽdisbuccolicisfinisUiterbii	se uoluit eẽ principẽ ĩ scribẽdis buccolicis finis Uiterbii
MͦCCCCLVmẽs̃maiiN	MͦCCCCLV mẽs̃ maii N
.Vpont̃MͦsedẽteEgoAngl̃usscarponi᷒	. V pont̃ Mͦ sedẽte Ego Angl̃us scarponi᷒
scolarishũclibrũscripsiDe	scolaris hũc librũ scripsi De
uassanoscilicortañdioc̃cepitq̃	uassano scilic  ortañ dioc̃ cepit q̃
iasonihocordinetͣdiditꝯseruandaDetͣditõeRerũad	iasoni hoc ordine tͣdidit ꝯseruanda De tͣditõe Rerũ ad
incãtand̃INpͥmistͣdiditeiquãd̃ymaginẽargenteãꝙͣ	incãtand̃ IN pͥmis tͣdidit ei quãd̃ ymaginẽ argenteã ꝙͣ
dixitesseꝑincantatõemnodosml̃ti	dixit esse ꝑ incantatõem nodos  ml̃ti
artificiiũtutecõstructamq̃adũsus	artificii ũtute cõstructam q̃ adũsus
incantatõesiãfc̃asẽualdepotissĩa	incantatões iã fc̃as ẽ ualde potissĩa
cassansuidelq̃fc̃aIamsũt&eoꝝuotiua	cassans uidel  q̃ fc̃a Iam sũt & eoꝝ uotiua
expulsionefinaliRepellensDe	expulsione finali Repellens De
hacgͥiasonẽsͨinstͧxituteãcaute	hac gͥ iasonẽ sͨ instͧxit ut eã caute
supͣsedeferatnãadũsusincantatões	supͣ se deferat nã adũsus incantatões
qͣslualeresescietuociuoꝝincantatõisuiribanl̃latis	qͣsl  ualere se sciet uociuoꝝ incantatõis uirib  anl̃latis
Scd̃osͥtradidͭcui᷒dã	Scd̃o sͥ tradidͭ cui᷒dã
umguẽtiodoriferimedicamẽquoip̃mliuiresuasitasẜens	umguẽti odoriferi medicamẽ quo ip̃m liuire suasit asẜens
ineoũtutẽineẽutadũsus	in eo ũtutẽ ineẽ ut adũsus
ꝯflãmasualdeualeatextingat	ꝯflãmas ualde  ualeat extingat
incendia⁊	incendia ⁊
om̃eꝙh̃tpotenciãꝯburendiincessafumositateResoluat	om̃e ꝙ h̃t potenciã ꝯburendi incessa fumositate Resoluat
Dem̃ꝙͣdãanulũsͥdeditinquotalisũtutũ	Dem̃ ꝙͣdã anulũ sͥ dedit in quo talis ũtutũ
lapiserat	lapis erat
inclususutq̃cũquenenacorriꝑẽt	inclusus ut q̃cũq  uenena corriꝑẽt
corũnocum̃taRepelleret⁊	corũ nocum̃ta Repelleret ⁊
ꝙͣueneniRabiesꝑfusaforsaninfic̃etuelutabaqͥsin	ꝙͣ ueneni Rabies ꝑfusa forsan infic̃et uelut ab aqͥs in
nãdequaillũinstuxit	nã de qua illũ instuxit
utꝙͣpͥmũꝑueniretadboues	ut ꝙͣ pͥmũ ꝑueniret ad boues
licoreillo	licore illo
ineoꝝoraꝑfund̃etcrebrisasꝑsionib	in eoꝝ ora ꝑfund̃et  crebris asꝑsionib
irroraret	 irroraret
Inlicoreẽillohanc	In licore ẽ illo hanc
ineẽuirtutẽasẜuntutꝙͣpͥmũ	ineẽ uirtutẽ asẜunt ut ꝙͣ pͥmũ
orabouminfũderent᷑exabillouelutq̃d	ora boum infũderent᷑ ex ab illo uelut q̃d
uiscosoglutinosͨꝯpactaꝯstring̃ent᷑ĩunũ	uiscoso glutino sͨ ꝯpacta ꝯstring̃ent᷑ ĩ unũ
ꝙeoꝝaꝑturanõtamdifficilis	ꝙ eoꝝ aꝑtura nõ tam difficilis
ꝙͣimpossibiliseẽtin	ꝙͣ impossibilis eẽt in
illissͨdesingl̃issuccessiuemedea	illis  sͨ de singl̃is successiue medea
Iasonẽdiligent̃instͧxitMedeagͥsuis	Iasonẽ diligent̃ instͧxit Medea gͥ suis
instructionibdoctrinissͨdemũfinẽimposuitetdata	instructionib  doctrinis sͨ demũ finẽ imposuit et data
iasonilicentiaRecedẽdiañdieicõminãtislucisaduent̃	iasoni licentia Recedẽdi añ diei cõminãtis lucis aduent̃
IasonindecretãsͥCamerãfurtiuis	Iason in decretã sͥ Camerã furtiuis
passibseRecepitInsurgẽte	passib  se Recepit Insurgẽte
gͥRoseis	gͥ Roseis
aurorasplendoribetsoleaureolucemodica	aurora splendorib  et sole aureo luce modica
Cacumĩamontiũillustranteiasonfutiuosurgitathalamoincomitia	Cacumĩa montiũ illustrante iason futiuo surgit a thalamo in comitia
uidelh̃culissuoꝝoetisRegis	uidel  h̃culis  suoꝝ  oetis Regis
adiuitsoliũinquoipeRexiamse	adiuit soliũ in quo ipe Rex iam se
Receꝑatml̃toꝝastanti	Receꝑat ml̃toꝝ astanti
choraulepalliotyriantinoquoilleuelutspolionobilitatisexultatmesale	choraule pallio tyriantino quo ille uelut spolio nobilitatis exultat mesale
nomẽuxõisiamꝗdlineaspetitaᷤ	nomẽ uxõis iam ꝗd lineas petitaᷤ
egyptoloquar	egypto loquar
Quidtyroetsydonatenuitateꝑlucidaᷤ	Quid tyro et sydona tenuitate ꝑ lucidaᷤ
micãtespũpuraplumãdidifficultateꝑ	micãtes pũpura plumãdi difficultate ꝑ
nobilesdõatisũatrabatitis	nobiles dõati sũ atrabatitis
biripetitidonatibiri	biri petiti donati biri
canussiniafricaneopesinscenaripri᷒	canussini africane opes inscenari pri᷒
uiseEthecquide	uise Et hec quide
idcĩcoegoĩlitterasretuliꝙfuturoseditõespudõe	 idcĩco ego ĩ litteras retuli ꝙ futuros editões pudõe
tang̃etnepr̃imonia	tang̃et ne pr̃imonia
suaproscriptislegitimishr̃dib᷒mimisetbalteõib.deputarẽt	sua pro scriptis legitimis hr̃dib᷒ mimis et balteõib . deputarẽt
Habemiamicemeũ	Habe mi amice meũ
mim᷒ꝙegoutsepedixinõeloquiẽtie	mim᷒ ꝙ ego ut sepe dixi nõ eloquiẽtie
causasedcũiositatisin	causa sed cũiositatis in
lumẽEdidiidcipueagẽs	lumẽ Edidi id  cipue agẽs
utsiꝗseloquẽsuelletfc̃aprĩcipureẜaremateriã	ut siꝗs eloquẽs uellet fc̃a prĩcipu  reẜare materiã
nõreꝗuir̃eth̃iturosmeoslibellosministroseloquii	nõ reꝗuir̃et h̃ituros meos libellos ministros eloquii
tequesosisꝯtẽtusnosq.sicuoluissescriberemeli᷒	te queso sis ꝯtẽtus nosq . sic uoluisse scribere meli᷒
ꝙͣpotuisse	ꝙͣ potuisse
contẽdasFeLiCi	contẽdas Fe Li Ci
TerAm̃Expliciteuite	Ter Am̃ Explicite uite
DiuersoꝝPrĩcipũEtTyrãnoꝝAdiuoAdriano	Diuersoꝝ Prĩcipũ Et Tyrãnoꝝ A diuo Adriano
usqadNum̃ianum	usq  ad Num̃ianum
FeliciterUt̃eFelix	Feliciter Ut̃e Felix
Script᷒fuitsubMillĩocccͦ	Script᷒ fuit sub Millĩo cccͦ
LVIdemensefebr̃	LVI de mense febr̃
Etscripsiteum	Et scripsit eum
Frat̃ioh̃esdeCampagnola	Frat̃ ioh̃es de Campagnola
Regiñdioc̃DeoG̃asAm̃Am̃	Regiñ dioc̃ Deo G̃as Am̃ Am̃
am̃PErcorrer	am̃ PEr correr
miglioraqqOmailanauicelladelmioin	miglior aqq  Omai la nauicella del mio in
Chelasciadietroasemar	Che lascia dietro a se mar
EcanterodiquelsecondoOue	E cantero di quel secondo Oue
lumanospiritosipurEdisalira	l umano spirito si pur E di salir a
ddiodiuentadeMaquilamortapoesiri	ddio diuenta de Ma qui la morta poesi ri
Osantemusepoicheuost	O sante muse poi che uost
EquicaliopealquantosurSeghuitando	E qui caliope alquanto sur Seghuitando
elmiocantoconquelsonodichui	el mio canto con quel sono di chui
lepicchemiseresentirolocolpotalche	le picche misere sentiro lo colpo tal che
desperarꝑdonoDolcecolordorientalzaphiroChes	desperar ꝑdono Dolce color d oriental zaphiro Che s
acolgeuanel	acolgeua nel
serenoaspectoDilaerpuroinsinoalprimogiroAgliocchi	sereno aspecto Dilaer puro insino al primo giro Agli occhi
meiricominciodilectotostochiouscide	mei ricomincio dilecto tosto ch io usci de
lauramortaChem	l aura morta Che m
auiacontristatigliocchielpLo	auia contristati gli occhi e l p Lo
belpianetachedamarconfortaFaceuatuctorider	bel pianeta che d amar conforta Faceua tucto rider
lorienteUelandoeipescicheraminsua	l oriente Uelando ei pesci ch eram in sua
scortREuerendediscretõnisdñomagr̃ohugonicantuariensisdñippͤ	scort REuerende discretõnis dño magr̃o hugoni cantuariensis dñi ppͤ
nuncioinangliafraterNicolaustreuethor	nuncio in anglia frater Nicolaus treueth or
RecõmendatõnehũiliReũenciã⁊	Recõmendatõne hũili Reũenciã ⁊
honoremAntiquitataliq̃dexordiumsiue	honorem Antiquitat aliq̃d exordium siue
ꝑcreationẽutcatholiciseuꝑIunoflagrationes	ꝑ creationẽ ut catholici seu ꝑ Iuno flagrationes
seudiluuiasicutplatonicinoneodẽeãualloInter	seu diluuia sicut platonici non eodẽ eã uallo Inter
cet̃osaut̃maiorisuetustatisassertoresĩuẽsac̃dotibinsignẽint̃	cet̃os aut̃ maioris uetustatis assertores ĩuẽ sac̃dotib  insignẽ int̃
septẽsapientesSolonẽinstrucmeoSaimurbemegipciacãocto	septẽ sapientes Solonẽ instruc meo Saim urbem egipciacã octo
milibannoꝝtũc	milib  annoꝝ tũc
steathenaꝝꝓcessitcondiciomilleãniss	ste athenaꝝ ꝓcessit condicio mille ãnis s 
ml̃toantiquiorhiisfingit᷑genseg	ml̃to antiquior hiis fingit᷑ gens eg
cian᷒inꝓlogo	cian᷒ in ꝓlogo
astronomiesuequiipolibrorari᷒inuenit᷑exꝑsona	astronomie sue qui ipo libro rari᷒ inuenit᷑ ex ꝑsona
sap̃ieꝑassentuiguisseSedhũcantiquitatis	sap̃ie ꝑ assent uiguisse Sed hũc antiquitatis
positionẽuelutfabulosisfitaugustin᷒deciuitate	positionẽ uelut fabulosis fit augustin᷒ de ciuitate
deilibro	dei libro
12mononsolũquia	12mo non solũ quia
ueritatisacrescͥpturedisso	ueritati sacre scͥpture disso
hystoriisgrecoꝝquiint̃mũdisapientesanteRomanoshabiti	hystoriis grecoꝝ qui int̃ mũdi sapientes ante Romanos habiti
s̃tclarioresnimẽtadeclarãtdiscrepareꝙͣpl̃imũĩueniturQuã	s̃t clariores nimẽta declarãt discrepare ꝙͣ pl̃imũ ĩuenitur Quã
dissonãciãdeclarãssanc	dissonãciã declarãs sanc
docetquomͦutliquetexquadãepl̃aquã	docet quomͦ ut liquet ex quadã epl̃a quã
MatrisueOlimpiadiAlexandernrioꝝRegno	Matri sue Olimpiadi Alexander n rioꝝ Regno
ascribũtegipciiannoꝝ5000ampli᷒cuigrecinõultra	ascribũt egipcii annoꝝ 5000 ampli᷒ cui greci nõ ultra
1300aittuq	1300 ait tuq
abeod̃t̃minosuesumantcõputatõnis	 ab eod̃ t̃mino sue sumant cõputatõnis
pͥncipiũuidelabexordioregniB	pͥncipiũ uidel  ab exordio regni B
ENEDICTUSep̃usẜuusẜuorum	ENEDICTUS ep̃us ẜuus ẜuorum
deiUeñfr̃iEp̃oMagaloñsalt̃⁊apl̃icãbñDudum	dei Ueñ fr̃i Ep̃o Magaloñ salt̃ ⁊ apl̃icã bñ Dudum
adaudientiamnr̃iapl̃atusꝑuenitꝑlatequodꝓ	ad audientiam nr̃i apl̃atus ꝑuenit ꝑlate quod ꝓ
eoꝙinCastro	eo ꝙ in Castro
debrixiacoMagaloñdioc̃adtuamMagal̃	de brixiaco Magaloñ dioc̃ ad tuam Magal̃
eccam&dilc̃m	eccam & dilc̃m
filiũnobilemuirũRaymundumpetriMilitemdñmAgauteiusd̃	filiũ nobilem uirũ Raymundum petri Militem dñm Agaut eiusd̃
dioc̃cõiterꝑtinẽteperquosdamiudic̃secular̃cur̃cõis	dioc̃ cõiter ꝑtinẽte per quosdam iudic̃ secular̃ cur̃ cõis
ecceacnobil̃dictoꝝcontͣ	ecce ac nobil̃  dictoꝝ contͣ
quadamMichaelem	quadam Michaelem
gaut͛ieetEmẽgardamdecarnic̃acAgnetẽfabricemulieres	gaut͛ie et Emẽgardam de carnic̃ ac Agnetẽ fabrice mulieres
utasserebat᷑sortilegas⁊maleficasc̃tushabitusꝓcessusfuerat⁊	ut asserebat᷑ sortilegas ⁊ maleficas c̃tus habitus ꝓcessus fuerat ⁊
cõdempnacionissñia	cõdempnacionis sñia
ꝓmulgataet	ꝓmulgata et
executionimandata	executioni mandata
inofficiidilc̃ifiliiInquisitorheretic̃prauitat̃inillispartib	in officii dilc̃i filii Inquisitor heretic̃ prauitat̃ in illis partib
auct̃eapl̃icadeputatiutdicebat᷑iudiciũ⁊cõtemptum	 auct̃e apl̃ica deputati ut dicebat᷑  iudiciũ ⁊ cõtemptum
pereũdemInquisitorseudemãdatosuocontͣnonullas	per eũdem Inquisitor seu de mãdato suo contͣ nonullas
ꝑsonasc̃tifuerãt	ꝑsonas c̃ti fuerãt
factiꝓcessusRoc̃tisexcaus̃tam	facti ꝓcessus Ro c̃tis ex caus̃ tam
detotoꝓcessu	de toto ꝓcessu
suꝑmiss̃habitoperdc̃osIudic̃essecular̃ꝙͣ	suꝑ  miss̃ habito per dc̃os Iudic̃es secular̃ ꝙͣ
ꝓcessupredc̃opereũdemInquisitor̃ueldesuoAdLuchinum	ꝓcessu predc̃o per eũdem Inquisitor̃ uel de suo Ad Luchinum
uicecoͥtemmediolanidominucũ	uicecoͥtem mediolani dominu  cũ
piratransmitteretincidenter	pira transmitteret incidenter
egitdelaudib.italieARgolicassifamauolansuulgata	egit de laudib . italie ARgolicas si fama uolans uulgata
ꝑurbesArborisausoniequondam	ꝑ urbes Arboris ausonie quondam
dumsplenduitetasAurea,saturnoterrisregnantefuiss⁊	dum splenduit etas Aurea , saturno terris regnante fuiss ⁊
UtreoreurysteusnũꝙͣtotferrelaboresCogeretalcydem	Ut reor eurysteus nũꝙͣ tot ferre labores Cogeret alcydem
,suaditia	, sua ditia
pomadraconiOrtulushesperidummale	poma draconi Ortulus hesperidum male
custoditushaberetHocpotiusmandaretopusnecuinceret	custoditus haberet Hoc potius mandaret opus nec uinceret
auruNatiuidulcoris	auru  Natiui dulcoris
opesFelitiusomniEslatiumtellurequidem	opes Felitius omni Es latium tellure quidem
fertilisoraItalieꝙͣfulua	 fertilis ora Italie ꝙͣ fulua
ceresuiridisq.minerua	ceres uiridisq . minerua
Purpureusꝙͣbachusquãamattu	Purpureus ꝙͣ bachus quã amat tu
frõdeacaprisFloreamellificisapib	frõdea capris Florea mellificis apib
.pecoriq.uicissimPascuaet	. pecoriq . uicissim Pascua et
irriguislatepulcerrimapratisTuredolensortisuariisscatebrosametallis	irriguis late pulcerrima pratis Tu redolens ortis uariis scatebrosa metallis
Arborib.	Arborib .
q.uirens	q . uirens
siluisumbrosauetustisantereclusumsubNumaregeetuicta	siluis umbrosa uetustis ante reclusum sub Numa rege et uicta
primũcarthagineHincconuersusadpacempronũinomnia	primũ carthagine Hinc conuersus ad pacem pronũ in omnia
malaetinluxumfluenssaeculumgrauib	mala et in luxum fluens saeculum grauib 
seuerisqlegibusmultiscoercuit	seuerisq  legibus multis coercuit
Obhaectotfactaingentiadictator	Ob haec tot facta ingentia dictator
ꝑpetuuset	ꝑpetuus et
paterpatriędictusest	pater patrię dictus est
Tractatumetiaminsenatu	Tractatum etiam in senatu
anquiacondidisset	an quia condidisset
imꝑiumromulusuocaretursedsanctiuserreuerentiusuisum	imꝑium romulus uocaretur sed sanctius er reuerentius uisum
estnomenaugustiut	est nomen augusti ut
scilicetiamdudumdu	scilicet iamdudum du
colitterrasiponomineet	 colit terras ipo nomine et
tituloconsecret᷑LAnneiFloriliberultimusannodñi1458	titulo consecret᷑ L Annei Flori liber ultimus anno dñi 1458
IIInoñianuar̃MlĩDeo	III noñ ianuar̃ Mlĩ Deo
lausEGOOMNIOFFICIO	laus EGO OMNI OFFICIO
ACPOTI᷒pietate	AC POTI᷒ pietate
ergateceterissatisfacioomnibusmihiipsenunꝙͣ	erga te ceteris satisfacio omnibus mihi ipse nunꝙͣ
satisfacioTantaenimest	satisfacio Tanta enim est
magnitudotuorumergamemeritorumutquoniamtu	magnitudo tuorum erga me meritorum ut quoniam tu
nisiperfectaredeme	nisi perfecta re de me
nonconquiesti	non conquiesti
egoidemintuacausanonofficio	ego  idem in tua causa non officio
uitãmihiesseacerbamputemIn	uitã mihi esse acerbam putem In
causahęcsuntHamoniusregis	causa hęc sunt Hamonius regis
legatusapertepecunianosoppugnat	legatus aperte pecunia nos oppugnat
Resagiturpereosdemcompetitoresperquoscumtu	Res agitur per eosdem competitores per quos cum tu
aderasagebaturRegiscausasiquisuntqui	aderas agebatur Regis causa si qui sunt qui
uelintꝗpauci	uelint ꝗ pauci
suntomnesremadpompeiumdeferriuoluntSenatusreligionis	sunt omnes rem ad pompeium deferri uolunt Senatus religionis
calũniamnonreligionesedmaleuolentia&	calũniam non religione sed maleuolentia &
illiusregiaeLargitionisinuidiacõprobat	illius regiae Largitionis inuidia cõprobat
Pompeiumethortariet	Pompeium et hortari et
orareetiamLiberiusaccusareetmonereutmagnaminfamiam	orare et iam Liberius accusare et monere ut magnam infamiam
fugiatnondesistimusSed	fugiat non desistimus Sed
planenecprecibusnr̃issiquidobcommissorum	plane nec precibus nr̃is si quid ob commissorum
penitenciameligitisueliniuriaamicisuestris	penitenciam eligitis uel iniuria  amicis uestris
neanicomede	ne a nicomede
inferrisiniteSicenifaciẽtibusuobisauxilia	inferri sinite Sic eni faciẽtibus uobis auxilia
contraitalosregemnostrum	contra italos regem nostrum
laturumpollicemuruelapparentemamiciciamsaltemdissoluiteuelromam	laturum pollicemur uel apparentem amiciciam saltem dissoluite uel romam
adiudiciumcontendamusunaSicpelopidaselocutus	ad iudicium contendamus una Sic pelopidas elocutus
estHiauteminsolenciisillumloqui	est Hi autem insolenciis illum loqui
arbitrantesmitridatemanicomedeetcapadociaabstiñe	arbitrantes mitridatem a nicomede et capadocia abstiñe
imperantse	imperant se
statimAriobarzanemineamreducturosesse	statim Ariobarzanem in eam reducturos esse
pelopidaminsuperabexercitucedereiubentneculteriusad	pelopidam insuper ab exercitu cedere iubent nec ulterius ad
eosreuertinisiinhisquemandataessentpermaneretrex	eos reuerti nisi in his que mandata essent permaneret rex
Inhuncmod̃tulere	In hunc mod̃ tulere
sentenciametdiscendentiabindepelopidecustodiamadhibuerenequempiam	sentenciam et discendenti abinde pelopide custodiam adhibuere ne quempiam
initinereꝑuert̃etQuibusperactisconsiliatantibelli	in itinere ꝑuert̃et Quibus peractis consilia tanti belli
neutiqexpectantesaututpopulo	neutiq  expectantes aut ut populo
notafierentetgalatisquiinasia	nota fierentet galatis qui in asia
suntstatimmouentVerumquiapropius	sunt statim mouent Verum quia propius
ipisexercitusaderatquemlucassiusasie	ipis exercitus aderat quem lu cassius asie
proconsulretinebatetomnessocioꝝuiresĩunũconuenerant	proconsul retinebat et omnes socioꝝ uires ĩ unũ conuenerant
dispartitiscopiisunusquisqcastraponitCassiusbithinie	dispartitis copiis unusquisq  castra ponit Cassius bithinie
etgalacieinmedioinannis	et galacie in medio in annis
perinferiora	per inferiora
bithiHocpriuilegiumadño	bithi Hoc priuilegium a dño
ppͣnobisetecclesienostreconcessumloquiturdeom̃ibus	ppͣ nobis et ecclesie nostre concessum loquitur de om̃ibus
terriᷤquashabeteccl̃anr̃a	terriᷤ quas habet eccl̃a nr̃a
ubicumqsintAlexanderepiscopus	ubicumq  sint Alexander episcopus
seruusseruorumdeidilectisfiliisAndreedecanoeccl̃e	seruus seruorum dei dilectis filiis Andree decano eccl̃e
sanctiauitieiusqfratrib	sancti auiti eiusq  fratrib
tampresentib	 tam presentib 
quamfuturiscanonice	quam futuris canonice
sustituendisinꝑpetuumQuotiensa	sustituendis in ꝑpetuum Quotiens a
nobisilludpetiturquodreligioniethonestati	nobis illud petitur quod religioni et honestati
condereetpetentiumdesideriiscongruuminpertirisuffragiumEaꝓpterdilecti	condere et petentium desideriis congruum inpertiri suffragium Eaꝓpter dilecti
indñofilii	in dño filii
uestrisiustispostulationibclementerannuimusetcũctaillũĩansos	uestris iustis postulationib  clementer annuimus et cũcta illũĩans os
d̃ilinguaignitasap̃iamꝓmẽsfonsiugit͛sanitates	d̃i lingua ignita sap̃iam ꝓmẽs fons iugit͛ sanitates
emanãsQuimareĩmeabl̃ibgͤssib᷒	emanãs Qui mare ĩ meabl̃ib  gͤssib᷒
sc̃ificastiQͥt̃rãp᷑pureãtuocruorefecistiqͥcelos	sc̃ificasti Qͥ t̃rã p᷑pureã tuo cruore fecisti qͥ celos
cõmeastiuͥĩmedio	cõmeasti uͥ ĩ medio
diuineacieirefulgesĩsplendoreĩmarcessibilisgl̃ie	diuineaciei refulges ĩ splendore ĩmarcessibilis gl̃ie
splendesInexultatõneIocũditatisĩsaciabilis	splendes In exultatõne Iocũditatis ĩsaciabilis
gaudesh̃theodorusAugustinushocnom̃sortitusẽul̃ꝑꝑethimologiã	gaudes h̃ theodorus Augustinus hoc nom̃ sortitus ẽ ul̃ ꝑꝑethimologiã
nõisꝓpt̃excellentiãdignitatisqm̃sic̃	nõis ꝓpt̃ excellentiã dignitatis qm̃ sic̃
ĩꝑatoraugustuscellebatõsregessic	ĩꝑator augustus  cellebat õs reges sic 
isteexcellitõsdoctores	iste excellit õs doctores
ẜꝙdicit	ẜ ꝙ dicit
remigi᷒undealiidoctores	remigi᷒ unde alii doctores
ꝯꝑant᷑stellisdañxiiQuiadiustĩam	ꝯꝑant᷑ stellis dañ xii Qui ad iustĩam
erudiuntml̃tossic̃stelle⁊c̃hicaut̃ꝯꝑat᷑soli	erudiunt ml̃tos sic̃ stelle ⁊ c̃ hic aut̃ ꝯꝑat᷑ soli
sic̃pĩ	sic̃ p  ĩ
epl̃aq̃	epl̃a q̃
deeocantat᷑qiͣsolrefulgenssicipe	de eo cantat᷑ qiͣ sol refulgens sic ipe
refulsitintemplod̃iScd̃op̃pf̃uorẽdilectõisqm̃	refulsit in templo d̃i Scd̃o p̃p f̃uorẽ dilectõis qm̃
sic̃m̃sisaugustusualdeferuetestucalorissic⁊ipe	sic̃ m̃sis augustus ualde feruet estu caloris sic ⁊ ipe
ualdeĩcaluitigne	ualde ĩcaluit igne
diuiniamorisuñipeĩlibro	diuini amoris uñ ipe ĩ libro
ꝯfõnũdesedicitSagittaũas	ꝯfõnũ de se dicit Sagittaũas
tucormeũcaritatetua⁊c̃It̃ibidẽ	tu cor meũ caritate tua ⁊ c̃ It̃ ibidẽ
aliqñĩtromittismeĩ	aliqñ ĩtromittis me ĩ
affc̃mml̃tũĩusitatũĩtrorsus	affc̃m ml̃tũ ĩusitatũ ĩtrorsus
nescioadqͣmdulcedinẽq̃siꝑficiat᷑ĩ	nescio ad qͣm dulcedinẽ q̃ si ꝑficiat᷑ ĩ
menescioqͥderitꝙ	me nescio qͥd erit ꝙ
uitaistanõeritT̃ciop̃pethymologiamnõisDicit᷑	uita ista nõ erit T̃cio p̃p ethymologiam nõis Dicit᷑
eĩaugustin᷒ab	eĩ augustin᷒ ab
augeo⁊astimq̃dẽciuitas	augeo ⁊ astimq̃d ẽ ciuitas
anaq̃dẽsursũIndeaug̃qiͣ	 ana q̃d ẽ sursũ Inde aug̃ qiͣ
augenssuꝑnãciuitatẽuñ	augens suꝑnã ciuitatẽ uñ
deeocantat᷑Qui	de eo cantat᷑ Qui
ualuitamplificareciuitatẽ	 ualuit amplificare ciuitatẽ 
c̃ul̃utdr̃dinglosarioaug̃dr̃d	c̃ ul̃ ut dr̃d in glosario aug̃ dr̃d
magnificusfelix	magnificus felix 
clarusindoctrinafuit·H·	clarus in doctrina fuit · H ·
magnificusĩuita	magnificus ĩ uita
