Nonfacit	Non facit
adsaevoscervixnisiprima	ad saevos cervix nisi prima
leones.Quidfugishosdentesambitiose	leones . Quid fugis hos dentes ambitiose
lepusScilicetamagnisadtedescenderetauris	lepus Scilicet a magnis ad te descendere tauris
Etquaenoncernuntfrangerecolla	Et quae non cernunt frangere colla
velint.Desperandatibiest	velint . Desperanda tibi est
ingentisgloriafatiNon	ingentis gloria fati Non
poteshoctenuispraedasubhoste	potes hoc tenuis praeda sub hoste
Issaestpassere	Issa est passere
nequiorCatulliIssaestpuriorosculocolumbaeIssaestblandior	nequior Catulli Issa est purior osculo columbae Issa est blandior
omnibuspuellisIssa	omnibus puellis Issa
estcariorIndicislapillisIssa	est carior Indicis lapillis Issa
estdeliciae	est deliciae
catellaPubli.Hanctu	catella Publi . Hanc tu
siqueriturloquiputabis;Sentittristitiamquegaudiumque	si queritur loqui putabis ; Sentit tristitiamque gaudiumque
.CollonixacubatcapitquesomnosUtsuspiria	. Collo nixa cubat capitque somnos Ut suspiria
nullasentiantur;EtdesideriocoactaventrisGutta	nulla sentiantur ; Et desiderio coacta ventris Gutta
pallianon	pallia non
fefellitullaSedblandopedesuscitattoroqueDeponimonetet	fefellit ulla Sed blando pede suscitat toroque Deponi monet et
rogatlevari.Castaetantusinestpudorcatellae	rogat levari . Castae tantus inest pudor catellae
IgnoratVenerem;necinvenimusDignumtamtenera	Ignorat Venerem ; nec invenimus Dignum tam tenera
virumpuella.Hancne	virum puella . Hanc ne
luxrapiatsuprematotamPictaPubliusexprimit	lux rapiat suprema totam Picta Publius exprimit
tabellaInquatamsimilemvidebisIssamUt	tabella In qua tam similem videbis Issam Ut
sittamsimilissibinecipsa	sit tam similis sibi nec ipsa
.IssamdeniqueponecumtabellaAututramqueputabisesse	. Issam denique pone cum tabella Aut utramque putabis esse
veramAututramqueputabis	veram Aut utramque putabis
essepictam.	esse pictam .
SiquidFuscevacas	Si quid Fusce vacas
adhucamariNamsunt	adhuc amari Nam sunt
hinctibisuntethincamiciUnumsisuperest	hinc tibi sunt et hinc amici Unum si superest
locumrogamusNecmequodtibi	locum rogamus Nec me quod tibi
simnovusrecusesOmneshocveterestuifuerunt	sim novus recuses Omnes hoc veteres tui fuerunt
.Tutantuminspicequinovusparatur	. Tu tantum inspice qui novus paratur
Anpossitfierivetussodalis.	An possit fieri vetus sodalis .
CoponemlaniumquebalneumqueTonsoremtabulamquecalculosqueEt	Coponem laniumque balneumque Tonsorem tabulamque calculosque Et
paucosseduteligamlibellosUnum	paucos sed ut eligam libellos Unum
nonnimiumrudemsodalemEtgrandem	non nimium rudem sodalem Et grandem
puerumdiuquelevemEtcarampueromeopuellam	puerum diuque levem Et caram puero meo puellam
HaecpraestamihiRufevelButuntis	Haec praesta mihi Rufe vel Butuntis
Etthermas	Et thermas
tibihabeNeronianas.	tibi habe Neronianas .
Quiddete	Quid de te
LinesuspiceturuxorEtquapartevelitpudiciorem	Line suspicetur uxor Et qua parte velit pudiciorem
CertisindiciissatisprobavitCustodemtibi	Certis indiciis satis probavit Custodem tibi
quaededitspadonem.Nilnasutiushacmaligniusque.	quae dedit spadonem . Nil nasutius hac maligniusque .
Rictibushistauros	Rictibus his tauros
noneripueremagistriPerquos	non eripuere magistri Per quos
praedafugaxitquereditquelepus;Quodquemagis	praeda fugax itque reditque lepus ; Quodque magis
mirumvelociorexitabhosteNecnihil	mirum velocior exit ab hoste Nec nihil
atantanobilitaterefert.Tutiorinsolanonest	a tanta nobilitate refert . Tutior in sola non est
cumcurritharenaNeccaveaetanta	cum currit harena Nec caveae tanta
conditurillefide.	conditur ille fide .
SivitarecanummorsuslepusinprobequaerisAdquaeconfugias	Si vitare canum morsus lepus inprobe quaeris Ad quae confugias
oraleonishabes.	ora leonis habes .
SitibiMistyllos	Si tibi Mistyllos
cocusAemilianevocaturDicaturquarenonTaratalla	cocus Aemiliane vocatur Dicatur quare non Taratalla
EdetuostandempopuloFaustinelibellos	Ede tuos tandem populo Faustine libellos
EtcultumdoctopectoreproferopusQuodnecCecropiaedamnent	Et cultum docto pectore profer opus Quod nec Cecropiae damnent
PandionisarcesNecsileantnostripraetereantquesenes.	Pandionis arces Nec sileant nostri praetereantque senes .
Anteforesstantemdubitas	Ante fores stantem dubitas
admittereFamamTequepigetcuraepraemiaferretuaePost	admittere Famam Teque piget curae praemia ferre tuae Post
tevicturaeper	te victurae per
tequoqueviverechartaeIncipiantcinerigloriasera	te quoque vivere chartae Incipiant cineri gloria sera
HesternofeteremeroquicreditAcerramFalliturinlucemsemper	Hesterno fetere mero qui credit Acerram Fallitur in lucem semper
Acerrabibit.	Acerra bibit .
AestivoservesubipiscemtemporequaerisInthermis	Aestivo serves ubi piscem tempore quaeris In thermis
servaCaeciliane	serva Caeciliane
NostrisversibusessetepoetamFidentineputascupisquecrediSic	Nostris versibus esse te poetam Fidentine putas cupisque credi Sic
dentatasibivideturAegleEmptisossibusIndicoquecornu;	dentata sibi videtur Aegle Emptis ossibus Indicoque cornu ;
SicquaenigriorestcadentemoroCerussatasibiplacetLycoris	Sic quae nigrior est cadente moro Cerussata sibi placet Lycoris
.Hacetturationequapoetaes	. Hac et tu ratione qua poeta es
Calvuscumfueriseriscomatus.	Calvus cum fueris eris comatus .
Emiseupuerum	Emi seu puerum
togamvepexamSeutres	togamve pexam Seu tres
utputaquattuorvelibrasSextusprotinusillefenerator	ut puta quattuorve libras Sextus protinus ille fenerator
Quemnostisveteremmeum	Quem nostis veterem meum
sodalemNequid	sodalem Ne quid
fortepetamtimetcavetqueEt	forte petam timet cavetque Et
secumsedutaudiamsusurratSeptem	secum sed ut audiam susurrat Septem
miliadebeoSecundo	milia debeo Secundo
PhoeboquattuorundecimPhiletoEtquadransmihi	Phoebo quattuor undecim Phileto Et quadrans mihi
nullusestin	nullus est in
arca.Ogrande	arca . O grande
ingeniummeisodalisDurumestSextenegarecumrogaris	ingenium mei sodalis Durum est Sexte negare cum rogaris
Quantoduriusantequamrogeris	Quanto durius antequam rogeris
Sinonmolestum	Si non molestum
estteque	est teque
nonpigetscazonNostrorogamus	non piget scazon Nostro rogamus
paucaverbaMaternoDicasinauremsic	pauca verba Materno Dicas in aurem sic
utaudiatsolus.AmatorilletristiumlacernarumEtbaeticatus	ut audiat solus . Amator ille tristium lacernarum Et baeticatus
atqueleucophaeatusQuicoccinatosnonputatvirosesseAmethystinasquemulierum	atque leucophaeatus Qui coccinatos non putat viros esse Amethystinasque mulierum
vocatvestes	vocat vestes
NativalaudethabeatetlicetsemperFuscoscolores	Nativa laudet habeat et licet semper Fuscos colores
galbinoshabetmores.Rogabit	galbinos habet mores . Rogabit
undesuspicervirum	unde suspicer virum
mollem.UnalavamuraspicitnihilsursumSedspectatoculis	mollem . Una lavamur aspicit nihil sursum Sed spectat oculis
devorantibusdraucosNecotiosis	devorantibus draucos Nec otiosis
mentulasvidetlabris.QuaerisquishicsitExcidit	mentulas videt labris . Quaeris quis hic sit Excidit
mihinomen.	mihi nomen .
Verberasecurisolitus	Verbera securi solitus
leoferremagistriInsertamquepatiblandusinora	leo ferre magistri Insertamque pati blandus in ora
manumDedidicitpacemsubitoferitatereversaQuantanecinLibycis	manum Dedidicit pacem subito feritate reversa Quanta nec in Libycis
debuitesse	debuit esse
iugis.Namduode	iugis . Nam duo de
tenerapuerilia	tenera puerilia
corporaturba	corpora turba
Sanguineamrastrisquae	Sanguineam rastris quae
renovabathumumSaevosetinfelixfuriali	renovabat humum Saevos et infelix furiali
denteperemitMartianonviditmaiusharenanefas.Exclamare	dente peremit Martia non vidit maius harena nefas . Exclamare
libetcrudelisperfidepraedoAnostra	libet crudelis perfide praedo A nostra
puerisparceredisce	pueris parcere disce
Miliapropuerocentum	Milia pro puero centum
memangopoposcitRisiegosed	me mango poposcit Risi ego sed
Phoebusprotinusilladedit	Phoebus protinus illa dedit
.Hocdoletet	. Hoc dolet et
queriturdememeamentulasecum	queritur de me mea mentula secum
LaudaturquemeamPhoebusininvidiam	Laudaturque meam Phoebus in invidiam
.Sedsestertiolumdonavit	. Sed sestertiolum donavit
mentulaPhoeboBisdecies	mentula Phoebo Bis decies
hocdatumihipluris	hoc da tu mihi pluris
Litigatet	Litigat et
podagraDiodorusFlaccelaborat.Sednil	podagra Diodorus Flacce laborat . Sed nil
patronoporrigithaeccheragraest.	patrono porrigit haec cheragra est .
GentibusinLibycisuxortuaGallemale	Gentibus in Libycis uxor tua Galle male
auditImmodicaefoedocrimineavaritiae	audit Immodicae foedo crimine avaritiae
.Sedmeranarranturmendacianon	. Sed mera narrantur mendacia non
soletillaAccipereomnino.QuidsoletergoDare	solet illa Accipere omnino . Quid solet ergo Dare
BistibitricenifuimusMancinevocatiEtpositumest	Bis tibi triceni fuimus Mancine vocati Et positum est
nobisnilherepraeteraprum	nobis nil here praeter aprum
Nonquaedetardis	Non quae de tardis
servanturvitibusuvaeDulcibusautcertant	servantur vitibus uvae Dulcibus aut certant
quaemelimelafavisNon	quae melimela favis Non
piraquaelongapendent	pira quae longa pendent
religatagenestaAutimitata	religata genesta Aut imitata
brevisPunicagranarosasRusticalactantesnec	brevis Punica grana rosas Rustica lactantes nec
misitSassina	misit Sassina
metasNecdePicenis	metas Nec de Picenis
venitolivacadisNudus	venit oliva cadis Nudus
apersedethicminimus	aper sed et hic minimus
qualisquenecariAnonarmatopumilionepotest	qualisque necari A non armato pumilione potest
.Etnihilindedatumest;	. Et nihil inde datum est ;
tantumspectavimusomnes	tantum spectavimus omnes
Ponereaprumnobissicetharenasolet.Ponaturtibi	Ponere aprum nobis sic et harena solet . Ponatur tibi
nullusaperposttaliafactaSedtuponaris	nullus aper post talia facta Sed tu ponaris
cuiCharidemusapro.	cui Charidemus apro .
Dummodocausidicumdumtemodorhetora	Dum modo causidicum dum te modo rhetora
fingisEtnondecernisLaurequidessevelis	fingis Et non decernis Laure quid esse velis
PeleosetPriami	Peleos et Priami
transitetNestorisaetas	transi t et Nestoris aetas
Etfueratserumiamtibidesinere.Incipetresuno	Et fuerat serum iam tibi desinere . Incipe tres uno
perieruntrhetoresanno	perierunt rhetores anno
Siquidhabesanimisiquid	Si quid habes animi si quid
inartevales.Sischola	in arte vales . Si schola
damnaturforalitibusomniaferventIpsepotest	damnatur fora litibus omnia fervent Ipse potest
fieriMarsua	fieri Marsua
causidicus.Heiaagerumpe	causidicus . Heia age rumpe
morasquotesperabimususqueDum	moras quo te sperabimus usque Dum
quidsisdubitas	quid sis dubitas
iampotesesse	iam potes esse
Hesternatibinocte	Hesterna tibi nocte
dixeramusQuincunces	dixeramus Quincunces
putopostdecemperactosCenareshodieProcillemecum	puto post decem peractos Cenares hodie Procille mecum
.Tufactamtibiremstatimputasti	. Tu factam tibi rem statim putasti
Etnonsobria	Et non sobria
verbasubnotastiExemplonimiumpericulosoProcille.	verba subnotasti Exemplo nimium periculoso Procille .
haecsunthaecsunttuaCandide.	haec sunt haec sunt tua Candide .
Quaetumagnilocus	Quae tu magnilocus
noctediequesonasTeLacedaemoniovelattogalotaGalaesoVel	nocte dieque sonas Te Lacedaemonio velat toga lota Galaeso Vel
quamsepositodegregeParmadeditAtmequae	quam seposito de grege Parma dedit At me quae
passaestfuriasetcornuatauriNoluerit	passa est furias et cornua tauri Noluerit
diciquampilaprimasuam.	dici quam pila prima suam .
MisitAgenoreas	Misit Agenoreas
CadmitibiterralacernasNonvendesnummiscoccina	Cadmi tibi terra lacernas Non vendes nummis coccina
nostratribus.TuLibycosIndissuspendis	nostra tribus . Tu Libycos Indis suspendis
dentibusorbisFulciturtesta	dentibus orbis Fulcitur testa
faginamensamihi.Inmodicitibi	fagina mensa mihi . Inmodici tibi
flavateguntchrysendetamulliConcolorinnostracammare	flava tegunt chrysendeta mulli Concolor in nostra cammare
lancerubes.GrextuusIliacopoteratcertare	lance rubes . Grex tuus Iliaco poterat certare
cinaedoAtmihisuccurrit	cinaedo At mihi succurrit
proGanymedemanus.Exopibustantisveterifidoque	pro Ganymede manus . Ex opibus tantis veteri fidoque
sodaliDasnihil	sodali Das nihil
etdicisCandide	et dicis Candide
Pictoquod	Picto quod
iugadelicatacolloPardussustinetinprobaequetigresIndulgentpatientiam	iuga delicata collo Pardus sustinet inprobaeque tigres Indulgent patientiam
flagelloMordent	flagello Mordent
aureaquod	aurea quod
lupatacerviQuodfrenisLibycidomanturursi	lupata cervi Quod frenis Libyci domantur ursi
EtquantumCalydontulisse	Et quantum Calydon tulisse
ferturParetpurpureisapercapistrisTurpes	fertur Paret purpureis aper capistris Turpes
essedaquodtrahuntvisontesEtmollesdareiussaquod	esseda quod trahunt visontes Et molles dare iussa quod
choreasNigro	choreas Nigro
beluanonnegatmagistroQuisspectacula	belua non negat magistro Quis spectacula
nonputetdeorumHaectransittamenutminora	non putet deorum Haec transit tamen ut minora
quisquisVenatushumilesvidetleonumQuosvelox	quisquis Venatus humiles videt leonum Quos velox
leporumtimorfatigat.	leporum timor fatigat .
DimittuntrepetuntamantquecaptosEt	Dimittunt repetunt amantque captos Et
securiorestinorepraedaLaxoscuidare	securior est in ore praeda Laxos cui dare
perviosquerictusGaudentettimidostenere	perviosque rictus Gaudent et timidos tenere
dentesMollemfrangeredumpudetrapinam	dentes Mollem frangere dum pudet rapinam
Stratiscummodovenerint	Stratis cum modo venerint
iuvencis.Haec	iuvencis . Haec
clementianonparaturarteSednoruntcui	clementia non paratur arte Sed norunt cui
serviantleones.	serviant leones .
Cumtibisitsophiaeparfamaetcuradeorum	Cum tibi sit sophiae par fama et cura deorum
Ingeniopietasnecminoripsa	Ingenio pietas nec minor ipsa
suoIgnoratmeritisdaremunera	suo Ignorat meritis dare munera
quitibilibrumEtqui	qui tibi librum Et qui
miraturReguleturadari.	miratur Regule tura dari .
Simemini	Si memini
fueranttibiquattuorAelia	fuerant tibi quattuor Aelia
dentesExpulitunaduostussisetunaduos.Iam	dentes Expulit una duos tussis et una duos . Iam
securapotestotistussirediebus	secura potes totis tussire diebus
Nilisticquodagattertiatussishabet.	Nil istic quod agat tertia tussis habet .
Editanebrevibuspereatmihicura	Edita ne brevibus pereat mihi cura
libellisDicaturpotius.	libellis Dicatur potius .
Quodnullicalicemtuum	Quod nulli calicem tuum
propinasHumanefacisHormenonsuperbe.	propinas Humane facis Horme non superbe .
InNomentanisOvidiquodnasciturarvisAccepitquotienstempora	In Nomentanis Ovidi quod nascitur arvis Accepit quotiens tempora
longamerumExuitannosamoresnomenque	longa merum Exuit annosa mores nomenque
senectaEtquidquidvoluittestavocaturanus.	senecta Et quidquid voluit testa vocatur anus .
Coccinafamosaedonasetianthina	Coccina famosae donas et ianthina
moechaeVisdare	moechae Vis dare
quaemeruitmuneramittetogam	quae meruit munera mitte togam
Quidfaciatvoltscire	Quid faciat volt scire
Lyrisquodsobriafellat	Lyris quod sobria fellat
Nupereratmedicus	Nuper erat medicus
nuncestvispillo	nunc est vispillo
DiaulusQuod	Diaulus Quod
vispillofacit	vispillo facit
feceratetmedicus.	fecerat et medicus .
UrbanustibiCaecilivideris.Nonescredemihi	Urbanus tibi Caecili videris . Non es crede mihi
.QuidergovernaHocquodtranstiberinusambulatorQuipallentia	. Quid ergo verna Hoc quod transtiberinus ambulator Qui pallentia
sulphuratafractisPermutatvitreisquodotiosaeVenditqui	sulphurata fractis Permutat vitreis quod otiosae Vendit qui
madidumcicercoronaeQuodcustosdominusqueviperarum	madidum cicer coronae Quod custos dominusque viperarum
QuodvilespuerisalariorumQuodfumantiaquitomaclaraucus	Quod viles pueri salariorum Quod fumantia qui tomacla raucus
Circumferttepidiscocus	Circumfert tepidis cocus
popinisQuodnonoptimusurbicus	popinis Quod non optimus urbicus
poetaQuoddeGadibusimprobusmagisterQuod	poeta Quod de Gadibus improbus magister Quod
buccaestvetulidicaxcinaedi.Quaredesine	bucca est vetuli dicax cinaedi . Quare desine
iamtibivideriQuodsolitibi	iam tibi videri Quod soli tibi
CaecilividerisQuiGabbamsalibustuis	Caecili videris Qui Gabbam salibus tuis
etipsumPosses	et ipsum Posses
vincereTettiumCaballum	vincere Tettium Caballum
.Noncuicumque	. Non cuicumque
datumest	datum est
haberenasum	habere nasum
LuditquistolidaprocacitateNonestTettius	Ludit qui stolida procacitate Non est Tettius
illesedcaballus.	ille sed caballus .
Unusdetotopeccaveratorbe	Unus de toto peccaverat orbe
comarumAnulusincertanonbenefixusacu	comarum Anulus incerta non bene fixus acu
.HocfacinusLalagespeculoquoviderat	. Hoc facinus Lalage speculo quo viderat
ultaestEtceciditsaevisictaPlecusacomis	ulta est Et cecidit saevis icta Plecusa comis
.DesineiamLalagetristesornarecapillosTangatet	. Desine iam Lalage tristes ornare capillos Tangat et
insanumnullapuellacaput.	insanum nulla puella caput .
HocsalamandranotetvelsaevanovaculanudetUtdignaspeculo	Hoc salamandra notet vel saeva novacula nudet Ut digna speculo
fiatimagotua.	fiat imago tua .
Solatibifuerantsestertia	Sola tibi fuerant sestertia
MilichecentumQuaetulitesacraLedaredemptavia.	Miliche centum Quae tulit e sacra Leda redempta via .
Milicheluxuriaestsitantidives	Miliche luxuria est si tanti dives
amares.	amares .
Nonamoiamdiceshaec	Non amo iam dices haec
quoqueluxuriaest	quoque luxuria est
IturadHerculeasgelidiquaTiburisarcesCanaque	Itur ad Herculeas gelidi qua Tiburis arces Canaque
sulphureisAlbulafumataquisRuranemusque	sulphureis Albula fumat aquis Rura nemusque
sacrumdilectaqueiugeraMusisSignatvicinaquartusab	sacrum dilectaque iugera Musis Signat vicina quartus ab
urbelapis.Hicrudisaestivaspraestabatporticusumbras	urbe lapis . Hic rudis aestivas praestabat porticus umbras
HeuquampaenenovumporticusausanefasNam	Heu quam paene novum porticus ausa nefas Nam
subitoconlapsaruitcummolesubillaGestatus	subito conlapsa ruit cum mole sub illa Gestatus
biiugisRegulusessetequis.	biiugis Regulus esset equis .
NimirumtimuitnostrasFortunaquerellasQuaepartam	Nimirum timuit nostras Fortuna querellas Quae par tam
magnaenonerat	magnae non erat
invidiae.	invidiae .
Nuncetdamnaiuvant	Nunc et damna iuvant
;suntipsapericulatanti	; sunt ipsa pericula tanti
Stantianonpoteranttectaprobaredeos	Stantia non poterant tecta probare deos
Uxoremarmati	Uxorem armati
futuispuerHylletribuniSuppliciumtantumdum	futuis puer Hylle tribuni Supplicium tantum dum
pueriletimes.Vaetibi	puerile times . Vae tibi
dumludis	dum ludis
castrabere.	castrabere .
IammihidicesNonlicethoc.Quidtu	Iam mihi dices Non licet hoc . Quid tu
quodfacisHyllelicet	quod facis Hylle licet
Invitumcenare	Invitum cenare
foristeClassicedicis	foris te Classice dicis
SinonmentirisClassicedispeream.Ipsequoqueadcenam	Si non mentiris Classice dispeream . Ipse quoque ad cenam
gaudebatApiciusireCumcenareterattristior	gaudebat Apicius ire Cum cenaret erat tristior
illedomi.SitameninvitusvadiscurClassice	ille domi . Si tamen invitus vadis cur Classice
vadisCogoraisverumest	vadis Cogor ais verum est
;cogituretSelius.Enrogat	; cogitur et Selius . En rogat
adcenamMeliorteClassicerectam.Grandiaverba	ad cenam Melior te Classice rectam . Grandia verba
ubisuntsivireseccenega.	ubi sunt si vir es ecce nega .
Quaecumquelusi	Quaecumque lusi
iuvenisetpuerquondam	iuvenis et puer quondam
Apinasquenostrasquas	Apinasque nostras quas
necipseiamnoviMaleconlocare	nec ipse iam novi Male conlocare
sibonasvoleshorasEtinvidebisotiotuo	si bonas voles horas Et invidebis otio tuo
lectorAValerianoPollio	lector A Valeriano Pollio
petesQuintoPerquemperirenonlicetmeisnugis	petes Quinto Per quem perire non licet meis nugis
LascivosleporumcursuslususqueleonumQuodmaiornobis	Lascivos leporum cursus lususque leonum Quod maior nobis
chartaminorquegeritEtbis	charta minorque gerit Et bis
idemfacimusnimiumsiStellavideturHoc	idem facimus nimium si Stella videtur Hoc
tibibisleporemtuquoquepone	tibi bis leporem tu quoque pone
ConiugisaudissetfatumcumPorciaBrutiEtsubtracta	Coniugis audisset fatum cum Porcia Bruti Et subtracta
sibiquaereretarmadolorNondum	sibi quaereret arma dolor Nondum
scitisaitmortem	scitis ait mortem
nonposse	non posse
negariCredideramfatis	negari Credideram fatis
hocdocuissepatrem.Dixit	hoc docuisse patrem . Dixit
etardentisavidobibitorefavillas.Inunc	et ardentis avido bibit ore favillas . I nunc
etferrumturbamolesta	et ferrum turba molesta
CumplaceatPhilerostotatibidoteredemptusTrespateris	Cum placeat Phileros tota tibi dote redemptus Tres pateris
natosGallaperirefame.Praestaturcanotanta	natos Galla perire fame . Praestatur cano tanta
indulgentiacunnoQuemneccastapotestiamdecuisseVenus	indulgentia cunno Quem nec casta potest iam decuisse Venus
.PerpetuamditefaciantPhilerotisamicamO	. Perpetuam di te faciant Philerotis amicam O
materquanec	mater qua nec
Pontiadeterior.	Pontia deterior .
NevaleamsinontotisDecianediebusEt	Ne valeam si non totis Deciane diebus Et
tecumtotisnoctibus	tecum totis noctibus
essevelim.	esse velim .
Sedduosuntquaenosdisiunguntmilia	Sed duo sunt quae nos disiungunt milia
passumQuattuorhaecfiunt	passum Quattuor haec fiunt
cumredituruseam.Saepedominonescum	cum rediturus eam . Saepe domi non es cum
sisquoquesaepe	sis quoque saepe
negarisVeltantumcausis	negaris Vel tantum causis
veltibisaepevacas.	vel tibi saepe vacas .
Tetamenutvideamduomilia	Te tamen ut videam duo milia
nonpigetire	non piget ire
Uttenonvideamquattuor	Ut te non videam quattuor
irepiget.	ire piget .
Etiudexpetitetpetit	Et iudex petit et petit
patronus.SolvascenseoSextecreditori	patronus . Solvas censeo Sexte creditori
UriTongiliusmalediciturhemitritaeo.	Uri Tongilius male dicitur hemitritaeo .
Novihominisfraudesesuritatquesitit.	Novi hominis fraudes esurit atque sitit .
Subdolatendunturcrassisnunc	Subdola tenduntur crassis nunc
retiaturdisHamusetinmullummittituratquelupum	retia turdis Hamus et in mullum mittitur atque lupum
.CaecubasaccenturquaequeannuscoxitOpimiCondanturparcofusca	. Caecuba saccentur quaeque annus coxit Opimi Condantur parco fusca
Falernavitro.OmnesTongiliummedici	Falerna vitro . Omnes Tongilium medici
iusserelavariOstultifebremcreditisesseGulaest.	iussere lavari O stulti febrem creditis esse Gula est .
PetitGemellusnuptiasMaronillaeEtcupitetinstat	Petit Gemellus nuptias Maronillae Et cupit et instat
etprecaturetdonat.Adeonepulchraest	et precatur et donat . Adeone pulchra est
immofoediusnilest	immo foedius nil est
.Quidergo	. Quid ergo
inillapetituretplacetTussit.	in illa petitur et placet Tussit .
CumtibivernarentdubialanuginemalaeLambebatmedios	Cum tibi vernarent dubia lanugine malae Lambebat medios
inprobalinguaviros.Postquamtristecaputfastidiavispillonum	inproba lingua viros . Postquam triste caput fastidia vispillonum
EtmiserimeruittaediacarnificisUterisore	Et miseri meruit taedia carnificis Uteris ore
aliternimiaqueaeruginecaptusAdlatrasnomenquod	aliter nimiaque aerugine captus Adlatras nomen quod
tibicumque	tibi cumque
datur.Haereat	datur . Haereat
inguinibuspotiustam	inguinibus potius tam
noxialinguaNamcumfellaretpuriorillafuit.	noxia lingua Nam cum fellaret purior illa fuit .
FoedastimiserummaritemoechumEt	Foedasti miserum marite moechum Et
sequifuerantpriusrequiruntTruncinaribusauribusquevoltus.	se qui fuerant prius requirunt Trunci naribus auribusque voltus .
CredistesatisessevindicatumErrasistepotestet	Credis te satis esse vindicatum Erras iste potest et
irrumare.	irrumare .
Garrisinaurem	Garris in aurem
semperomnibusCinnaGarrireetilludtestequodlicet	semper omnibus Cinna Garrire et illud teste quod licet
turba.Ridesinaurem	turba . Rides in aurem
quererisarguisploras	quereris arguis ploras
Cantasinauremiudicas	Cantas in aurem iudicas
tacesclamasAdeoquepenitus	taces clamas Adeoque penitus
sedithictibimorbusUtsaepeinaurem	sedit hic tibi morbus Ut saepe in aurem
CinnaCaesaremlaudes.	Cinna Caesarem laudes .
OccurrisquocumquelocomihiPostumeclamasProtinuset	Occurris quocumque loco mihi Postume clamas Protinus et
primaesthaectua	prima est haec tua
voxQuidagisHocsimedeciesunaconveneris	vox Quid agis Hoc si me decies una conveneris
horaDicishabesputotu	hora Dicis habes puto tu
Postumenilquodagas.	Postume nil quod agas .
HostibivicinosFaustineTelesphorushortosFaeniusetbreve	Hos tibi vicinos Faustine Telesphorus hortos Faenius et breve
rusudaquepratatenet.Condidithicnatae	rus udaque prata tenet . Condidit hic natae
cineresnomenquesacravitQuodlegisAntullae	cineres nomenque sacravit Quod legis Antullae
dignioripselegi.	dignior ipse legi .
AdStygiasaequumfueratpaterissetutumbrasQuod	Ad Stygias aequum fuerat pater isset ut umbras Quod
quianonlicuitvivatutossacolat.	quia non licuit vivat ut ossa colat .
Nilrecitasetvis	Nil recitas et vis
Mamercepoetavideri.	Mamerce poeta videri .
Quidquidvisestodummodonilrecites.	Quidquid vis esto dummodo nil recites .
Sidetiniquatibi	Si det iniqua tibi
tristemfortunareatumSqualidus	tristem fortuna reatum Squalidus
haerebopallidiorquereoSiiubeatpatriadamnatumexcedereterraPer	haerebo pallidiorque reo Si iubeat patria damnatum excedere terra Per
fretaperscopulosexulisibocomes.Dattibi	freta per scopulos exulis ibo comes . Dat tibi
divitiasecquidsuntistaduorumDaspartem	divitias ecquid sunt ista duorum Das partem
multumestCandidedas	multum est Candide das
aliquidMecumerisergomiserquodsi	aliquid Mecum eris ergo miser quod si
deusoreserenoAdnueritfelixCandide	deus ore sereno Adnuerit felix Candide
soluseris.	solus eris .
Fabricioiunctusfido	Fabricio iunctus fido
requiescitAquinusQuipriorElysiasgaudetadissedomos	requiescit Aquinus Qui prior Elysias gaudet adisse domos
.AraduplexprimitestaturmunerapiliPlustamen	. Ara duplex primi testatur munera pili Plus tamen
esttitulo	est titulo
quodbreviorelegisIunctus	quod breviore legis Iunctus
uterquesacrolaudataefoederevitaeFamaquequodraronovitamicus	uterque sacro laudatae foedere vitae Famaque quod raro novit amicus
CosconiquilongaputasepigrammatanostraUtilis	Cosconi qui longa putas epigrammata nostra Utilis
unguendisaxibusessepotes	unguendis axibus esse potes
.HactucrediderislongumrationecolossonEtpuerumBruti	. Hac tu credideris longum ratione colosson Et puerum Bruti
dixerisessebrevem.Disce	dixeris esse brevem . Disce
quodignorasMarsidoctiquePedonisSaepeduplex	quod ignoras Marsi doctique Pedonis Saepe duplex
unumpaginatractatopus.	unum pagina tractat opus .
Nonsuntlongaquibusnihilestquoddemere	Non sunt longa quibus nihil est quod demere
possisSed	possis Sed
tuCosconidisticha	tu Cosconi disticha
longafacis.	longa facis .
Amissumnonfletcumsolaest	Amissum non flet cum sola est
GelliapatremSiquisadestiussaeprosiliuntlacrimae.	Gellia patrem Si quis adest iussae prosiliunt lacrimae .
NonlugetquisquislaudariGelliaquaeritIlledoletvere	Non luget quisquis laudari Gellia quaerit Ille dolet vere
quisinetestedolet.	qui sine teste dolet .
CumsintcruratibisimilentquaecornualunaeInrhytio	Cum sint crura tibi similent quae cornua lunae In rhytio
poterasPhoebelavarepedes	poteras Phoebe lavare pedes
SaepemihiqueriturnonsiccisCestosocellisTangise	Saepe mihi queritur non siccis Cestos ocellis Tangi se
digitoMamurianetuo	digito Mamuriane tuo
.Nonopusestdigitototumtibi	. Non opus est digito totum tibi
CestonhabetoSideest	Ceston habeto Si deest
nilaliudMamurianetibi.	nil aliud Mamuriane tibi .
Sedsinec	Sed si nec
focusestnudinecspondagrabati	focus est nudi nec sponda grabati
NeccurtusChionesAntiopesvecalixCereasi	Nec curtus Chiones Antiopesve calix Cerea si
pendetlumbiset	pendet lumbis et
scriptalacernaDimidiasquenatesGallicapaedategitPasceris	scripta lacerna Dimidiasque nates Gallica paeda tegit Pasceris
etnigrae	et nigrae
solonidoreculinaeEtbibisinmundamcumcanepronus	solo nidore culinae Et bibis inmundam cum cane pronus
aquamNonculumneque	aquam Non culum neque
enimestculusqui	enim est culus qui
noncacatolimSedfodiam	non cacat olim Sed fodiam
digitoquisuperestoculumNecmezelotypumnec	digito qui superest oculum Nec me zelotypum nec
dixerisessemalignum.DeniquepedicaMamuriane	dixeris esse malignum . Denique pedica Mamuriane
VersusscriberemeparumseverosNecquospraelegat	Versus scribere me parum severos Nec quos praelegat
inscholamagisterCorneliquererissedhilibelliTamquam	in schola magister Corneli quereris sed hi libelli Tamquam
coniugibussuismaritiNon	coniugibus suis mariti Non
possuntsinementulaplacere.Quidsime	possunt sine mentula placere . Quid si me
iubeastalassionemVerbisdicerenontalassionis	iubeas talassionem Verbis dicere non talassionis
QuisFloraliavestitetstolatumPermittitmeretricibuspudoremLex	Quis Floralia vestit et stolatum Permittit meretricibus pudorem Lex
haeccarminibusdataestiocosisNepossintnisipruriantiuvare	haec carminibus data est iocosis Ne possint nisi pruriant iuvare
.QuaredepositaseveritateParcas	. Quare deposita severitate Parcas
lusibuset	lusibus et
iocisrogamusNec	iocis rogamus Nec
castrarevelismeoslibellos.Gallo	castrare velis meos libellos . Gallo
turpiusestnihilPriapo.	turpius est nihil Priapo .
Omihicurarumpretiumnonvile	O mihi curarum pretium non vile
mearumFlacceAntenoreispesetalumnelarisPieriosdiffer	mearum Flacce Antenorei spes et alumne laris Pierios differ
cantusquechorosquesororum;Aesdabitex	cantusque chorosque sororum ; Aes dabit ex
istisnullapuellatibi.Quidpetisa	istis nulla puella tibi . Quid petis a
Phoebonummoshabetarca	Phoebo nummos habet arca
Minervae;Haecsapithaecomnesfeneratuna	Minervae ; Haec sapit haec omnes fenerat una
deos.QuidpossunthederaeBacchidarePallados	deos . Quid possunt hederae Bacchi dare Pallados
arborInclinatvariaspondere	arbor Inclinat varias pondere
nigracomas.PraeteraquasHeliconetserta	nigra comas . Praeter aquas Helicon et serta
lyrasquedearumNilhabet	lyrasque dearum Nil habet
etmagnumsed	et magnum sed
perinanesophos.QuidtibicumCirrhaquidcum	perinane sophos . Quid tibi cum Cirrha quid cum
PermessidenudaRomanumpropiusdivitiusqueforumest.Illicaera	Permesside nuda Romanum propius divitiusque forum est . Illic aera
sonantatcircumpulpitanostraEt	sonant at circum pulpita nostra Et
sterilescathedrasbasiasolacrepant.	steriles cathedras basia sola crepant .
CurnonbasiotePhilaenicalvaes.Curnon	Cur non basio te Philaeni calva es . Cur non
basiotePhilaeni	basio te Philaeni
rufaes.Curnonbasiote	rufa es . Cur non basio te
Philaeniluscaes.Haecqui	Philaeni lusca es . Haec qui
basiatoPhilaenifellat.	basiat o Philaeni fellat .
Indignaspremeretpestiscumtabidafauces	Indignas premeret pestis cum tabida fauces
Inqueipsos	Inque ipsos
vultusserperetatraluesSiccisipsegenisflentes	vultus serperet atra lues Siccis ipse genis flentes
hortatusamicosDecrevitStygiosFestusadirelacus.Nectamen	hortatus amicos Decrevit Stygios Festus adire lacus . Nec tamen
obscuropiapolluitoravenenoAuttorsitlentatristiafata	obscuro pia polluit ora veneno Aut torsit lenta tristia fata
fameSanctamRomanavitamsedmorteperegitDimisitque	fame Sanctam Romana vitam sed morte peregit Dimisitque
animamnobiliorerogo.Hancmortem	animam nobiliore rogo . Hanc mortem
fatismagnipraeferreCatonisFamapotesthuiusCaesaramicuserat	fatis magni praeferre Catonis Fama potest huius Caesar amicus erat
Nondicamlicetusqueme	Non dicam licet usque me
rogetisQuisitPostumusinmeolibelloNondicamquid	rogetis Qui sit Postumus in meo libello Non dicam quid
enimmihi	enim mihi
necesseestHas	necesse est Has
offenderebasiationesQuae	offendere basiationes Quae
setambenevindicarepossunt	se tam bene vindicare possunt
ScripsirescripsitnilNaevianondabitergo.Sedputo	Scripsi rescripsit nil Naevia non dabit ergo . Sed puto
quodscripsilegeratergodabit.	quod scripsi legerat ergo dabit .
Quodneccarminegloriorsupino	Quod nec carmine glorior supino
NecretrolegoSotadencinaedumNusquamGraeculaquodrecantat	Nec retro lego Sotaden cinaedum Nusquam Graecula quod recantat
echoNecdictatmihiluculentusAttisMollemdebilitategalliambon	echo Nec dictat mihi luculentus Attis Mollem debilitate galliambon
NonsumClassicetammaluspoeta.Quidsi	Non sum Classice tam malus poeta . Quid si
pergracilisviaspetauriInvitumiubeassubireLadanTurpeest	per gracilis vias petauri Invitum iubeas subire Ladan Turpe est
difficileshaberenugasEtstultuslaborestineptiarum.	difficiles habere nugas Et stultus labor est ineptiarum .
ScribatcarminacirculisPalaemonMeraris	Scribat carmina circulis Palaemon Me raris
iuvatauribusplacere.	iuvat auribus placere .
DatBaianamihiquadrantes	Dat Baiana mihi quadrantes
sportulacentum.Interdeliciasquidfacit	sportula centum . Inter delicias quid facit
istafames	ista fames
ReddeLupinobistenebrosaquebalneaGrylli	Redde Lupi nobis tenebrosaque balnea Grylli
TammalecumcenemcurbeneFlaccelaver	Tam male cum cenem cur bene Flacce laver
SiLucane	Si Lucane
tibivelsitibi	tibi vel si tibi
TulledarenturQualiaLedaei	Tulle darentur Qualia Ledaei
fataLaconeshabentNobilis	fata Lacones habent Nobilis
haecessetpietatisrixaduobusQuodpro	haec esset pietatis rixa duobus Quod pro
fratremorivelletuterquepriorDiceretinfernasetqui	fratre mori vellet uterque prior Diceret infernas et qui
priorissetadumbrasVivetuo	prior isset ad umbras Vive tuo
fratertemporevive	frater tempore vive
PexatuspulchreridesmeaZoile	Pexatus pulchre rides mea Zoile
trita.SunthaectritaquidemZoilesed	trita . Sunt haec trita quidem Zoile sed
measunt.	mea sunt .
CoepitMaximePanaquaesolebatNuncostendereCaniumTarentos.	Coepit Maxime Pana quae solebat Nunc ostendere Canium Tarentos .
VicinusmeusestmanuquetangiDenostrisNoviuspotest	Vicinus meus est manuque tangi De nostris Novius potest
fenestris.Quis	fenestris . Quis
noninvideatmihi	non invideat mihi
putetqueHorisomnibusessemebeatumIuncto	putetque Horis omnibus esse me beatum Iuncto
cuiliceatfruisodale	cui liceat frui sodale
TamlongeestmihiquamTerentianusQuinunc	Tam longe est mihi quam Terentianus Qui nunc
NiliacamregitSyenen.NonconviverenecvideresaltemNon	Niliacam regit Syenen . Non convivere nec videre saltem Non
audirelicetnec	audire licet nec
urbetotaQuisquamesttamprope	urbe tota Quisquam est tam prope
tamproculquenobis.Migrandumestmihilongiusvel	tam proculque nobis . Migrandum est mihi longius vel
illi.VicinusNoviovelinquilinusSit	illi . Vicinus Novio vel inquilinus Sit
siquisNovium	si quis Novium
viderenonvolt.	videre non volt .
StellaedeliciummeiColumbaVeronalicet	Stellae delicium mei Columba Verona licet
audientedicamVicitMaximePasseremCatulli.Tanto	audiente dicam Vicit Maxime Passerem Catulli . Tanto
StellameustuoCatulloQuanto	Stella meus tuo Catullo Quanto
passeremaiorestcolumba.	passere maior est columba .
TercentenaquidempoterasepigrammataferreSedquis	Ter centena quidem poteras epigrammata ferre Sed quis
teferretperlegeretqueliberAtnuncsuccincti	te ferret perlegeretque liber At nunc succincti
quaesintbonadiscelibelli.Hocprimum	quae sint bona disce libelli . Hoc primum
estbreviorquodmihichartaperit;Deindequod	est brevior quod mihi charta perit ; Deinde quod
haecunaperagetlibrariushoraNec	haec una peraget librarius hora Nec
tantumnugisservietillemeis;Tertiares	tantum nugis serviet ille meis ; Tertia res
haecestquodsicuifortelegeris	haec est quod si cui forte legeris
Sislicetusquemalusnonodiosuseris.Teconviva	Sis licet usque malus non odiosus eris . Te conviva
legetmixtoquincuncesedanteIncipiatpositusquamtepuisse	leget mixto quincunce sed ante Incipiat positus quam tepuisse
calix.Esse	calix . Esse
tibitantacautusbrevitatevideris	tibi tanta cautus brevitate videris
Eimihiquammultissicquoque	Ei mihi quam multis sic quoque
longuseris	longus eris
Siquavidebunturchartis	Si qua videbuntur chartis
tibilectorinistisSiveobscuranimissivelatina	tibi lector in istis Sive obscura nimis sive latina
parumNonmeusesterrornocuit	parum Non meus est error nocuit
librariusillisDumproperatversusadnumeraretibi.Quodsi	librarius illis Dum properat versus adnumerare tibi . Quod si
nonillumsedmepeccasseputabisTuncegote	non illum sed me peccasse putabis Tunc ego te
credamcordis	credam cordis
haberenihil.	habere nihil .
Istatamenmalasunt.Quasi	Ista tamen mala sunt . Quasi
nosmanifestanegemusHaecmalasuntsedtunon	nos manifesta negemus Haec mala sunt sed tu non
meliorafacis.	meliora facis .
SemperagiscausasetresagisAttalesemper	Semper agis causas et res agis Attale semper
Estnonestquodagas	Est non est quod agas
Attalesemperagis.Siresetcausae	Attale semper agis . Si res et causae
desuntagisAttalemulas.Attale	desunt agis Attale mulas . Attale
nequodagasdesitagasanimam.	ne quod agas desit agas animam .
Sidederintsuperi	Si dederint superi
deciesmihimiliacentumDicebasnondum	decies mihi milia centum Dicebas nondum
ScaevolaiustusequesQualiterovivamquamlargequamque	Scaevola iustus eques Qualiter o vivam quam large quamque
beateRiseruntfacilesettribuere	beate Riserunt faciles et tribuere
dei.Sordidiormultoposthoctoga	dei . Sordidior multo post hoc toga
paenulapeiorCalceus	paenula peior Calceus
estsartaterquequaterquecute	est sarta terque quaterque cute
Dequedecempluressemper	Deque decem plures semper
servanturolivaeExplicatetcenas	servantur olivae Explicat et cenas
unicamensaduasEtVeientanibibiturfaexcrassarubelli	unica mensa duas Et Veientani bibitur faex crassa rubelli
Assecicertepidumconstatet	Asse cicer tepidum constat et
asseVenus	asse Venus
.Iniusofallaxatque	. In ius o fallax atque
infitiatoreamusAutviveautdecies	infitiator eamus Aut vive aut decies
Scaevolareddedeis.	Scaevola redde deis .
Hostibi	Hos tibi
PhoebevovettotosaverticecrinesEncolposdomini	Phoebe vovet totos a vertice crines Encolpos domini
centurionisamorGrata	centurionis amor Grata
Pudensmerititulerit	Pudens meriti tulerit
cumpraemiapili.QuamprimumlongasPhoeberecide	cum praemia pili . Quam primum longas Phoebe recide
comasDumnullatenerisordentlanuginevoltusDumque	comas Dum nulla teneri sordent lanugine voltus Dumque
decentfusaelacteacollaiubae;Utque	decent fusae lactea colla iubae ; Utque
tuislongumdominusquepuerquefruanturMuneribustonsumfac	tuis longum dominusque puerque fruantur Muneribus tonsum fac
citoserovirum.	cito sero virum .
Nullusinurbefuittotaqui	Nullus in urbe fuit tota qui
tangerevelletUxoremgratisCaecilianetuam	tangere vellet Uxorem gratis Caeciliane tuam
DumlicuitsednuncpositiscustodibusingensTurba	Dum licuit sed nunc positis custodibus ingens Turba
fututorumestingeniosushomo	fututorum est ingeniosus homo
CastanecantiquiscedensLaevinaSabinisEtquamvistetricotristior	Casta nec antiquis cedens Laevina Sabinis Et quamvis tetrico tristior
ipsaviroDummodoLucrinomodo	ipsa viro Dum modo Lucrino modo
sepermittitAvernoEtdumBaianissaepefoveturaquisIncidit	se permittit Averno Et dum Baianis saepe fovetur aquis Incidit
inflammasiuvenemque	in flammas iuvenemque
secutarelictoConiugePenelopevenitabitHelene.	secuta relicto Coniuge Penelope venit abi t Helene .
OsetlabratibilingitManneiacatellusNon	Os et labra tibi lingit Manneia catellus Non
mirormerdassilibetessecani.	miror merdas si libet esse cani .
Rerumcertasalusterrarumgloria	Rerum certa salus terrarum gloria
CaesarSospitequo	Caesar Sospite quo
magnoscredimusessedeosSi	magnos credimus esse deos Si
festinatistotienstibilectalibellis	festinatis totiens tibi lecta libellis
DetinuereoculoscarminanostratuosQuodfortunavetat	Detinuere oculos carmina nostra tuos Quod fortuna vetat
fieripermittevideriNatorumgenitorcredarutesse	fieri permitte videri Natorum genitor credar ut esse
trium.Haecsidisplicuifuerintsolacianobis;Haec	trium . Haec si displicui fuerint solacia nobis ; Haec
fuerintnobispraemiasiplacui.	fuerint nobis praemia si placui .
Oquamblandus	O quam blandus
esAmmianematriQuamblanda	es Ammiane matri Quam blanda
esttibimaterAmmiane	est tibi mater Ammiane
Fratremtevocatetsororvocatur	Fratrem te vocat et soror vocatur
.Curvosnominanequioratangunt	. Cur vos nomina nequiora tangunt
QuarenoniuvathocquodestisesseLusumcreditishoc	Quare non iuvat hoc quod estis esse Lusum creditis hoc
iocumqueNonestMatremquaecupitessesesororemNec	iocumque Non est Matrem quae cupit esse se sororem Nec
matremiuvatessenec	matrem iuvat esse nec
sororem.	sororem .
QuidteTuccaiuvat	Quid te Tucca iuvat
vetulomiscereFalernoIn	vetulo miscere Falerno In
Vaticaniscondita	Vaticanis condita
mustacadisQuid	musta cadis Quid
tantumfecere	tantum fecere
bonitibipessimavina	boni tibi pessima vina
AutquidfeceruntoptimavinamaliDenobis	Aut quid fecerunt optima vina mali De nobis
facileestscelusestiugulare	facile est scelus est iugulare
FalernumEtdareCampanotoxicasaevamero.Convivae	Falernum Et dare Campano toxica saeva mero . Convivae
merueretuifortasseperireAmphora	meruere tui fortasse perire Amphora
nonmeruit	non meruit
tampretiosa	tam pretiosa
CandidiusnihilestteCaeciliane.NotaviSi	Candidius nihil est te Caeciliane . Notavi Si
quandoexnostris	quando ex nostris
distichapaucalegoProtinusautMarsi	disticha pauca lego Protinus aut Marsi
recitasautscriptaCatulli.Hocmihidas	recitas aut scripta Catulli . Hoc mihi das
tamquamdeterioralegasUtconlatamagisplaceant	tamquam deteriora legas Ut conlata magis placeant
meaCredimusistudMalotamenrecitesCaecilianetua.	mea Credimus istud Malo tamen recites Caeciliane tua .
Abscisaservom	Abscisa servom
quidfigis	quid figis
PonticelinguaNescistupopulum	Pontice lingua Nescis tu populum
quodtacetilleloqui	quod tacet ille loqui
Cumtuanonedas	Cum tua non edas
carpismeacarminaLaeli.Carperevel	carpis mea carmina Laeli . Carpere vel
nolinostraveledetua.	noli nostra vel ede tua .
VirCeltiberisnontacendegentibusNostraequelausHispaniaeVidebis	Vir Celtiberis non tacende gentibus Nostraeque laus Hispaniae Videbis
altamLicinianeBilbilinEquiset	altam Liciniane Bilbilin Equis et
armisnobilemSenemqueCaiumnivibusetfractissacrumVadaveronemmontibus	armis nobilem Senemque Caium nivibus et fractis sacrum Vadaveronem montibus
EtdelicatidulceBoterdinemusPomonaquodfelix	Et delicati dulce Boterdi nemus Pomona quod felix
amat.TepidinatabisleneCongedivadumMollesqueNympharum	amat . Tepidi natabis lene Congedi vadum Mollesque Nympharum
lacusQuibusremissumcorpusadstringesbreviSalonequiferrumgelat	lacus Quibus remissum corpus adstringes brevi Salone qui ferrum gelat
.PraestabitillicipsafigendaspropeVoberca	. Praestabit illic ipsa figendas prope Voberca
prandentiferas.Aestus	prandenti feras . Aestus
serenosaureofranges	serenos aureo franges
TagoObscurusumbrisarborum;AvidamrigensDerceitaplacabit	Tago Obscurus umbris arborum ; Avidam rigens Derceita placabit
sitimEtNutha	sitim Et Nutha
quaevincitnives.AtcumDecember	quae vincit nives . At cum December
canusetbrumaimpotensAquiloneraucomugiet	canus et bruma impotens Aquilone rauco mugiet
ApricarepetesTarraconislitoraTuamqueLaletaniam.	Aprica repetes Tarraconis litora Tuamque Laletaniam .
Ibiinligatasmollibusdammasplagis	Ibi inligatas mollibus dammas plagis
MactabisetvernasaprosLeporemque	Mactabis et vernas apros Leporemque
forticallidumrumpesequo	forti callidum rumpes equo
Cervosrelinquesvilico.Vicina	Cervos relinques vilico . Vicina
inipsumsilvadescendetfocumInfantecinctum	in ipsum silva descendet focum Infante cinctum
sordido.Vocabiturvenatoret	sordido . Vocabitur venator et
veniettibiConvivaclamatusprope	veniet tibi Conviva clamatus prope
.LunatanusquampellisetnusquamtogaOlidaequevestes	. Lunata nusquam pellis et nusquam toga Olidaeque vestes
murice;Proculhorridus	murice ; Procul horridus
LiburnusetqueruluscliensImperiaviduarumprocul;Non	Liburnus et querulus cliens Imperia viduarum procul ; Non
rumpetaltumpallidussomnumreus	rumpet altum pallidus somnum reus
Sedmanetotum	Sed mane totum
dormies.Mereatur	dormies . Mereatur
aliusgrandeetinsanumsophosMisereretufeliciumVeroquefruere	alius grande et insanum sophos Miserere tu felicium Veroque fruere
nonsuperbusgaudioDumSuralaudaturtuus	non superbus gaudio Dum Sura laudatur tuus
.Noninpudentervitaquodrelicum	. Non inpudenter vita quod relicum
estpetitCumfamaquod	est petit Cum fama quod
satisesthabet.	satis est habet .
CarminaPaulusemit	Carmina Paulus emit
recitatsuacarminaPaulus	recitat sua carmina Paulus
.Namquodemaspossisiurevocaretuum	. Nam quod emas possis iure vocare tuum
NegravishesternofragresFescenniavinoPastillos	Ne gravis hesterno fragres Fescennia vino Pastillos
Cosmiluxuriosavoras	Cosmi luxuriosa voras
.Istalinuntdentesiantaculasednihilobstant	. Ista linunt dentes iantacula sed nihil obstant
Extremoructuscumreditabarathro.Quidquodolet	Extremo ructus cum redit a barathro . Quid quod olet
graviusmixtumdiapasmatevirus	gravius mixtum diapasmate virus
AtqueduplexanimaelongiusexitodorNotasergonimisfraudes	Atque duplex animae longius exit odor Notas ergo nimis fraudes
deprensaquefurtaIamtollasetsisebriasimpliciter	deprensaque furta Iam tollas et sis ebria simpliciter
NilintemptatumSeliusnillinquitinausum	Nil intemptatum Selius nil linquit inausum
Cenandumquotiensiam	Cenandum quotiens iam
videtessedomi.CurritadEuropenettePauline	videt esse domi . Currit ad Europen et te Pauline
tuosqueLaudatAchilleossedsine	tuosque Laudat Achilleos sed sine
finepedes	fine pedes
.SinihilEurope	. Si nihil Europe
fecittuncSaepta	fecit tunc Saepta
petunturSiquidPhillyridespraestetet	petuntur Si quid Phillyrides praestet et
Aesonides.Hic	Aesonides . Hic
quoquedeceptusMemphiticatempla	quoque deceptus Memphitica templa
frequentatAdsidetetcathedrismaestaiuvencatuis.Indepetit	frequentat Adsidet et cathedris maesta iuvenca tuis . Inde petit
centumpendentiatectacolumnisIllincPompeidona	centum pendentia tecta columnis Illinc Pompei dona
nemusqueduplex.	nemusque duplex .
NecFortunati	Nec Fortunati
spernitnecbalneaFaustiNecGrylli	spernit nec balnea Fausti Nec Grylli
tenebrasAeoliamque	tenebras Aeoliamque
LupiNamthermisiterumqueiterumque	Lupi Nam thermis iterumque iterumque
iterumquelavatur.	iterumque lavatur .
OmniacumfecitsedrenuentedeoLotusadEuropes	Omnia cum fecit sed renuente deo Lotus ad Europes
tepidaebuxeta	tepidae buxeta
recurritSiquisibiserumcarpatamicusiter.	recurrit Si quis ibi serum carpat amicus iter .
Perteperquetuamvectorlascivepuellam	Per te perque tuam vector lascive puellam
AdcenamSeliumturogotaurevoca.	Ad cenam Selium tu rogo taure voca .
QuaedammecupitinvideProcilleLotocandidiorpuella	Quaedam me cupit invide Procille Loto candidior puella
cycnoArgentonivelilioligustro.Sedquandamvolonocte	cycno Argento nive lilio ligustro . Sed quandam volo nocte
nigrioremFormicapicegraculo	nigriorem Formica pice graculo
cicada.IamsuspendiasaevacogitabasSinovi	cicada . Iam suspendia saeva cogitabas Si novi
beneteProcillevives	bene te Procille vives
Speromesecutuminlibellis	Spero me secutum in libellis
meistaletemperamentumutdeillisqueri	meis tale temperamentum ut de illis queri
nonpossit	non possit
quisquisdesebenesenserit	quisquis de se bene senserit
cumsalva	cum salva
infimarumquoquepersonarumreverentialudant;quae	infimarum quoque personarum reverentia ludant ; quae
adeoantiquisauctoribusdefuitutnominibus	adeo antiquis auctoribus defuit ut nominibus
nontantumverisabusisintsedetmagnis.	non tantum veris abusi sint sed et magnis .
Mihifamaviliusconstetetprobeturinme	Mihi fama vilius constet et probetur in me
novissimumingenium.Absitaiocorumnostrorum	novissimum ingenium . Absit a iocorum nostrorum
simplicitatemalignusinterpresnecepigrammata	simplicitate malignus interpres nec epigrammata
meascribatinprobefacitquiinalienolibroingeniosus	mea scribat inprobe facit qui in alieno libro ingeniosus
est.Lascivamverborumveritatem	est . Lascivam verborum veritatem
idestepigrammaton	id est epigrammaton
linguamexcusaremsi	linguam excusarem si
meumessetexemplumsic	meum esset exemplum sic
scribitCatullussicMarsussicPedo	scribit Catullus sic Marsus sic Pedo
sicGaetulicussic	sic Gaetulicus sic
quicumqueperlegitur.Si	quicumque perlegitur . Si
quistamentamambitiosetristisestut	quis tamen tam ambitiose tristis est ut
apudilluminnullapaginalatineloquifas	apud illum in nulla pagina latine loqui fas
sitpotestepistulavel	sit potest epistula vel
potiustitulocontentusesse.Epigrammataillisscribunturqui	potius titulo contentus esse . Epigrammata illis scribuntur qui
solentspectareFlorales.NonintretCatotheatrum	solent spectare Florales . Non intret Cato theatrum
meumautsiintraveritspectet.Videormihi	meum aut si intraverit spectet . Videor mihi
meoiurefacturussi	meo iure facturus si
epistulamversibuscluseroNossesiocosaedulcecum	epistulam versibus clusero Nosses iocosae dulce cum
sacrumFloraeFestosquelusus	sacrum Florae Festosque lusus
etlicentiamvolgi	et licentiam volgi
Curintheatrum	Cur in theatrum
CatoseverevenistiAnideotantumveneras	Cato severe venisti An ideo tantum veneras
utexires	ut exires
Bellushomoetmagnusvisidem	Bellus homo et magnus vis idem
CottavideriSedqui	Cotta videri Sed qui
bellushomoest	bellus homo est
Cottapusillus	Cotta pusillus
homoest.	homo est .
AspicisincomptisillumDeciane	Aspicis incomptis illum Deciane
capillisCuiusetipsetimestriste	capillis Cuius et ipse times triste
superciliumQuiloquiturCuriosadsertoresque	supercilium Qui loquitur Curios adsertoresque
CamillosNolitofronticrederenupsitheri.	Camillos Nolito fronti credere nupsit heri .
LiberhomoesnimiumdicismihiCerylesemper.	Liber homo es nimium dicis mihi Ceryle semper .
IntequidicitCeryleliberhomoest	In te qui dicit Ceryle liber homo est
Bellaesnovimusetpuellaverumest	Bella es novimus et puella verum est
Etdives	Et dives
quisenimpotestnegareSedcumtenimiumFabullalaudas	quis enim potest negare Sed cum te nimium Fabulla laudas
Necdivesnequebellanecpuellaes.	Nec dives neque bella nec puella es .
ContigerisnostrosCaesarsifortelibellosTerrarum	Contigeris nostros Caesar si forte libellos Terrarum
dominumponesupercilium.Consuevereiocosvestriquoqueferre	dominum pone supercilium . Consuevere iocos vestri quoque ferre
triumphiMateriamdictisnecpudetesse	triumphi Materiam dictis nec pudet esse
ducem.QuaThymelen	ducem . Qua Thymelen
spectasderisoremque	spectas derisoremque
LatinumIllafronteprecorcarmina	Latinum Illa fronte precor carmina
nostralegas.Innocuoscensurapotest	nostra legas . Innocuos censura potest
permitterelususLascivaestnobispagina	permittere lusus Lasciva est nobis pagina
vitaproba.	vita proba .
SextenihildebesnildebesSextefatemur	Sexte nihil debes nil debes Sexte fatemur
.DebetenimsiquissolvereSextepotest.	. Debet enim si quis solvere Sexte potest .
AservoscistegenitumblandequefaterisCumdicisdominum	A servo scis te genitum blandeque fateris Cum dicis dominum
Sosibianepatrem.	Sosibiane patrem .
Hocnemus	Hoc nemus
aeternocinerumsacravithonoriFaeniusetculti	aeterno cinerum sacravit honori Faenius et culti
iugerapulchrasoli.Hoctegiturcitorapta	iugera pulchra soli . Hoc tegitur cito rapta
suisAntullasepulchroHoceritAntullaemixtusuterque	suis Antulla sepulchro Hoc erit Antullae mixtus uterque
parens.Sicupithuncaliquismoneonesperetagellum	parens . Si cupit hunc aliquis moneo ne speret agellum
Perpetuodominisserviet	Perpetuo dominis serviet
istesuis.	iste suis .
OccurrisquotiensLupercenobis	Occurris quotiens Luperce nobis
VismittampuerumsubindedicisCuitradas	Vis mittam puerum subinde dicis Cui tradas
epigrammatonlibellumLectumquemtibiprotinusremittamNon	epigrammaton libellum Lectum quem tibi protinus remittam Non
estquodpuerumLupercevexes.Longumest	est quod puerum Luperce vexes . Longum est
sivelit	si velit
adPirumvenire	ad Pirum venire
Etscalishabitotribussedaltis.Quod	Et scalis habito tribus sed altis . Quod
quaerispropius	quaeris propius
petaslicebit.Argi	petas licebit . Argi
nempesolessubireletumContra	nempe soles subire letum Contra
Caesarisest	Caesaris est
forumtabernaScriptispostibushincetindetotisOmnis	forum taberna Scriptis postibus hinc et inde totis Omnis
utcitoperlegaspoetas.Illincmepete.	ut cito perlegas poetas . Illinc me pete .
Necroges	Nec roges
AtrectumHocnomendominusgerit	Atrectum Hoc nomen dominus gerit
tabernaeDeprimodabitalterovenidoRasumpumicepurpuraque	tabernae De primo dabit alterove nido Rasum pumice purpuraque
cultumDenaristibiquinque	cultum Denaris tibi quinque
Martialem.TantinonesaisSapisLuperce.	Martialem . Tanti non es ais Sapis Luperce .
Quodnimiogaudesnoctemproducere	Quod nimio gaudes noctem producere
vinoIgnoscovitiumGaure	vino Ignosco vitium Gaure
Catonishabes.	Catonis habes .
CarminaquodscribisMusisetApollinenulloLaudari	Carmina quod scribis Musis et Apolline nullo Laudari
debeshoc	debes hoc
CiceronishabesQuodvomis	Ciceronis habes Quod vomis
AntoniquodluxuriarisApici.Quodfellasvitiumdicmihi	Antoni quod luxuriaris Apici . Quod fellas vitium dic mihi
cuiushabes	cuius habes
Uxoremhabendamnonputat	Uxorem habendam non putat
QuirinalisCumvelithaberefilios	Quirinalis Cum velit habere filios
etinvenitQuopossitistudmorefutuitancillasDomumque	et invenit Quo possit istud more futuit ancillas Domumque
etagros	et agros
impletequitibusvernis.PaterfamiliaeverusestQuirinalis	implet equitibus vernis . Pater familiae verus est Quirinalis
Quidquidagit	Quidquid agit
RufusnihilestnisiNaeviaRufo.	Rufus nihil est nisi Naevia Rufo .
Sigaudetsifletsi	Si gaudet si flet si
tacethancloquitur.Cenatpropinat	tacet hanc loquitur . Cenat propinat
poscitnegatinnuitunaestNaevia;	poscit negat innuit una est Naevia ;
sinonsit	si non sit
Naeviamutuserit	Naevia mutus erit
.Scriberethesternapatricum	. Scriberet hesterna patri cum
lucesalutem	luce salutem
NaevialuxinquitNaevialumen	Naevia lux inquit Naevia lumen
have.HaeclegitetridetdemissoNaevia	have . Haec legit et ridet demisso Naevia
voltu.Naevianonunaestquidvir	voltu . Naevia non una est quid vir
ineptefuris	inepte furis
CretadeditmagnummaiusdeditAfricanomenScipioquodvictor	Creta dedit magnum maius dedit Africa nomen Scipio quod victor
quodqueMetellushabet;Nobilius	quodque Metellus habet ; Nobilius
domitotribuitGermaniaRhenoEtpuerhocdignusnomineCaesar	domito tribuit Germania Rheno Et puer hoc dignus nomine Caesar
eras.FraterIdumaeosmeruitcumpatretriumphosQuae	eras . Frater Idumaeos meruit cum patre triumphos Quae
daturexChattislaureatota	datur ex Chattis laurea tota
Hesternafactum	Hesterna factum
narraturPostumecenaQuodnollemquis	narratur Postume cena Quod nollem quis
enimtaliafactaprobetOstibipercisumquantonon	enim talia facta probet Os tibi percisum quanto non
ipseLatinusVilia	ipse Latinus Vilia
PanniculipercutitorasonoQuodquemagismirum	Panniculi percutit ora sono Quodque magis mirum
estauctoremcriminis	est auctorem criminis
huiusCaeciliumtotarumorinurbe	huius Caecilium tota rumor in urbe
sonat.Essenegasfactumvishocmecredere	sonat . Esse negas factum vis hoc me credere
credo.Quidquod	credo . Quid quod
habettestesPostumeCaecilius	habet testes Postume Caecilius
HicestquemlegisillequemrequirisTotonotus	Hic est quem legis ille quem requiris Toto notus
inorbeMartialisArgutis	in orbe Martialis Argutis
epigrammatonlibellisCuilector	epigrammaton libellis Cui lector
studiosequoddedistiViventidecusatquesentientiRari	studiose quod dedisti Viventi decus atque sentienti Rari
postcinereshabentpoetae.	post cineres habent poetae .
UxoremnoloTelesinam	Uxorem nolo Telesinam
ducerequareMoechaest	ducere quare Moecha est
.Sedpuerisdat	. Sed pueris dat
Telesina.Volo.	Telesina . Volo .
BasiadasaliisaliisdasPostumedextram	Basia das aliis aliis das Postume dextram
.DicisUtrummaviselige.Malomanum.	. Dicis Utrum mavis elige . Malo manum .
Cumdixificus	Cum dixi ficus
ridesquasi	rides quasi
barbaraverbaEtdici	barbara verba Et dici
ficosLaetilianeiubes.Dicemusficusquasscimusin	ficos Laetiliane iubes . Dicemus ficus quas scimus in
arborenasciDicemusficosCaecilianetuos.	arbore nasci Dicemus ficos Caeciliane tuos .
CuilegissesatisnonestepigrammatacentumNililli	Cui legisse satis non est epigrammata centum Nil illi
satisestCaedicianemali	satis est Caediciane mali
QuodquerulumspiratquodacerbumNaeviatussitInquetuos	Quod querulum spirat quod acerbum Naevia tussit Inque tuos
mittitsputasubindesinusIamteremfactamBithynicecredis	mittit sputa subinde sinus Iam te rem factam Bithynice credis
habereErrasblanditurNaevia	habere Erras blanditur Naevia
nonmoritur.	non moritur .
Siquiserit	Si quis erit
rarosinternumerandusamicosQualesprisca	raros inter numerandus amicos Quales prisca
fidesfamaquenovitanusSiquisCecropiaemadidusLatiaeque	fides famaque novit anus Si quis Cecropiae madidus Latiaeque
MinervaeArtibus	Minervae Artibus
etverasimplicitatebonusSiquiseritrecticustosmirator	et vera simplicitate bonus Si quis erit recti custos mirator
honestiEtnihilarcanoqui	honesti Et nihil arcano qui
rogetoredeosSiquis	roget ore deos Si quis
eritmagnaesubnixusroborementisDispereamsinonhic	erit magnae subnixus robore mentis Dispeream si non hic
Decianuserit.	Decianus erit .
Alcimequemraptumdomino	Alcime quem raptum domino
crescentibusannisLabicanalevicaespitevelathumusAccipenonPario	crescentibus annis Labicana levi caespite velat humus Accipe non Pario
nutantiaponderasaxoQuaecinerivanusdatruituralabor	nutantia pondera saxo Quae cineri vanus dat ruitura labor
SedfacilesbuxosetopacaspalmitisumbrasQuaequevirentlacrimis	Sed faciles buxos et opacas palmitis umbras Quaeque virent lacrimis
roscidapratameisAccipe	roscida prata meis Accipe
carepuernostrimonimentadolorisHictibiperpetuo	care puer nostri monimenta doloris Hic tibi perpetuo
temporevivethonor.CummihisupremosLachesis	tempore vivet honor . Cum mihi supremos Lachesis
perveneritannosNonalitercineresmandoiaceremeos	pervenerit annos Non aliter cineres mando iacere meos
Veronadoctisyllabasamat	Verona docti syllabas amat
vatisMaronefelixMantuaest	vatis Marone felix Mantua est
CenseturAponiLiviosuotellusStellaquenec	Censetur Aponi Livio suo tellus Stellaque nec
FlaccominusApollodoroplauditimbriferNilusNasonePaelignisonantDuosque	Flacco minus Apollodoro plaudit imbrifer Nilus Nasone Paeligni sonant Duosque
SenecasunicumqueLucanumFacundaloquiturCorduba	Senecas unicumque Lucanum Facunda loquitur Corduba
GaudentiocosaeCaniosuoGadesEmeritaDecianomeoTe	Gaudent iocosae Canio suo Gades Emerita Deciano meo Te
Licinianegloriabiturnostra	Liciniane gloriabitur nostra
NecmetacebitBilbilis.	Nec me tacebit Bilbilis .
LaxiorhexaphoristuasitlecticalicebitCum	Laxior hexaphoris tua sit lectica licebit Cum
tamenhaectuasit	tamen haec tua sit
Zoilesandapila	Zoile sandapila
QuodmagniThraseaeconsummatiqueCatonisDogmatasicsequerissalvosut	Quod magni Thraseae consummatique Catonis Dogmata sic sequeris salvos ut
essevelisPectorenecnudostrictosincurrisinensisQuod	esse velis Pectore nec nudo strictos incurris in ensis Quod
fecissevelimteDecianefacis.Nolovirum	fecisse velim te Deciane facis . Nolo virum
faciliredimitquisanguinefamamHunc	facili redimit qui sanguine famam Hunc
vololaudariquisine	volo laudari qui sine
mortepotest.	morte potest .
ArgentilibrasMariustibiquinquereliquitCuinihilipse	Argenti libras Marius tibi quinque reliquit Cui nihil ipse
dabashictibiverbadedit	dabas hic tibi verba dedit
LaeviasexcyathisseptemIustinabibaturQuinque	Laevia sex cyathis septem Iustina bibatur Quinque
LycasLydequattuorIdatribus	Lycas Lyde quattuor Ida tribus
.Omnisab	. Omnis ab
infusonumereturamicaFalernoEtquianullavenittu	infuso numeretur amica Falerno Et quia nulla venit tu
mihiSomneveni.	mihi Somne veni .
CurtristioremcernimusSaleianumAn	Cur tristiorem cernimus Saleianum An
causalevisestinquisextuliuxorem.	causa levis est inquis extuli uxorem .
Ograndefaticrimeno	O grande fati crimen o
gravemcasumIlla	gravem casum Illa
illadivesmortua	illa dives mortua
estSecundilla	est Secundilla
Centenadeciesquae	Centena decies quae
tibideditdotisNollemaccidissethoctibiSaleiane	tibi dedit dotis Nollem accidisset hoc tibi Saleiane
DimidiumdonareLinoquamcrederetotumQui	Dimidium donare Lino quam credere totum Qui
mavoltmavoltperderedimidium.	mavolt mavolt perdere dimidium .
Captotuam	Capto tuam
pudetheusedcaptoMaximecenamTucaptas	pudet heu sed capto Maxime cenam Tu captas
aliamiam	aliam iam
sumusergopares.Manesalutatumveniotudiceris	sumus ergo pares . Mane salutatum venio tu diceris
isseAntesalutatumiamsumusergopares.Sum	isse Ante salutatum iam sumus ergo pares . Sum
comesipsetuustumidique	comes ipse tuus tumidique
anteambuloregisTucomesalteriusiamsumusergopares	anteambulo regis Tu comes alterius iam sumus ergo pares
.Essesatestservumiamnolovicariusesse.	. Esse sat est servum iam nolo vicarius esse .
Quirexestregem	Qui rex est regem
Maximenon	Maxime non
PulchrevaletCharinusettamenpallet.ParcebibitCharinus	Pulchre valet Charinus et tamen pallet . Parce bibit Charinus
ettamenpallet.Beneconcoquit	et tamen pallet . Bene concoquit
Charinuset	Charinus et
tamenpallet.SoleutiturCharinusettamen	tamen pallet . Sole utitur Charinus et tamen
pallet.TingitcutemCharinusettamenpallet.	pallet . Tingit cutem Charinus et tamen pallet .
CunnumCharinuslingit	Cunnum Charinus lingit
ettamen	et tamen
RufevidesillumsubselliaprimaterentemCuiusethinc	Rufe vides illum subsellia prima terentem Cuius et hinc
lucetsardonychata	lucet sardonychata
manusQuaeque	manus Quaeque
Tyrontotiensepotavere	Tyron totiens epotavere
lacernaeEt	lacernae Et
toganontactasvincereiussanives	toga non tactas vincere iussa nives
Cuiusolettotopinguiscoma	Cuius olet toto pinguis coma
MarcellanoEt	Marcellano Et
splendentvolsobracchiatritapiloNonhesternasedet	splendent volso bracchia trita pilo Non hesterna sedet
lunatalingulaplantaCoccinanonlaesumpingitaluta	lunata lingula planta Coccina non laesum pingit aluta
pedemEtnumerosalinuntstellantemspleniafrontem.Ignorasquid	pedem Et numerosa linunt stellantem splenia frontem . Ignoras quid
sitspleniatolleleges.	sit splenia tolle leges .
Primusubiestinquiscumsit	Primus ubi est inquis cum sit
liberistesecundusQuidfaciamsiplus	liber iste secundus Quid faciam si plus
illepudorishabetTutamenhuncfierisimavis	ille pudoris habet Tu tamen hunc fieri si mavis
ReguleprimumUnumdetitulo	Regule primum Unum de titulo
tollereiotapotes.	tollere iota potes .
Mutuavigintisestertiaforterogabam	Mutua viginti sestertia forte rogabam
Quaeveldonantinongrave	Quae vel donanti non grave
munuserat.Quipperogabatur	munus erat . Quippe rogabatur
felixquevetusquesodalisEtcuiuslaxasarcaflagellat	felixque vetusque sodalis Et cuius laxas arca flagellat
opes.IsmihiDiveseris	opes . Is mihi Dives eris
sicausasegerisinquit.Quod	si causas egeris inquit . Quod
petodaGainon	peto da Gai non
petoconsilium.	peto consilium .
Utrecitem	Ut recitem
tibinostra	tibi nostra
rogasepigrammata	rogas epigrammata
.Nolo.Non	. Nolo . Non
audireCelersedrecitarecupis.	audire Celer sed recitare cupis .
TonstrixSuburaefaucibus	Tonstrix Suburae faucibus
sedetprimisCruentapendent	sedet primis Cruenta pendent
quaflagellatortorumArgiqueletummultusobsidetsutor.Sed	qua flagella tortorum Argique letum multus obsidet sutor . Sed
istatonstrixAmmianenontondet	ista tonstrix Ammiane non tondet
Nontondetinquam.Quid	Non tondet inquam . Quid
igiturfacitRadit.	igitur facit Radit .
RidesisapisopuellaridePaelignusputo	Ride si sapis o puella ride Paelignus puto
dixeratpoeta.	dixerat poeta .
Sednondixerat	Sed non dixerat
omnibuspuellis.VerumutdixeritomnibuspuellisNon	omnibus puellis . Verum ut dixerit omnibus puellis Non
dixittibi	dixit tibi
tupuella	tu puella
nonesEttressunttibi	non es Et tres sunt tibi
MaximinadentesSed	Maximina dentes Sed
planepiceiquebuxeique.Quare	plane piceique buxeique . Quare
sispeculomihique	si speculo mihique
credisDebesnonalitertimererisumQuamventumSpaniusmanumque	credis Debes non aliter timere risum Quam ventum Spanius manumque
PriscusQuamcretatatimet	Priscus Quam cretata timet
FabullanimbumCerussatatimetSabellasolem.Voltusinduetu	Fabulla nimbum Cerussata timet Sabella solem . Voltus indue tu
magisseverosQuamconiunxPriaminurusquemaior.Mimosridiculi	magis severos Quam coniunx Priami nurusque maior . Mimos ridiculi
PhilistionisEtconvivia	Philistionis Et convivia
nequioravitaEtquidquidlepidaprocacitateLaxatperspicuo	nequiora vita Et quidquid lepida procacitate Laxat perspicuo
labellarisu.	labella risu .
Temaestaedecetadsiderematri	Te maestae decet adsidere matri
LugentivevirumpiumvefratremEttantum	Lugentive virum piumve fratrem Et tantum
tragicisvacareMusis.At	tragicis vacare Musis . At
tuiudiciumsecutanostrumPlora	tu iudicium secuta nostrum Plora
sisapisopuellaplora.	si sapis o puella plora .
DotibinaumachiamtudasepigrammatanobisVisputo	Do tibi naumachiam tu das epigrammata nobis Vis puto
cumlibroMarcenataretuo.	cum libro Marce natare tuo .
Nonvisin	Non vis in
soliopriuslavariQuemquamCotilecausaquaenisihaec	solio prius lavari Quemquam Cotile causa quae nisi haec
estUndis	est Undis
nefovearisirrumatisPrimuste	ne fovearis irrumatis Primus te
licetabluasnecesseestAntehicmentulaquamcaputlavetur	licet abluas necesse est Ante hic mentula quam caput lavetur
QuemrecitasmeusestoFidentine	Quem recitas meus est o Fidentine
libellusSedmale	libellus Sed male
cumrecitasincipitessetuus.	cum recitas incipit esse tuus .
NatorummihiiustriumrogantiMusarumpretium	Natorum mihi ius trium roganti Musarum pretium
deditmearumSolusquipoterat.	dedit mearum Solus qui poterat .
Valebisuxor.Nondebetdominiperire	Valebis uxor . Non debet domini perire
Essequidhoc	Esse quid hoc
dicamquodolenttuabasiamurramQuodque	dicam quod olent tua basia murram Quodque
tibiestnumquamnonalienus	tibi est numquam non alienus
odorHocmihisuspectumest	odor Hoc mihi suspectum est
quodolesbenePostumesemper	quod oles bene Postume semper
Postumenonbene	Postume non bene
oletquibenesemper	olet qui bene semper
Quaetibinon	Quae tibi non
stabatpraecisaestmentulaGlypte.	stabat praecisa est mentula Glypte .
DemenscumferroquidtibiGalluseras.	Demens cum ferro quid tibi Gallus eras .
Cumtenon	Cum te non
nossemdominumregemquevocabamNuncbenetenoviiam	nossem dominum regemque vocabam Nunc bene te novi iam
mihiPriscuseris.	mihi Priscus eris .
Errasmeorum	Erras meorum
furavarelibrorumFieripoetampossequiputas	fur avare librorum Fieri poetam posse qui putas
tantiScripturaquanticonstetettomusvilisNon	tanti Scriptura quanti constet et tomus vilis Non
sexparaturautdecemsophosnummis.Secretaquaere	sex paratur aut decem sophos nummis . Secreta quaere
carminaetrudescurasQuasnovitunusscrinioquesignatasCustodit	carmina et rudes curas Quas novit unus scrinioque signatas Custodit
ipsevirginispaterchartaeQuae	ipse virginis pater chartae Quae
tritadurononinhorruit	trita duro non inhorruit
mento.Mutare	mento . Mutare
dominumnonpotest	dominum non potest
libernotus.Sedpumicatafrontesiquisestnondum	liber notus . Sed pumicata fronte si quis est nondum
Necumbiliciscultusatque	Nec umbilicis cultus atque
membranaMercaretaleshabeo;necscietquisquam.Aliena	membrana Mercare tales habeo ; nec sciet quisquam . Aliena
quisquisrecitatetpetitfamamNonemerelibrumsed	quisquis recitat et petit famam Non emere librum sed
silentiumdebet	silentium debet
ZoilequidsoliumsublutopodiceperdisSpurciusutfiatZoile	Zoile quid solium subluto podice perdis Spurcius ut fiat Zoile
mergecaput.	merge caput .
UnaestinnostristuaFidentinelibellisPaginasedcerta	Una est in nostris tua Fidentine libellis Pagina sed certa
dominisignatafiguraQuaetuatraducit	domini signata figura Quae tua traducit
manifestocarminafurto.Sicinterpositus	manifesto carmina furto . Sic interpositus
villocontaminatunctoUrbicaLingonicusTyrianthinabardocucullusSicArretinaeviolant	villo contaminat uncto Urbica Lingonicus Tyrianthina bardocucullus Sic Arretinae violant
crystallinatestaeSicnigerinripiserratcumforte	crystallina testae Sic niger in ripis errat cum forte
CaystriInterLedaeosridetur	Caystri Inter Ledaeos ridetur
corvusoloresSicubimultisonafervetsacerAtthidelucusInproba	corvus olores Sic ubi multisona fervet sacer Atthide lucus Inproba
Cecropiasoffenditpicaquerellas.Indicenonopusestnostris	Cecropias offendit pica querellas . Indice non opus est nostris
neciudicelibrisStatcontradicitquetibi	nec iudice libris Stat contra dicitque tibi
tuapaginaFures.	tua pagina Fur es .
Quiducisvultusetnonlegisista	Qui ducis vultus et non legis ista
libenterOmnibusinvideaslividenemotibi.	libenter Omnibus invideas livide nemo tibi .
InterponisaquamsubindeRufeEtsi	Interponis aquam subinde Rufe Et si
cogerisasodaleraram	cogeris a sodale raram
DilutibibisunciamFalerni.Numquidpollicita	Diluti bibis unciam Falerni . Numquid pollicita
esttibibeatamNoctem	est tibi beatam Noctem
NaeviasobriasquemavisCertaenequitiasfututionisSuspirasreticesgemis	Naevia sobriasque mavis Certae nequitias fututionis Suspiras retices gemis
negavit.Crebros	negavit . Crebros
ergolicetbibastrientesEtdurum	ergo licet bibas trientes Et durum
iugulesmerodolorem.QuidparcistibiRufe	iugules mero dolorem . Quid parcis tibi Rufe
dormiendumest.	dormiendum est .
Vimineclausalevi	Vimine clausa levi
niveaecustodiacoctaeHoctibiSaturnitemporemunus	niveae custodia coctae Hoc tibi Saturni tempore munus
erit.Donaquodaestatismisi	erit . Dona quod aestatis misi
tibimense	tibi mense
DecembriSiquererisrasamtumihimittetogam.	Decembri Si quereris rasam tu mihi mitte togam .
Dicmihiquis	Dic mihi quis
furorestturbaspectantevocataSolusboletos	furor est turba spectante vocata Solus boletos
Caecilianevoras.Quiddignumtantotibi	Caeciliane voras . Quid dignum tanto tibi
ventregulaqueprecaborBoletumqualemClaudiuseditedas.	ventre gulaque precabor Boletum qualem Claudius edit edas .
QuidmihivobiscumestoPhoebe	Quid mihi vobiscum est o Phoebe
novemquesororesEcce	novemque sorores Ecce
nocetvatiMusa	nocet vati Musa
iocosasuo	iocosa suo
.DimidionobisdarePostumusante	. Dimidio nobis dare Postumus ante
solebatBasianunclabro	solebat Basia nunc labro
coepitutroque	coepit utroque
SextilianebibisquantumsubselliaquinqueSolusaqua	Sextiliane bibis quantum subsellia quinque Solus aqua
totiensebriusessepotes;Necconsessorumvicinanomismata	totiens ebrius esse potes ; Nec consessorum vicina nomismata
tantumAerasedacuneisulteriora	tantum Aera sed a cuneis ulteriora
petis.NonhaecPaelignisagitur	petis . Non haec Paelignis agitur
vindemiaprelisUvanecinTuscisnascitur	vindemia prelis Uva nec in Tuscis nascitur
istaiugis	ista iugis
Testasedantiquifelixsiccatur	Testa sed antiqui felix siccatur
OpimiEgeritetnigrosMassicacella	Opimi Egerit et nigros Massica cella
cados.AcoponetibifaexLaletanapetaturSi	cados . A copone tibi faex Laletana petatur Si
plusquamdeciesSextilianebibis	plus quam decies Sextiliane bibis
Floridapervariosut	Florida per varios ut
pingiturHyblacoloresCumbreveSicaniaeverpopulantur	pingitur Hybla colores Cum breve Sicaniae ver populantur
apesSictuasubpositisconlucentprelalacernisSicmicat	apes Sic tua subpositis conlucent prela lacernis Sic micat
innumerisarculasynthesibusAtque	innumeris arcula synthesibus Atque
unamvestiretribum	unam vestire tribum
tuacandidapossuntApula	tua candida possunt Apula
nonunoquae	non uno quae
gregeterratulit	grege terra tulit
.TuspectashiememsuccinctilentusamiciProscelus	. Tu spectas hiemem succincti lentus amici Pro scelus
etlaterisfrigoratritatimes.	et lateris frigora trita times .
QuantumeratinfelixpannisfraudareduobusQuidmetuis	Quantum erat infelix pannis fraudare duobus Quid metuis
nonteNaevole	non te Naevole
sedtineas	sed tineas
Esttibisitqueprecormultos	Est tibi sitque precor multos
crescatqueperannosPulchraquidemverumtranstiberinadomusAt	crescatque per annos Pulchra quidem verum transtiberina domus At
meaVipsanasspectantcenaculalaurusFactus	mea Vipsanas spectant cenacula laurus Factus
inhacegosumiamregionesenex.Migrandumest	in hac ego sum iam regione senex . Migrandum est
utmanedomiteGalle	ut mane domi te Galle
salutemEsttantivelsilongiusillaforet	salutem Est tanti vel si longius illa foret
.Sedtibi	. Sed tibi
nonmultumestunumsipraesto	non multum est unum si praesto
togatumMultumesthuncunumsimihiGallenego.	togatum Multum est hunc unum si mihi Galle nego .
Ipsesalutabodecumatesaepius	Ipse salutabo decuma te saepius
horaManetibipromedicethavere	hora Mane tibi pro me dicet havere
QualemFlaccevelimquaerisnolimvepuellam	Qualem Flacce velim quaeris nolimve puellam
Nolonimis	Nolo nimis
facilemdifficilemquenimis.	facilem difficilemque nimis .
IlludquodmediumestatqueinterutrumqueprobamusNecvolo	Illud quod medium est atque inter utrumque probamus Nec volo
quodcruciatnec	quod cruciat nec
voloquodsatiat.	volo quod satiat .
IntresamplalicettorvilepusoraleonisEssetamenvacuo	Intres ampla licet torvi lepus ora leonis Esse tamen vacuo
seleodenteputat.Quodruetin	se leo dente putat . Quod ruet in
tergumvelquosprocumbet	tergum vel quos procumbet
inarmos	in armos
Altaiuvencorumvolnera	Alta iuvencorum volnera
figetubiQuidfrustranemorumdominumregemquefatigasNon	figet ubi Quid frustra nemorum dominum regemque fatigas Non
nisidelectapasciturillefera.	nisi delecta pascitur ille fera .
QuodpectusquodcruratibiquodbracchiavellisQuodcincta	Quod pectus quod crura tibi quod bracchia vellis Quod cincta
estbrevibusmentulatonsapilisHocpraestasLabienetuaequis	est brevibus mentula tonsa pilis Hoc praestas Labiene tuae quis
nescitamicae.CuipraestasculumquodLabiene	nescit amicae . Cui praestas culum quod Labiene
SportulaCane	Sportula Cane
tibisupremanoctepetitaestOcciditputoteCane	tibi suprema nocte petita est Occidit puto te Cane
quodunafuit.	quod una fuit .
Dicisamoretui	Dicis amore tui
bellasarderepuellasQuifaciemsubaqua	bellas ardere puellas Qui faciem sub aqua
Sextenatantishabes	Sexte natantis habes
ContinuisvexatamadetvindemianimbisNonpotesut	Continuis vexata madet vindemia nimbis Non potes ut
cupiasvenderecopomerum.	cupias vendere copo merum .
QuodtenomineiamtuosalutoQuemregemetdominum	Quod te nomine iam tuo saluto Quem regem et dominum
priusvocabamNemedixerisessecontumacemTotis	prius vocabam Ne me dixeris esse contumacem Totis
pilleasarcinisredemi.Reges	pillea sarcinis redemi . Reges
etdominoshaberedebetQuise	et dominos habere debet Qui se
nonhabetatqueconcupiscitQuodregesdominique	non habet atque concupiscit Quod reges dominique
concupiscunt.Servom	concupiscunt . Servom
sipotes	si potes
OlenonhabereEtregempotesOlenon	Ole non habere Et regem potes Ole non
habere.	habere .
NonplenummodovicieshabebasSedtamprodigus	Non plenum modo vicies habebas Sed tam prodigus
atqueliberalisEt	atque liberalis Et
tamlautuserasCalene	tam lautus eras Calene
utomnes	ut omnes
Optarenttibicentiesamici.Auditvotadeus	Optarent tibi centies amici . Audi t vota deus
precesquenostrasAtqueintraputoseptimasKalendasMorteshoctibi	precesque nostras Atque intra puto septimas Kalendas Mortes hoc tibi
quattuordederunt.Attusicquasinonforet	quattuor dederunt . At tu sic quasi non foret
relictumSedraptumtibicentiesabistiIntantammiser	relictum Sed raptum tibi centies abisti In tantam miser
esuritionemUtconviviasumptuosioraTotoquae	esuritionem Ut convivia sumptuosiora Toto quae
semelapparasinannoNigraesordibusexplicesmonetaeEtseptem	semel apparas in anno Nigrae sordibus explices monetae Et septem
veterestuisodales	veteres tui sodales
Constemustibiplumbeaselibra.Quiddignummeritisprecemur	Constemus tibi plumbea selibra . Quid dignum meritis precemur
istisOptamustibimiliesCalene.Hoc	istis Optamus tibi milies Calene . Hoc
sicontigeritfameperibis.	si contigerit fame peribis .
VentrisonusmiseronectepudetexcipisauroBasse	Ventris onus misero nec te pudet excipis auro Basse
bibisvitrocariusergocacas	bibis vitro carius ergo cacas
Zoilusaegrotatfaciunthancstragulafebrem.Si	Zoilus aegrotat faciunt hanc stragula febrem . Si
fueritsanuscoccinaquidfacient	fuerit sanus coccina quid facient
QuidtorusaNiloquidSidone	Quid torus a Nilo quid Sidone
tinctusolenti	tinctus olenti
Ostenditstultasquidnisi	Ostendit stultas quid nisi
morbusopesQuidtibi	morbus opes Quid tibi
cummedicis	cum medicis
dimitteMachaonasomnis.Visfierisanus	dimitte Machaonas omnis . Vis fieri sanus
stragulasumemea	stragula sume mea
NonamoteSabidinecpossumdicerequareHoctantum	Non amo te Sabidi nec possum dicere quare Hoc tantum
possumdicerenonamote.	possum dicere non amo te .
Quodclamassemperquodagentibus	Quod clamas semper quod agentibus
obstrepisAeliNonfacishocgratisaccipisuttaceas.	obstrepis Aeli Non facis hoc gratis accipis ut taceas .
Visfieri	Vis fieri
libermentirisMaximenonvisSedfierisivishac	liber mentiris Maxime non vis Sed fieri si vis hac
rationepotes.Libereriscenareforissi	ratione potes . Liber eris cenare foris si
MaximenolisVeientanatuamsidomatuvasitim	Maxime nolis Veientana tuam si domat uva sitim
SiriderepotesmiserichrysendetaCinnaeContentusnostrasipotes	Si ridere potes miseri chrysendeta Cinnae Contentus nostra si potes
essetogaSi	esse toga Si
plebeiaVenusgeminotibivinciturasse	plebeia Venus gemino tibi vincitur asse
Situanonrectustectasubirepotes.	Si tua non rectus tecta subire potes .
HaectibisivisestsimentistantapotestasLiberior	Haec tibi si vis est si mentis tanta potestas Liberior
Parthovivereregepotes.	Partho vivere rege potes .
ScriberemequererisVeloxepigrammatalonga.Ipsenihilscribis	Scribere me quereris Velox epigrammata longa . Ipse nihil scribis
tubreviorafacis.	tu breviora facis .
VisteSextecolivolebam	Vis te Sexte coli volebam
amare.Parendum	amare . Parendum
esttibiquodiubescolerisSedsitecolo	est tibi quod iubes coleris Sed si te colo
Sextenonamabo.	Sexte non amabo .
Inuncederemeiubelibellos.Lectisvixtibi	I nunc edere me iube libellos . Lectis vix tibi
paginisduabusSpectaseschatocollionSevereEtlongastrahisoscitationes.	paginis duabus Spectas eschatocollion Severe Et longas trahis oscitationes .
HaecsuntquaerelegentemesolebasRaptaexscribere	Haec sunt quae relegente me solebas Rapta exscribere
sedVitellianisHaecsuntsingulaquaesinuferebas	sed Vitellianis Haec sunt singula quae sinu ferebas
PerconviviacunctapertheatraHaec	Per convivia cuncta per theatra Haec
suntautmeliorasiquanescis.Quidprodest	sunt aut meliora si qua nescis . Quid prodest
mihitammacerlibellusNullocrassior	mihi tam macer libellus Nullo crassior
utsitumbilico	ut sit umbilico
SitotustibitriduolegaturNumquamdeliciae	Si totus tibi triduo legatur Numquam deliciae
supiniores.Lassustamcitodeficis	supiniores . Lassus tam cito deficis
viatorEtcumcurreredebeasBovillasInteriungerequaeris	viator Et cum currere debeas Bovillas Interiungere quaeris
adCamenasI	ad Camenas I
nuncederemeiubelibellos	nunc edere me iube libellos
QuintilianevagaemoderatorsummeiuventaeGloriaRomanaeQuintiliane	Quintiliane vagae moderator summe iuventae Gloria Romanae Quintiliane
togaeViverequodproperopaupernecinutilisannisDa	togae Vivere quod propero pauper nec inutilis annis Da
veniamproperatvivere	veniam properat vivere
nemosatis.Differat	nemo satis . Differat
hocpatrios	hoc patrios
optatquivincerecensus	optat qui vincere census
Atriaqueinmodicisartatimaginibus.Mefocusetnigrosnon	Atriaque inmodicis artat imaginibus . Me focus et nigros non
indignantiafumosTectaiuvant	indignantia fumos Tecta iuvant
etfonsvivosetherbarudis.Sitmihi	et fons vivos et herba rudis . Sit mihi
vernasatursit	verna satur sit
nondoctissimaconiunxSitnoxcum	non doctissima coniunx Sit nox cum
somnositsinelite	somno sit sine lite
CumdicisProperofacsifacisHedylelanguet	Cum dicis Propero fac si facis Hedyle languet
ProtinusetcessatdebilitataVenus.Expectare	Protinus et cessat debilitata Venus . Expectare
iubevelociusiboretentus.Hedyle	iube velocius ibo retentus . Hedyle
siproperasdic	si properas dic
mihineproperem	mihi ne properem
MoechuseratpoterastamenhoctuPaulanegare	Moechus erat poteras tamen hoc tu Paula negare
.EccevirestnumquidPaulanegarepotes	. Ecce vir est numquid Paula negare potes
Quodnumquammaribus	Quod numquam maribus
iunctamteBassavidebamQuodque	iunctam te Bassa videbam Quodque
tibimoechum	tibi moechum
fabulanulladabatOmnesedofficium	fabula nulla dabat Omne sed officium
circatesemperobibatTurbatui	circa te semper obibat Turba tui
sexusnonadeunteviroEssevidebaris	sexus non adeunte viro Esse videbaris
fateorLucretianobisAt	fateor Lucretia nobis At
tuprofacinusBassa	tu pro facinus Bassa
fututoreras.Inter	fututor eras . Inter
segeminosaudescommitterecunnosMentiturquevirumprodigiosa	se geminos audes committere cunnos Mentiturque virum prodigiosa
Venus.CommentaesdignumThebanoaenigmate	Venus . Commenta es dignum Thebano aenigmate
monstrumHicubivirnonest	monstrum Hic ubi vir non est
utsitadulterium.	ut sit adulterium .
Cumpeteret	Cum peteret
regemdeceptasatellitedextraIngessitsacrisseperiturafocis	regem decepta satellite dextra Ingessit sacris se peritura focis
.Sedtamsaevapiusmiraculanontulit	. Sed tam saeva pius miracula non tulit
hostisEtraptumflammisiussitabire	hostis Et raptum flammis iussit abire
virumUrerequampotuitcontemptoMuciusigneHanc	virum Urere quam potuit contempto Mucius igne Hanc
spectaremanumPorsenanonpotuit.	spectare manum Porsena non potuit .
MaiordeceptaefamaestetgloriadextraeSinonerrasset	Maior deceptae fama est et gloria dextrae Si non errasset
feceratillaminus.	fecerat illa minus .
Unussaepe	Unus saepe
tibitotadenariusarcaCumsitethic	tibi tota denarius arca Cum sit et hic
culotritior	culo tritior
HylletuoNontamenhuncpistornonauferethunctibi	Hylle tuo Non tamen hunc pistor non auferet hunc tibi
copoSedsiquis	copo Sed si quis
nimiopenesuperbuserit.Infelixventerspectatconvivia	nimio pene superbus erit . Infelix venter spectat convivia
culiEtsemper	culi Et semper
miserhicesuritillevorat.	miser hic esurit ille vorat .
Flecterete	Flectere te
nolimsednecturbare	nolim sed nec turbare
capillos;Splendidasitnolosordida	capillos ; Splendida sit nolo sordida
nolocutis;Nec	nolo cutis ; Nec
tibimitrarumnecsittibibarbareorumNolovirum	tibi mitrarum nec sit tibi barba reorum Nolo virum
nimiumPannychenolo	nimium Pannyche nolo
parum.Nuncsuntcrurapilis	parum . Nunc sunt crura pilis
etsunttibipectorasaetisHorridasedmens	et sunt tibi pectora saetis Horrida sed mens
estPannychevolsatibi.	est Pannyche volsa tibi .
Cumdatasint	Cum data sint
equitibisquinanomismata	equiti bis quina nomismata
quareBis	quare Bis
deciessolusSextilianebibisIamdefecisset	decies solus Sextiliane bibis Iam defecisset
portantiscaldaministrosSinonpotares	portantis calda ministros Si non potares
Sextilianemerum.	Sextiliane merum .
ArgiletanasmavishabitaretabernasCumtibiparveliber	Argiletanas mavis habitare tabernas Cum tibi parve liber
scrinianostravacent.Nescisheunescisdominae	scrinia nostra vacent . Nescis heu nescis dominae
fastidiaRomaeCredemihinimiumMartia	fastidia Romae Crede mihi nimium Martia
turbasapit.Maioresnusquam	turba sapit . Maiores nusquam
rhonchiiuvenesque	rhonchi iuvenesque
senesqueEtpuerinasumrhinocerotishabent.	senesque Et pueri nasum rhinocerotis habent .
AudieriscumgrandesophosdumbasiaiactasIbisab	Audieris cum grande sophos dum basia iactas Ibis ab
excussomissusinastrasago.Sedtu	excusso missus in astra sago . Sed tu
netotiensdominipatiare	ne totiens domini patiare
liturasNevenotetlusus	lituras Neve notet lusus
tristisharundotuosAetheriaslascivecupisvolitareperaurasI	tristis harundo tuos Aetherias lascive cupis volitare per auras I
fuge;sedpoteras	fuge ; sed poteras
tutioressedomi.	tutior esse domi .
DeliciasCaesarlususqueiocosque	Delicias Caesar lususque iocosque
leonumVidimus	leonum Vidimus
hocetiampraestatharenatibiCumprensusblandototiensa	hoc etiam praestat harena tibi Cum prensus blando totiens a
denterediretEtperapertavaguscurreretoralepus	dente rediret Et per aperta vagus curreret ora lepus
.Undepotestavidus	. Unde potest avidus
captaeleoparcerepraedaeSedtamenesse	captae leo parcere praedae Sed tamen esse
tuusdiciturergo	tuus dicitur ergo
VadesalutatumpromeliberireiuberisAdProculi	Vade salutatum pro me liber ire iuberis Ad Proculi
nitidosofficioselares.Quaerisiterdicam	nitidos officiose lares . Quaeris iter dicam
.VicinumCastoracanaeTransibisVestae	. Vicinum Castora canae Transibis Vestae
virgineamquedomum;Inde	virgineamque domum ; Inde
sacrovenerandapetesPalatiaclivoPlurima	sacro veneranda petes Palatia clivo Plurima
quasummifulget	qua summi fulget
imagoducis.	imago ducis .
NectedetineatmiriradiatacolossiQuaeRhodium	Nec te detineat miri radiata colossi Quae Rhodium
molesvinceregaudetopus.Flecteviashac	moles vincere gaudet opus . Flecte vias hac
quamadidi	qua madidi
sunttecta	sunt tecta
LyaeiEtCybelespictostatCorybantetholus.Protinusa	Lyaei Et Cybeles picto stat Corybante tholus . Protinus a
laevaclaritibifrontePenatesAtriaqueexcelsae	laeva clari tibi fronte Penates Atriaque excelsae
suntadeundadomus	sunt adeunda domus
.Hancpetene	. Hanc pete ne
metuasfastuslimenquesuperbumNullamagistotoianuaposte	metuas fastus limenque superbum Nulla magis toto ianua poste
patetNecpropiorquamPhoebusametdoctaequesorores.	patet Nec propior quam Phoebus amet doctaeque sorores .
SidicetQuare	Si dicet Quare
nontamenipsevenit	non tamen ipse venit
SiclicetexcusesQuiaqualiacumquelegunturIstasalutatorscriberenon	Sic licet excuses Quia qualiacumque leguntur Ista salutator scribere non
Ridetomultum	Rideto multum
quiteSextille	qui te Sextille
cinaedumDixeritetdigitumporrigito	cinaedum Dixerit et digitum porrigito
medium.Sednecpedicoes	medium . Sed nec pedico es
nectuSextillefututorCaldaVetustinaenectibibucca	nec tu Sextille fututor Calda Vetustinae nec tibi bucca
placet.ExistisnihilesfateorSextillequidergo	placet . Ex istis nihil es fateor Sextille quid ergo
esNesciosed	es Nescio sed
tuscisressuperesseduas.	tu scis res superesse duas .
Cogitme	Cogit me
Titusactitare	Titus actitare
causasEtdicit	causas Et dicit
mihisaepeMagnares	mihi saepe Magna res
est.ResmagnaestTitequamfacit	est . Res magna est Tite quam facit
colonus.	colonus .
FelicemfiericredismeZoilecenaFelicem	Felicem fieri credis me Zoile cena Felicem
cenaZoiledeindetuaDebetAricinoconvivarecumbereclivo	cena Zoile deinde tua Debet Aricino conviva recumbere clivo
QuemtuafelicemZoilecenafacit	Quem tua felicem Zoile cena facit
SuntbonasuntquaedammediocriasuntmalapluraQuae	Sunt bona sunt quaedam mediocria sunt mala plura Quae
legishicaliternonfitAviteliber	legis hic aliter non fit Avite liber
Cinctumtogatispost	Cinctum togatis post
etanteSaufeiumQuantareduciRegulussoletturbaAdalta	et ante Saufeium Quanta reduci Regulus solet turba Ad alta
tonsumtemplacum	tonsum templa cum
reummisitMaternecernisinviderenolito.	reum misit Materne cernis invidere nolito .
Comitatusistesitprecortuusnumquam	Comitatus iste sit precor tuus numquam
.HosilliamicosetgregestogatorumFuficulenus	. Hos illi amicos et greges togatorum Fuficulenus
praestatet	praestat et
Faventinus.	Faventinus .
Micavocorquidsimcerniscenatio	Mica vocor quid sim cernis cenatio
parvaExmeCaesareumprospiciseccetholum.Frange	parva Ex me Caesareum prospicis ecce tholum . Frange
torospete	toros pete
vinarosascapetinguerenardoIpseiubetmortis	vina rosas cape tinguere nardo Ipse iubet mortis
tememinissedeus.	te meminisse deus .
Aetheriasaquilapuerumportanteperauras	Aetherias aquila puerum portante per auras
InlaesumtimidisunguibushaesitonusNuncsuaCaesareosexoratpraeda	Inlaesum timidis unguibus haesit onus Nunc sua Caesareos exorat praeda
leonesTutusetingentiluditinorelepus	leones Tutus et ingenti ludit in ore lepus
.QuaemaioraputasmiraculasummusutrisqueAuctoradesthaec	. Quae maiora putas miracula summus utrisque Auctor adest haec
suntCaesarisillaIovis.	sunt Caesaris illa Iovis .
SaepeegoChrestinamfutui.Detquam	Saepe ego Chrestinam futui . Det quam
benequaerisSupraquodfierinilMarianepotest	bene quaeris Supra quod fieri nil Mariane potest
Invitastuncmecum	Invitas tunc me cum
scisNasicavocasse	scis Nasica vocasse
.Excusatumhabeasmerogoceno	. Excusatum habeas me rogo ceno
QuodfellasetaquampotasnilLesbiapeccas	Quod fellas et aquam potas nil Lesbia peccas
.Quatibiparte	. Qua tibi parte
opusest	opus est
Lesbiasumisaquam.	Lesbia sumis aquam .
QuipinxitVenerem	Qui pinxit Venerem
tuamLycoriBlanditusputopictorestMinervae.	tuam Lycori Blanditus puto pictor est Minervae .
Hicquemvidetis	Hic quem videtis
gressibusvagislentumAmethystinatusmediaquisecat	gressibus vagis lentum Amethystinatus media qui secat
SaeptaQuemnonlacernisPubliusmeusvincitNon	Saepta Quem non lacernis Publius meus vincit Non
ipseCordusalphapaenulatorumQuemgrextogatussequituret	ipse Cordus alpha paenulatorum Quem grex togatus sequitur et
capillatusRecensquesellalinteisquelorisqueOppigneravit	capillatus Recensque sella linteisque lorisque Oppigneravit
modomodoadCladimensam	modo modo ad Cladi mensam
Vixoctonummisanulumundecenaret.	Vix octo nummis anulum unde cenaret .
Basiadimidioquod	Basia dimidio quod
dasmihiPostumelabroLaudo	das mihi Postume labro Laudo
licetdemashincquoquedimidium.Visdaremaius	licet demas hinc quoque dimidium . Vis dare maius
adhucet	adhuc et
inenarrabilemunusHoctibihabetotumPostumedimidium	inenarrabile munus Hoc tibi habe totum Postume dimidium
Cumclamantomnes	Cum clamant omnes
loqueristuncNaevoletantumEttepatronum	loqueris tunc Naevole tantum Et te patronum
causidicumqueputas.Hacrationepotest	causidicumque putas . Hac ratione potest
nemononessedisertus.EccetacentomnesNaevole	nemo non esse disertus . Ecce tacent omnes Naevole
dicaliquid.	dic aliquid .
Subdolafamosae	Subdola famosae
moneofugeretia	moneo fuge retia
moechaeLevioroconchisGalleCytheriacis.Confidis	moechae Levior o conchis Galle Cytheriacis . Confidis
natibusnonestpedicomaritusQuae	natibus non est pedico maritus Quae
faciatduosuntirrumataut	faciat duo sunt irrumat aut
futuit.	futuit .
VenderetexcultoscollescumpraecofacetusAtquesuburbaniiugera	Venderet excultos colles cum praeco facetus Atque suburbani iugera
pulchrasoliErrat	pulchra soli Errat
aitsiquisMarioputatessenecesseVendere	ait si quis Mario putat esse necesse Vendere
nildebet	nil debet
feneratimmomagis.Quaeratio	fenerat immo magis . Quae ratio
estigiturServosibiperdiditomnesEtpecuset	est igitur Servos ibi perdidit omnes Et pecus et
fructusnon	fructus non
amatindelocum.Quis	amat inde locum . Quis
faceretpretiumnisiqui	faceret pretium nisi qui
suaperderevellet	sua perdere vellet
OmniaSicMarionoxiushaeretager.	Omnia Sic Mario noxius haeret ager .
LaudantemSeliumcenaecumretiatenditAccipesive	Laudantem Selium cenae cum retia tendit Accipe sive
legassivepatronusagasEffectegravitercito	legas sive patronus agas Effecte graviter cito
nequitereuge	nequiter euge
beateHocvoluiFactaest	beate Hoc volui Facta est
iamtibi	iam tibi
cenatace.	cena tace .
Declamasbellecausas	Declamas belle causas
agisAttice	agis Attice
belleHistorias	belle Historias
bellascarminabellafacis	bellas carmina bella facis
ComponisbellemimosepigrammatabelleBellusgrammaticus	Componis belle mimos epigrammata belle Bellus grammaticus
bellusesastrologusEtbelle	bellus es astrologus Et belle
cantasetsaltasAtticebelleBellusesartelyraebellus	cantas et saltas Attice belle Bellus es arte lyrae bellus
esartepilae.Nilbenecumfaciasfacias	es arte pilae . Nil bene cum facias facias
tamenomniabelleVisdicamquid	tamen omnia belle Vis dicam quid
sismagnusesardalio.	sis magnus es ardalio .
Molliseratfacilisque	Mollis erat facilisque
virisPoeantiusherosVulnerasicParidisdicitur	viris Poeantius heros Vulnera sic Paridis dicitur
ultaVenus.CurlingatcunnumSiculusSertorius	ulta Venus . Cur lingat cunnum Siculus Sertorius
hocestAbhoc	hoc est Ab hoc
occisusRufevideturEryx.	occisus Rufe videtur Eryx .
CommendotibiQuintiane	Commendo tibi Quintiane
nostrosNostrosdiceresitamenlibellosPossumquosrecitat	nostros Nostros dicere si tamen libellos Possum quos recitat
tuuspoeta	tuus poeta
SideservitiograviquerunturAdsertor	Si de servitio gravi queruntur Adsertor
veniassatisquepraestesEtcumsedominumvocabitille	venias satisque praestes Et cum se dominum vocabit ille
Dicasessemeosmanuquemissos	Dicas esse meos manuque missos
.HocsiterquequaterqueclamitarisInponesplagiario	. Hoc si terque quaterque clamitaris Inpones plagiario
pudorem.	pudorem .
NovitloturosDasiusnumerarepoposcitMammosamSpatalenpro	Novit loturos Dasius numerare poposcit Mammosam Spatalen pro
tribusilladedit.	tribus illa dedit .
Quidmihireddatager	Quid mihi reddat ager
quaerisLine	quaeris Line
NomentanusHocmihi	Nomentanus Hoc mihi
redditagerteLine	reddit ager te Line
nonvideo.	non video .
Omihipost	O mihi post
nullosIulimemorandesodalesSiquidlongafides	nullos Iuli memorande sodales Si quid longa fides
canaqueiuravalentBisiampaenetibiconsultricensimusinstat	canaque iura valent Bis iam paene tibi consul tricensimus instat
Etnumeratpaucosvixtuavitadies.Non	Et numerat paucos vix tua vita dies . Non
benedistulerisvideasquaepossenegari	bene distuleris videas quae posse negari
Etsolumhoc	Et solum hoc
ducasquodfuitesse	ducas quod fuit esse
tuum.ExpectantcuraequecatenatiquelaboresGaudianon	tuum . Expectant curaeque catenatique labores Gaudia non
remanentsedfugitivavolant	remanent sed fugitiva volant
.Haecutraque	. Haec utraque
manuconplexuqueadseretotoSaepefluuntimosicquoquelapsa	manu conplexuque adsere toto Saepe fluunt imo sic quoque lapsa
sinu.Nonestcredemihi	sinu . Non est crede mihi
sapientisdicereVivamSeranimisvita	sapientis dicere Vivam Sera nimis vita
estcrastinavivehodie.	est crastina vive hodie .
HaecquaepulveredissipatamultoLongasporticusexplicatruinas	Haec quae pulvere dissipata multo Longas porticus explicat ruinas
Enquantoiacetabsolutacasu	En quanto iacet absoluta casu
.TectisnammodoRegulussubillisGestatusfuerat	. Tectis nam modo Regulus sub illis Gestatus fuerat
recesseratqueVictaestponderecumsuorepente	recesseratque Victa est pondere cum suo repente
EtpostquamdominonihiltimebatSecuro	Et postquam domino nihil timebat Securo
ruitincruentadamno.TantaeRegulepostmetum	ruit incruenta damno . Tantae Regule post metum
querellaeQuiscuramnegetesse	querellae Quis curam neget esse
tedeorumPropterquemfuitinnocens	te deorum Propter quem fuit innocens
VotatuibrevitersiviscognoscereMarciClarummilitiaeFronto	Vota tui breviter si vis cognoscere Marci Clarum militiae Fronto
togaequedecusHocpetitessesuinecmagniruris	togaeque decus Hoc petit esse sui nec magni ruris
aratorSordidaque	arator Sordidaque
inparvis	in parvis
otiarebus	otia rebus
amat.Quisquampictacolit	amat . Quisquam picta colit
Spartanifrigora	Spartani frigora
saxiEtmatutinum	saxi Et matutinum
portatineptusHaveCuilicetexuviis	portat ineptus Have Cui licet exuviis
nemorisrurisquebeatoAntefocumplenasexplicuisseplagasEtpiscem	nemoris rurisque beato Ante focum plenas explicuisse plagas Et piscem
tremulasalientem	tremula salientem
duceresaetaFlavaquederubropromeremellacadoPinguis	ducere saeta Flavaque de rubro promere mella cado Pinguis
inaequalesoneratcuivilicamensasEt	inaequales onerat cui vilica mensas Et
suanonemptuspraeparatovacinisNonamethanc	sua non emptus praeparat ova cinis Non amet hanc
vitamquisquismenonamat	vitam quisquis me non amat
optoVivateturbanisalbusinofficiis.	opto Vivat et urbanis albus in officiis .
IllamanusquondamstudiorumfidameorumEtfelix	Illa manus quondam studiorum fida meorum Et felix
dominonotaqueCaesaribusDestituitprimosviridisDemetriusannosQuartatribus	domino notaque Caesaribus Destituit primos viridis Demetrius annos Quarta tribus
lustrisadditamessiserat.Netamen	lustris addita messis erat . Ne tamen
adStygiasfamulusdescenderet	ad Stygias famulus descenderet
umbrasUreretinplicitumcumsceleratalues	umbras Ureret inplicitum cum scelerata lues
Cavimusetdominiiusomne	Cavimus et domini ius omne
remisimusaegro	remisimus aegro
Muneredignuseratconvaluissemeo.	Munere dignus erat convaluisse meo .
SensitdeficienssuapraemiamequepatronumDixitadinfernas	Sensit deficiens sua praemia meque patronum Dixit ad infernas
liberiturusaquas.	liber iturus aquas .
Quidnuncsaevafugisplacidilepusora	Quid nunc saeva fugis placidi lepus ora
leonisFrangeretamparvasnondidicereferas.Servantur	leonis Frangere tam parvas non didicere feras . Servantur
magnisisticervicibusunguesNecgaudettenuisanguine	magnis isti cervicibus ungues Nec gaudet tenui sanguine
tantasitis.Praedacanumlepus	tanta sitis . Praeda canum lepus
estvastosnonimplethiatusNontimeatDacusCaesarisarma	est vastos non implet hiatus Non timeat Dacus Caesaris arma
QuitecumcupisessemeosubicumquelibellosEt	Qui tecum cupis esse meos ubicumque libellos Et
comiteslongaequaeris	comites longae quaeris
habereviaeHosemequosartatbrevibus	habere viae Hos eme quos artat brevibus
membranatabellisScriniada	membrana tabellis Scrinia da
magnismemanusunacapit.Netamenignores	magnis me manus una capit . Ne tamen ignores
ubisimvenaliseterres	ubi sim venalis et erres
Urbevagustotame	Urbe vagus tota me
ducecertuserisLibertum	duce certus eris Libertum
doctiLucensisquaereSecundumLiminapostPacisPalladiumqueforum.	docti Lucensis quaere Secundum Limina post Pacis Palladiumque forum .
Incustoditisetapertis	Incustoditis et apertis
Lesbiasemper	Lesbia semper
LiminibuspeccasnectuafurtategisEtplusspectator	Liminibus peccas nec tua furta tegis Et plus spectator
quamtedelectatadulterNecsuntgratatibigaudiasi	quam te delectat adulter Nec sunt grata tibi gaudia si
qualatent.Atmeretrixabigittestem	qua latent . At meretrix abigit testem
veloqueseraqueRaraqueSubmemmifornicerima	veloque seraque Raraque Submemmi fornice rima
patet.AChionesaltem	patet . A Chione saltem
velabIade	vel ab Iade
discepudoremAbsconduntspurcaset	disce pudorem Abscondunt spurcas et
monumentalupas.Numquidduratibinimiumcensura	monumenta lupas . Numquid dura tibi nimium censura
videturDeprendivetote	videtur Deprendi veto te
Lesbianonfutui.	Lesbia non futui .
CantastimaledumfututaesAegle.Iam	Cantasti male dum fututa es Aegle . Iam
cantasbene;basiandanones.	cantas bene ; basianda non es .
CastasuogladiumcumtraderetArriaPaetoQuemdevisceribus	Casta suo gladium cum traderet Arria Paeto Quem de visceribus
strinxeratipsasuisSiquafidesvulnusquodfecinon	strinxerat ipsa suis Si qua fides vulnus quod feci non
doletinquit	dolet inquit
Sedtuquodfacieshocmihi	Sed tu quod facies hoc mihi
Paetedolet.	Paete dolet .
DasnumquamsemperpromittisGallaroganti	Das numquam semper promittis Galla roganti
.SisemperfallisiamrogoGallanega.	. Si semper fallis iam rogo Galla nega .
HostemcumfugeretseFanniusipseperemit.	Hostem cum fugeret se Fannius ipse peremit .
Hicrogononfurorestne	Hic rogo non furor est ne
moriaremori	moriare mori
Famarefert	Fama refert
nostroste	nostros te
FidentinelibellosNonaliterpopuloquamrecitaretuos.	Fidentine libellos Non aliter populo quam recitare tuos .
Simeavis	Si mea vis
dicigratistibicarminamittamSi	dici gratis tibi carmina mittam Si
dicituavishoceme	dici tua vis hoc eme
nemeasint.	ne mea sint .
LismihicumBalboesttu	Lis mihi cum Balbo est tu
BalbumoffenderenonvisPonticecum	Balbum offendere non vis Pontice cum
Licinoesthicquoquemagnushomoest.Vexatsaepe	Licino est hic quoque magnus homo est . Vexat saepe
meumPatrobasconfinisagellumContra	meum Patrobas confinis agellum Contra
libertumCaesarisiretimes	libertum Caesaris ire times
.AbnegatetretinetnostrumLaroniaservum	. Abnegat et retinet nostrum Laronia servum
RespondesOrbaestdivesanusvidua	Respondes Orba est dives anus vidua
.Nonbenecredemihiservo	. Non bene crede mihi servo
servituramicoSitliberdominusquivoletesse	servitur amico Sit liber dominus qui volet esse
Mammasatquetatashabet	Mammas atque tatas habet
AfrasedipsatatarumDici	Afra sed ipsa tatarum Dici
etmammarummaximamamma	et mammarum maxima mamma
QuidquidponiturhincetindeverrisMammassuminis	Quidquid ponitur hinc et inde verris Mammas suminis
imbricemqueporciCommunemqueduobusattagenamMullum	imbricemque porci Communemque duobus attagenam Mullum
dimidiumlupumquetotumMuraenaequelatusfemurque	dimidium lupumque totum Muraenaeque latus femurque
pulliStillantemquealicasuapalumbum.Haec	pulli Stillantemque alica sua palumbum . Haec
cumconditasuntmadentemappaTradunturpuerodomumferendaNos	cum condita sunt madente mappa Traduntur puero domum ferenda Nos
accumbimusotiosaturba.Ullussipudor	accumbimus otiosa turba . Ullus si pudor
estreponecenamCrasteCaecilianenonvocavi.	est repone cenam Cras te Caeciliane non vocavi .
InvitasnullumnisicumquoCottalavaris	Invitas nullum nisi cum quo Cotta lavaris
Etdantconvivambalneasolatibi	Et dant convivam balnea sola tibi
.Mirabarquare	. Mirabar quare
numquammeCotta	numquam me Cotta
vocassesIamsciomenudumdisplicuisse	vocasses Iam scio me nudum displicuisse
Chirurgusfueratnuncestvispillo	Chirurgus fuerat nunc est vispillo
Diaulus.Coepitquopoteratclinicusesse	Diaulus . Coepit quo poterat clinicus esse
QuodfronteSeliumnubilavidesRufeQuodambulatorporticumterit	Quod fronte Selium nubila vides Rufe Quod ambulator porticum terit
seramLugubrequiddamquodtacet	seram Lugubre quiddam quod tacet
pigervoltus	piger voltus
Quodpaeneterramnasus	Quod paene terram nasus
indecenstangitQuoddextrapectuspulsatetcomam	indecens tangit Quod dextra pectus pulsat et comam
vellitNonilleamicifata	vellit Non ille amici fata
lugetautfratrisUterquenatusvivitetprecor	luget aut fratris Uterque natus vivit et precor
vivatSalvaestetuxorsarcinaequeservique	vivat Salva est et uxor sarcinaeque servique
Nihilcolonusvilicusquedecoxit.MaerorisigiturcausaquaeDomi	Nihil colonus vilicusque decoxit . Maeroris igitur causa quae Domi
Saepemihi	Saepe mihi
dicisLucicarissimeIuliScribealiquidmagnum	dicis Luci carissime Iuli Scribe aliquid magnum
desidiosushomo	desidiosus homo
es.Otiadanobissed	es . Otia da nobis sed
qualiafeceratolimMaecenasFlaccoVergilioquesuo	qualia fecerat olim Maecenas Flacco Vergilioque suo
Conderevicturastemptemper	Condere victuras temptem per
saeculacurasEtnomen	saecula curas Et nomen
flammiseripuissemeum.Insterilesnoluntcamposiuga	flammis eripuisse meum . In steriles nolunt campos iuga
ferreiuvenciPinguesolumlassatsediuvatipselabor	ferre iuvenci Pingue solum lassat sed iuvat ipse labor
