fecitconstantin᷒celebrariꝯciliumExpliciunttitulilibri	fecit constantin᷒ celebrari ꝯcilium Expliciunt tituli libri
pͥmiIncip̃lib̃IOratioallocutoria	pͥmi Incip̃ lib̃ I Oratio allocutoria
sozomeniadtheodosiũĩꝑatorAiuntantiquispͥncipibdiligentiestudiumfuisse	sozomeni ad theodosiũ ĩꝑator Aiunt antiquis pͥncipib diligentie studium fuisse
uteisamatores	ut eis amatores
qͥdemornam̃toꝝpurpuramatqcoronam	qͥdem ornam̃toꝝ purpuram atq coronam
ethissimiliapararentLibroꝝuͦh̃ntesintentionemcircaquasdã	et his similia pararent Libroꝝ uͦ h̃ntes intentionem circa quasdã
fabulasoccupaticonscͥptiones	fabulas occupati conscͥptiones
agerentqueaudientium	agerent que audientium
cordamulc̃entPorrobellasectantesutsagittamoportunedirigerentbestiam	corda mulc̃ent Porro bella sectantes ut sagittam oportune dirigerent bestiam
ꝓsternerentlanceãbñiacularent᷑autequũdecent̃ascenderent	ꝓsternerent lanceã bñ iacularent᷑ aut equũ decent̃ ascenderent
Presentabãt᷑enimsingl̃i	Presentabãt᷑ enim singl̃i
regalibeoꝝstudentesrebillisq̃forent	regalib eoꝝ studentes reb illis q̃ forent
gratissimedñatuiAuusitaq̃lapidesciososdifficilecomꝑtosofferebatalt̃	gratissime dñatui Auus itaq̃ lapides ciosos difficile comꝑtos offerebat alt̃
tincturampurpura	tincturam purpura
clariorẽplurimipoemataautdiũsasconscͥptionesinsinuabantaliusbonacingl̃	clariorẽ plurimi poemata aut diũsas conscͥptiones insinuabant alius bona cingl̃
autoptimũarmoꝝpandebatusummaximauͦ	aut optimũ armoꝝ pandebat usum maxima uͦ
etimꝑialis	et imꝑialis
putabat᷑h᷒popularisAntoninirequireagapitiuir	putabat᷑ h᷒ popularis Antonini req uire agapiti uir
agiulphirequiremalcelliUigl̃sc̃iBertini	agiulphi req uire malcelli Uigl̃ sc̃i Bertini
utinuigl̃	ut in uigl̃
sc̃iiacobiIndies̃BertiniOM̃IPS̃sempiternedeus	sc̃i iacobi In die s̃ Bertini OM̃IPS̃ sempiterne deus
quimirabiliterfulgesin	qui mirabiliter fulges in
electistuisquoste	electis tuis quos te
habitatoreglorificareuoluisticoncede	habitatore glorificare uoluisti concede
nosqs̃beatipatrisnr̃iBertiniitasollempnia	nos qs̃ beati patris nr̃i Bertini ita sollempnia
uenerariutei᷒suffragantibmeritis	uenerari ut ei᷒ suffragantib meritis
templũtuummereamurfieriPerSecretaMunera	templũ tuum mereamur fieri Per Secreta Munera
nr̃atibidñed̃sbeatiBertiniAURELII	nr̃a tibi dñe d̃s beati Bertini AURELII
AUGUSTINIDOCTORIS	AUGUSTINI DOCTORIS
LIBERI᷒HYPPONIENSIS	LIBER I᷒ HYPPONIENSIS
EP̃IDECIUITATED̃IINCIP̃CONTR[A]	EP̃I DE CIUITATE D̃I INCIP̃ CONTR [ A ]
PAGANOSGL̃IOSISSIMAMCIUITATEMDEISIUE	PAGANOS GL̃IOSISSIMAM CIUITATEM DEI SIUE
INHOCTẼPORŨCURSUCŨ	IN HOC TẼPORŨ CURSU CŨ
INTERimpiosperegrinaturexfideuiuenssiueinilla	INTER impios peregrinatur exfide uiuens siue in illa
stabilitatesedisęternęquamnuncexpectatꝑ	stabilitate sedis ęternę quam nunc expectat ꝑ
pacientiãquoadusqiustitiac̃uertat᷑iniudiciũdeincepsadepturaꝑ	pacientiã quoadusq iustitia c̃uertat᷑ in iudiciũ deinceps adeptura ꝑ
excellentiãuictoriaultima&paceꝑfecta	excellentiã uictoria ultima & pace ꝑfecta
hocoꝑeadte	hoc oꝑe ad te
instituto&meaꝓmissione	instituto & mea ꝓmissione
debitodefendereaduersuseosquic̃ditori	debito defendere aduersus eos qui c̃ditori
ei᷒deossuosferunt	ei᷒ deos suos ferunt
filikm̃e	fili km̃e
MARcelliNEsuscepiMagnũopus&arduũ	MARcelliNE suscepi Magnũ opus & arduũ
sedd̃sadiutornr̃NamscioquibEXPLIC̃	sed d̃s adiutor nr̃ Nam scio quib EXPLIC̃
TERCIAꝓpositioINCIPITQUARTAQUARTAPROPOSITIO	TERCIA ꝓpositio INCIPIT QUARTA QUARTA PROPOSITIO
ESTADŨsariiquę&	EST ADŨsarii quę &
extremaduoseẽordinesouium&hircoꝝalterũiustoꝝ	extrema duos eẽ ordines ouium & hircoꝝ alterũ iustoꝝ
alterumpeccatoꝝ	alterum peccatoꝝ
aliosstare	alios stare
adextris	a dextris
aliosasinistris&	alios a sinistris &
audireiustosVenitebenedictipatͥsmei	audire iustos Venite benedicti patͥs mei
possideteparatũuob̃	possidete paratũ uob̃
regnũaconstitutionemundiPeccatoribuͦdiciDiscedite	regnũ a constitutione mundi Peccatorib uͦ dici Discedite
amemaledictiinignẽęt̃nũquiparat᷒ẽdiabolo	a me maledicti in ignẽ ęt̃nũ qui parat᷒ ẽ diabolo
&angelisei᷒Arborẽbonãnonposse	& angelis ei᷒ Arborẽ bonã non posse
fruct᷒malos	fruct᷒ malos
fac͛enecmalãbonosUñ&	fac͛e nec malã bonos Uñ &
saluatorloqͥt᷑adiudeosUosdepatrediabolo	saluator loqͥt᷑ ad iudeos Uos de patre diabolo
estis&concuQVIALARGIENTEDÑOmissarum	estis & concu QVIA LARGIENTE DÑO missarum
sollempniaterhodiecelebraturisum᷒loquidiudeeuangelicalectione	sollempnia ter hodie celebraturi sum᷒ loqui diu de euangelica lectione
nonpossumussednosaliquiduelbreuiterdicereredemptorisnr̃i	non possumus sed nos aliquid uel breuiter dicere redemptoris nr̃i
natiuitasipsa	natiuitas ipsa
cõpellitQuidestqͦdnasciturodño	cõpellit Quid est qͦd nascituro dño
mundusdescribitur	mundus describitur
nisihocquodaꝑtemonstraturquia	nisi hoc quod aꝑte monstratur quia
illeueniebat	ille ueniebat
incarneqͥ	in carne qͥ
electossuosascriber&inęternitateCuicontra	electos suos ascriber& in ęternitate Cui contra
dereꝓbisꝑproph̃amdiciturDeleanturdelibrouiuentiũ	de reꝓbis ꝑ proph̃am dicitur Deleantur de libro uiuentiũ
&cumiustisnonscribantur	& cum iustis non scribantur
Quibene&iam	Qui bene &iam
inb&hleemnasciturB&hleemquippe	in b&hleem nascitur B&hleem quippe
domuspanisinterpretat᷑IpsenamqestqͥaitEgosum	domus panis interpretat᷑ Ipse namq est qͥ ait Ego sum
panisuiuusqͥdecęlo	panis uiuus qͥ de cęlo
descendiLocusergoinqͦdñsnascereturdomus	descendi Locus ergo in qͦ dñs nasceretur domus
panisanteuocatusestquiafuturũꝓfectoerat	panis ante uocatus est quia futurũ ꝓfecto erat
utilleibiꝑmateriãcarnisapparer&quielectoꝝm̃tes	ut ille ibi ꝑ materiã carnis apparer& qui electoꝝ m̃tes
internasatietatereficer&Qui	interna satietate reficer& Qui
noninparentũ	non in parentũ
mentisiudicans&uulnerabilipaternę	mentis iudicans & uulnerabili paternę
consolationisadhibensmedicinamSicillereuersusadsesusceptionemquam	consolationis adhibens medicinam Sic ille reuersus ad se susceptionem quam
dilatamdoluitpacient̃expectauitMortemquoqWillelmiiuniorisquimagno	dilatam doluit pacient̃ expectauit Mortem quoq Willelmi iunioris qui magno
actriumphatorianglorũWillelmopatrisuosuccesserateuidenti	ac triumphatori anglorũ Willelmo patri suo successerat euidenti
uaticinioindicauitEratilled̃iseruusgl̃ose	uaticinio indicauit Erat ille d̃i seruusgl̃ose
opinionisanselm᷒cantuꝓmisitfueratPrescriptussiquinationisinsistercui᷒dã	opinionis anselm᷒ cantu ꝓmisit fuerat Prescriptus siqui nationis insister cui᷒dã
militisinstatimqsubita	militis in statimq subita
expirauitSiciterminataeta	expirauit Sic i terminata et a
claruit&cant	claruit & cant
quiꝑsequentisredeundifaculcessit	qui ꝑsequenti s redeundi facul cessit
Idemd̃iseruusNonoportetaLXXmausq	Idem d̃i seruus Non oportet a LXXma usq
inoct̃pasche&abaduentudñiusq	in oct̃ pasche & ab aduentu dñi usq
p᷒theophaniã	p᷒ theophaniã
nupciascelebrariConuenientib᷒eisqͥ	nupcias celebrari Conuenientib᷒ eis qͥ
hocsacram̃tũcelebraredesiderantpͥmocauendũ&	hoc sacram̃tũ celebrare desiderant pͥmo cauendũ &
diligentissimeẽinqͥrend̃nesitint̃	diligentissime ẽ inqͥrend̃ ne sit int̃
eosaliqͥdq̃dtantosacram̃topoᷤsiteẽcontrariũReqͥenduᷤẽ	eos aliqͥd q̃d tanto sacram̃to poᷤsit eẽ contrariũ Reqͥenduᷤ ẽ
ętiãdiligent̃asac̃doteamboꝝid÷uiri	ętiã diligent̃ a sac̃dote amboꝝ id÷ uiri
etmulierisassensus	et mulieris assensus
Q̃dsiuotaamboꝝconuenerintsacerdoslectacarta	Q̃d si uota amboꝝ conuenerint sacerdos lecta carta
sponsaliciibñdicatarrasdicensBENEDIC	sponsalicii bñdicat arras dicens BENEDIC
dñehasarrasquashodietradetfamulustuusinmanu	dñe has arras quas hodie tradet famulus tuus in manu
ancillętuęquemadmodũbenedixistiabraamcumsairaysaaccũ	ancillę tuę quem admodũ benedixisti abraam cum saira ysaac cũ
Rebecaiacobcũrachel	Rebeca iacob cũ rachel
Donasuꝑeosdñegr̃ambenedicPAPAVRBISROME	Dona suꝑ eos dñe gr̃am benedic PAPA VRBIS ROME
EDITVSSCRIPTORISLIBRILECTORMEMORESTOSICARDIOrdo	EDITVS SCRIPTORIS LIBRI LECTOR MEMOR ESTO SICARDI Ordo
qualit̃inCatholicaeccl̃a	qualit̃ in Catholica eccl̃a
missacelebreturInpͥmisantiph̃aadintroitũDeinde	missa celebretur In pͥmis antiph̃a ad introitũ Deinde
kiriel̃IIIͦxp̃el̃IIIͦkiriel̃IIIͦPosteaGl̃ain	kiriel̃ IIIͦ xp̃el̃ IIIͦ kiriel̃ IIIͦ Postea Gl̃a in
excelsisd̃odieb᷒	excelsis d̃o dieb᷒
festistantũmͦIndeor̃oSeqͥturEpl̃aDeindeGradal̃siueall̃a	festis tantũmͦ Inde or̃o Seqͥtur Epl̃a Deinde Gradal̃ siue all̃a
PosteaEugl̃mIndeOffertoriũPostomodũseqͥtur	Postea Eugl̃m Inde Offertoriũ Postomodũ seqͥtur
or̃osuꝑobl̃aQuasub	or̃o suꝑ obl̃a Qua sub
silentiocompletasacerdosexpansis	silentio completa sacerdos expansis
manib᷒excelsauocereuerenterdicat	manib᷒ excelsa uoce reuerenter dicat
SUPEROBLATAOblataconfessoristuicolumbanihonoresinttibi	SUPER OBLATA Oblata confessoris tui columbani honore sint tibi
nr̃agrata	nr̃a grata
libamina&nr̃arumapudte	libamina & nr̃arum apud te
supplicationumeffectumobtineãt*P	supplicationum effectum obtineãt * P
*ADCOMPLENDṼ	* AD COMPLENDṼ
Facnosquesumus	Fac nos quesumus
dominebeaticonfessoristuicolumbanidignesollempnia	domine beati confessoris tui columbani digne sollempnia
celebrarequilargitatistuaepreuent᷒munerelaudabilisuitęcursumglorioso	celebrare qui largitatis tuae preuent᷒ munere laudabilis uitę cursum glorioso
finecompleuit*P*EODEMDIEVIGILIA	fine compleuit * P * EODEM DIE VIGILIA
SC̃ECECILIAEVIRGINISSANctęCECILIAEmr̃istuęquesumusdomineintercessionibus	SC̃E CECILIAE VIRGINIS SANctę CECILIAE mr̃is tuę quesumus domine intercessionibus
nosfoueas&cuiusuenerabilemsollempnitatemnostribuispreuenireob	nos foueas & cuius uenerabilem sollempnitatem nos tribuis preuenire ob
Incipitsecund᷒Postmortem	Incipit secund᷒ Post mortem
uͦysaacfiliieiusinuicemhabitaculadiuiseruntnonea	uͦ ysaac filii eius inuicem habitacula diuiserunt non ea
queacceperant&tenuerants	que acceperant & tenuerant s
esauquidemebronciuitatemfratridanshabitauitinseir&	esau quidem ebron ciuitatem fratri dans habitauit in seir &
inidumearegnabatquamregionemasemetipsoitauocauitEdom	in idumea regnabat quam regionem a semetipso ita uocauit Edom
enimnominatus	enim nominatus
estQuam	est Quam
nuncupationemhuiusmodiuenationiscausa	nuncupationem huiusmodi uenationis causa
sortitusestAliquandolaboreuenationisesuriens	sortitus est Aliquando labore uenationis esuriens
redibatdumadhucpuereẽt	redibat dum adhuc puer eẽt
etateInueniensqfratremlentemsibi	etate Inueniensq fratrem lentem sibi
preparantemadprandiumrubeumcoloremnimishabentem&proptereapotius	preparantem ad prandium rubeum colorem nimis habentem & propterea potius
incitatusrogabatuteipreberet	incitatus rogabat ut ei preberet
adcibumQuiuenderesibiprimatumpropt̃cibumꝑ	ad cibum Qui uendere sibi primatum propt̃ cibum ꝑ
eiusesuriemcimpulitfratrẽSICVT	eius esuriem cimpulit fratrẽ SICVT
INDIVINISLITTERISdiuersaleguntur	IN DIVINIS LITTERIS diuersa leguntur
canticaita&sp̃usc̃olam̃tationes	cantica ita & sp̃u sc̃o lam̃tationes
diuersęEt	diuersę Et
sic̃ꝓpͥeappellaturlibersalomonis	sic̃ ꝓpͥe appellatur liber salomonis
canticacanticoꝝita&appellariqͤũtthreniiheremięlamentationeslam̃tationũ	cantica canticoꝝ ita & appellari qͤũtthreni iheremię lamentationes lam̃tationũ
sic̃omninocelluntillainquibsponsus	 sic̃ omnino cellunt illa in quib sponsus
acsponsadulvibfruunturamplexibusita	ac sponsa dulvib fruuntur amplexibus ita
&lam̃tationesistę	& lam̃tationes istę
hocĩnõedñiadmonem᷒	hoc ĩ nõe dñi admonem᷒
qͣntũposum᷒&cipim᷒utqnͦauditisexponi	qͣntũ posum᷒ & cipim᷒ ut qnͦ auditis exponi
sacͣm̃tũscͥpt᷑ęnarrantiᷤquę	sacͣm̃tũ scͥpt᷑ę narrantiᷤ quę
gestas̃priusilludq̃dlectũẽcredatissic	gesta s̃ prius illud q̃d lectũ ẽ credatis sic
gestũqͦmͦlectũẽnesubtractofundam̃torei	gestũ qͦmͦ lectũ ẽ ne subtracto fundam̃to rei
gestęqͣsiinaere	gestę qͣsi in aere
quaeratiᷤedificareAbrahãpat̃	quaeratiᷤ edificare Abrahã pat̃
nr̃homoeratillistẽporib	nr̃ homo erat illis tẽporib
fid̃liᷤcredensd̃oiustificat᷒exfidesic̃script᷑a	fid̃liᷤ credens d̃o iustificat᷒ ex fide sic̃ script᷑a
dic̃&uet᷒	dic̃ & uet᷒
&nouaSuscep̃	& noua Suscep̃
filiũdesarauxoreiãinsenectute	filiũ de sara uxore iã in senectute
utͥsqc̃stitutiᷤ	utͥsq c̃stitutiᷤ
exmagnadesꝑatiõe,sscd̃mhominẽQͥd	ex magna desꝑatiõe , s scd̃m hominẽ Qͥd
aut̃dedeoñsꝑandũ	aut̃ de deo ñ sꝑandũ
cuinichil	cui nichil
difficileẽqͥsicfac̃magnaquomͦparuasicsuscitat	difficile ẽ qͥ sic fac̃ magna quomͦ parua sic suscitat
mortuoᷤqͦmͦcreatuiuosSipictoreadẽ	mortuoᷤ qͦmͦ creat uiuos Si pictor eadẽ
artefac̃muremsudarioporrigit᷑adaltare	arte fac̃ murem sudario porrigit᷑ ad altare
q̃dsudariũponiturin	q̃d sudariũ ponitur in
cornualtaCalix	cornu alta Calix
inlatereoblatainaltari	in latere oblata in altari
cõponit᷑ñposttergũLętanięitacęlebraᷠt᷑in	cõponit᷑ ñ post tergũ Lętanię ita cęlebraᷠt᷑ in
uigiliispaschęutnr̃mosolimobtinuit	uigiliis paschę ut nr̃ mos olim obtinuit
idestpostbaptismũꝑsepnariũ&quinariũ&ternariũ	id est post baptismũ ꝑ sepnariũ & quinariũ & ternariũ
numerumOFFICIALIS	numerum OFFICIALIS
LIBERGLORIOSISSIMEIMPERATOR	LIBER GLORIOSISSIME IMPERATOR
ETMAGNIFICENsimeaccentiesinuictissime	ET MAGNIFICEN sime ac centies inuictissime
ad̃ocoronatenecn&conseruateatq	a d̃o coronate nec n & conseruate atq
conseruandeseruus	conseruande seruus
egour̃ALARIUSquãuisminimusom̃iũ	ego ur̃ A LARIUS quãuis minimus om̃iũ
Afficiebarolidesiderio	Afficiebar oli desiderio
utscirẽrationẽaliquã	ut scirẽ rationẽ aliquã
deordinenr̃ęmissęquãconsuęto	de ordine nr̃ę missę quã consuęto
morecęlebram᷒&amplius	more cęlebram᷒ & amplius
exdiuersitateq	ex diuersitate q
soletfieriineahoc	solet fieri in ea hoc
estq̃daliquotiensunaepistolalegit᷑aliqͦtiensduę&cętera	est q̃d aliquotiens una epistola legit᷑ aliqͦtiens duę & cętera
taliasimulqdeceterisofficiis	talia simulq de ceteris officiis
Pręteritaꝓximpriiseoꝝuerbis	Pręterita ꝓxim priis eoꝝ uerbis
utensquęapta	utens quę apta
erantmeostudiotemperauiInterdumautẽquę	erant meo studio temperaui Interdum autẽ quę
manifestanondubiũuidebantur	manifesta non dubiũ uidebantur
uerarationefirmauiEtcontraquęq.	uera ratione firmaui Et contra quęq.
ineiusdemlibrimarginelitterasdoctoꝝquospremisiexinitio	in eiusdem libri margine litteras doctoꝝ quos premisi ex initio
nominiseregione	nominis e regione
figerecurauiPropterquodlege	figere curaui Propter quod lege
securus&	securus &
ꝑficequęmonuideuotus	ꝑfice quę monui deuotus
ExplicitPROLOG᷒INCIPIVNTCAPITVLAIxp̃icõmunionẽuerũcorpus	Explicit PROLOG᷒ INCIPIVNT CAPITVLA I xp̃i cõmunionẽ uerũ corpus
ei᷒&sanguinẽesseII	ei᷒ & sanguinẽ esse II
Q̃dhocmysteriũxp̃inullusfideliũdebeatignorareIIIQuid	Q̃d hoc mysteriũ xp̃i nullus fideliũ debeat ignorare III Quid
sintsacramentauelquaredicanturIIII	sint sacramenta uel quare dicantur IIII
Vtrũsubfiguraaninueritatehocmysticũfiatsacramentũ	Vtrũ sub figura an in ueritate hoc mysticũ fiat sacramentũ
VQuidsit	V Quid sit
interimmolationesueterũfigurasq.	inter immolationes ueterũ figurasq.
legaliũ&	legaliũ &
int̃sacramentũdñicicorporis&sanguinispuritatecelesis	int̃ sacramentũ dñici corporis & sanguinis puritate celesis
desid̃iigaudentErateneũquiamultisũtqͥ	desid̃ii gaudent Erat eneũ quia multi sũt qͥ
dicuntmenteseruiuim᷒legideicarneaut̃legi	dicunt mente seruiuim᷒ legi dei carne aut̃ legi
peccatiErat	peccati Erat
antetempliforespositumquiapaucisuntquirenuntiant	ante templi fores positum quia pauci sunt qui renuntiant
om̃ibq̃possidentutadostiumportic᷒appropinquentPortic᷒	om̃ib q̃ possident ut ad ostium portic᷒ appropinquent Portic᷒
siqͥd̃templiẽutsuꝑi᷒dixim᷒renuntiatõ	siqͥd̃ templi ẽ ut suꝑi᷒ dixim᷒ renuntiatõ
mundiInhacporticudueerigunt᷑	mundi In hac porticu due erigunt᷑
colũpneunacastitatisalt̃asobͥetatisutqͥmundorenuntiãt	colũpne una castitatis alt̃a sobͥetatis ut qͥ mundo renuntiãt
sobrie⁊castedeouiuant	sobrie ⁊ caste deo uiuant
Postporticumrenuntiatõnisseqͥt᷑	Post porticum renuntiatõnis seqͥt᷑
templũrecteꝯuconuersionisDealtariaureo⁊mensa	templũ recte ꝯu conuersionis De altari aureo ⁊ mensa
aurea⁊candelabroIN	aurea ⁊ candelabro IN
hoctemploẽaltareaureũestm̃saaurea	hoc templo ẽ altare aureũ est m̃sa aurea
sunt⁊candelabradeauropurissimofactaInaltari	sunt ⁊ candelabra de auro purissimo facta In altari
accendebant᷑thimiamatainm̃sapanesponebant᷑incandelabris	accendebant᷑ thimiamata in m̃sa panes ponebant᷑ in candelabris
lucerneAltareaureũsuntcorda	lucerne Altare aureũ sunt corda
electoꝝthimiamata	electoꝝ thimiamata
bonaoꝑa	bona oꝑa
odorthimiamatũbonioꝑisexemplumFum᷒thimiamatũqͥsuꝑi᷒	odor thimiamatũ boni oꝑis exemplum Fum᷒ thimiamatũ qͥ suꝑi᷒
ascenditẽintentõoratõnis	ascendit ẽ intentõ oratõnis
q̃exaffectucordisad	q̃ ex affectu cordis ad
desid̃andacelestiatenditm̃sauͦaureaẽdiuinascͥptura	desid̃anda celestia tendit m̃sa uͦ aurea ẽ diuina scͥptura
panessuntapostolisiueeoꝝsuccessoresex	panes sunt apostoli siue eoꝝ successores ex
quoꝝactibtanqͣmexpanibreficiunt᷑fideliũmentesQui	quoꝝ actib tanqͣm ex panib reficiunt᷑ fideliũ mentes Qui
panesꝓpositõnisꝯuenient̃possuntappellarquiaadimitandũ	panes ꝓpositõnis ꝯuenient̃ possunt appellar quia ad imitandũ
ꝓponunt᷑uniũsoorbiDecẽcandelabra	ꝓponunt᷑ uniũso orbi Decẽ candelabra
sũtdecemlegisceptaluc̃nelumendoctͥnePossunt	sũt decem legis cepta luc̃ne lumen doctͥne Possunt
hec⁊alit̃	hec ⁊ alit̃
diciSitgͥ	dici Sit gͥ
altaredilectõ	altare dilectõ
mensalectõcandeINCIPITPROLOG᷒	mensa lectõ cande INCIPIT PROLOG᷒
INVITÃ	IN VITÃ
SC̃IAGERICIImpellitismeac	SC̃I AGERICI Impellitis me ac
trahitisuiolentiaamabili	trahitis uiolentia amabili
fr̃skm̃iutin	fr̃s km̃i ut in
diefestiuitatisSc̃i	die festiuitatis Sc̃i
acuenerabilispatrisnr̃iAGERICIdehorto	ac uenerabilis patris nr̃i AGERICI de horto
uirtutumipsiusfecundissimo	uirtutum ipsius fecundissimo
quosdamflosculosetuirentiaquęlibetodoramentadecerpam	quosdam flosculos et uirentia quęlibet odoramenta decerpam
eaq.admensamleticię	eaq. ad mensam leticię
cõmunisferculolitterarumcõpositaofferamsicq.	cõmunis ferculo litterarum cõposita offeram sicq.
repleamdesideriiur̃iappetitumparticulãq.bonamacceptamadñouobis	repleam desiderii ur̃i appetitum particulãq. bonam acceptam a dño uobis
excaritatecõmunicemBona	ex caritate cõmunicem Bona
ẽaclaudabilisplutimũintentio	ẽ ac laudabilis plutimũ intentio
EXPLICITDIESQUART᷒INCIP̃LIB̃QͥNT᷒QVIVINDEMIAMCOLLIGIT	EXPLICIT DIES QUART᷒ INCIP̃ LIB̃ QͥNT᷒ QVI VINDEMIAM COLLIGIT
uasapriusquibusuinum	uasa prius quibus uinum
infundit᷑mundareconsueuitnesordesaliquauini	infundit᷑ mundare consueuit ne sordes aliqua uini
gr̃amdecoloretQuidenĩprodestponeręuitę̃ordinefoderequot	gr̃am decoloret Quid enĩ prodest ponerę uitę̃ ordine fodere quot
annisautaratrissulcosducereputare	annis aut aratris sulcos ducere putare
subrigereadiungereulmis&quodam	subrigere adiungere ulmis & quodam
conubiocopularesitanto	conubio copulare si tanto
laboreuinaquesitain	labore uina quesita in
uasecoacescantmatutinosquoq	uase coacescant matutinos quoq
solisort᷒siquis	solis ort᷒ si quis
spectaredesideratemundatocl̃ossuosnequid	spectare desiderat emundat ocl̃os suos nequid
puluerisneqͥdpurgam̃toꝝ	pulueris neqͥd purgam̃toꝝ
ocl̃isei᷒insideat	ocl̃is ei᷒ insideat
quotuendishebetet᷑optut᷒neuealiquacaligonebulosacorporeosuisus	quo tuendis hebetet᷑ optut᷒ neue aliqua caligonebulosa corporeos uisus
spectantisobuestręquarehunc	spectantis ob uestrę quare hunc
sermonẽnecessehabuiuob̃ꝓmereExquo	sermonẽ necesse habui uob̃ ꝓmere Ex quo
hicsumuseuntesadęccl̃am&redeuntespauperes	hic sumus euntes ad ęccl̃am & redeuntes pauperes
int̃pellantnos&dicuntut	int̃pellant nos & dicunt ut
dicam᷒uob̃utaliqͥdaccipiantauob̃Nosnouer̃l̃	dicam᷒ uob̃ ut aliqͥd accipiant a uob̃ Nos nouer̃ l̃
r̃tloquiuob̃	r̃t loqui uob̃
&seuidentñaccipereauob̃Inanit̃nos	& se uident ñ accipere a uob̃ Inanit̃ nos
arbitranturlaborareinuob̃	arbitrantur laborare in uob̃
Expectantaliquid&a	Expectant aliquid & a
nob̃damusquãtumhabem᷒damus	nob̃ damus quãtum habem᷒ damus
sicutpossumus	sicut possumus
Nũquidtam̃	Nũquid tam̃
adeorũ	ad eorũ
necessitatẽsupplendãidonei	necessitatẽ supplendã idonei
sumusQuiagͦadeorumnecessitatẽimplendã	sumus Quia gͦ ad eorum necessitatẽ implendã
idoneinonsumusueladuoslegatiipsorũsumus	idonei non sumus uel ad uos legati ipsorũ sumus
Audistislaudastisd̃ogr̃asegistis	Audistis laudastis d̃o gr̃as egistis
Sem̃accepistisũbareddidistisLaudesistae	Sem̃ accepistis ũba reddidistis Laudes istae
ur̃ęgrauantnospotius&	ur̃ę grauant nos potius &
inpericulũ	in periculũ
mittuntToleram᷒	mittunt Toleram᷒
illas&tremimusint̃illasTam̃	illas & tremimus int̃ illas Tam̃
fr̃smeiistelaudesur̃ęfoliasuntarborũfructus	fr̃s mei iste laudes ur̃ę folia sunt arborũ fructus
quęriturEXPLICITITEM	quęritur EXPLICIT ITEM
EIUSDEMDEVERBIS	EIUSDEM DE VERBIS
DÑIINEUGL̃OSCD̃MMATH̃MDEPVEROCENTVRIONIS&VERBIS	DÑI IN EUGL̃O SCD̃M MATH̃M DE PVERO CENTVRIONIS & VERBIS
EI᷒INDIGNṼSEPRESENTIA	EI᷒ INDIGNṼ SE PRESENTIA
DÑIdebita	DÑI debita
nr̃asic̃&nosdimittim᷒debitoribnSꝑate	nr̃a sic̃ & nos dimittim᷒ debitorib n Sꝑa te
resurrecturũ&tc̃futurũom̃imͦ	resurrecturũ & tc̃ futurũ om̃i mͦ
sinpeccatoQͥaille	sin peccato Qͥa ille
resurrex̃qͥ	resurrex̃ qͥ
pͥm᷒fuitsine	pͥm᷒ fuit sine
peccatoAuigmatutinasꝑanolidicereegoñsũ	peccato A uig matutina sꝑa noli dicere ego ñ sũ
dign᷒ꝓpt̃peccatañesmultaapud	dign᷒ ꝓpt̃ peccata ñ e s multa apud
illũredẽptioEtipseredimet	illũ redẽptio Et ipse redimet
isr̃lexom̃ibiniqͥtatib	isr̃l ex om̃ib iniqͥtatib
ei᷒EXPLIC̃DEPSAMOCENTESIMOVICESIMONONO	ei᷒ EXPLIC̃ DE PSA MO CENTESIMO VICESIMO NONO
INCIPITDEPSALMOCENTESIMOTRICESIMOINISTOPSALMOcõm̃dat᷑nob̃	INCIPIT DE PSALMO CENTESIMO TRICESIMO IN ISTO PSALMO cõm̃dat᷑ nob̃
humilitasseuid̃i&fidelis	humilitas seui d̃i & fidelis
cui᷒uocecantat᷑q̃dẽ	cui᷒ uoce cantat᷑ q̃d ẽ
uniuersũcorp᷒xp̃i	uniuersũ corp᷒ xp̃i
Sepeenĩadmonuim᷒caritatẽur̃amñqͣsiuni᷒hominiscantantis	Sepe enĩ admonuim᷒ caritatẽ ur̃am ñ qͣsi uni᷒ hominis cantantis
ucẽaccipideberesedom̃iũ	u cẽ accipi debere sed om̃iũ
qͥs̃tinxp̃icorpore	qͥ s̃t in xp̃i corpore
Etqͥain	Et qͥa in
illi᷒corpores̃tom̃stãquãihomoloqͥt᷑	illi᷒ corpore s̃t om̃s tãquã i homo loqͥt᷑
Etipseẽun᷒qͥ&multi	Et ipse ẽ un᷒ qͥ & multi
s̃tMtienĩs̃tinseipsisun᷒s̃t	s̃t Mti enĩ s̃t in seipsis un᷒ s̃t
inilloqͥun᷒ẽIpsũẽetiãtẽplũd̃i	in illo qͥ un᷒ ẽ Ipsũ ẽ etiã tẽplũ d̃i
deqͦapl̃s	de qͦ apl̃s
dicitTẽpenĩd̃isc̃mẽ	dicit Tẽp enĩ d̃i sc̃m ẽ
q̃destisuosOm̃sqͥcredd̃tinxp̃m	q̃d estis uos Om̃s qͥ credd̃t in xp̃m
&siccred̃tut	& sic cred̃t ut
diliganthocẽcredeinxp̃mdiligerexp̃mNON	diligant hoc ẽ crede in xp̃m diligere xp̃m NON
qͦmͦdemonesfontẽuenirentnͥaliqͣdielauarent᷑Istũ	qͦmͦ demones fontẽ uenirent nͥ aliqͣ die lauarent᷑ Istũ
aut̃diempoti᷒	aut̃ diem poti᷒
adhocelectũqͦcenadñicaanniuersariecelebͣt᷑&qͥa	ad hoc electũ qͦ cena dñica anniuersarie celebͣt᷑ & qͥa
concessũẽhocbaptismũaccept᷑is,	concessũ ẽ hoc baptismũ accept᷑is ,
multicũhislauareuoluer̃ieiuniũqlaxarehisꝓut	multi cũ his lauare uoluer̃ ieiuniũq laxare his ꝓut
potuidisputati	potui disputati
moneoeaquę	moneo ea quę
locut᷒sũseruesqͣntũpotesutęccl̃ęd	locut᷒ sũ serues qͣntũ potes ut ęccl̃ę d
prudentẽacpacificũfiliũ	prudentẽ ac pacificũ filiũ
Aliaquęquę	Aliaquę quę
int̃rogastisidñs	int̃rogasti si dñs
uolueritalio	uoluerit alio
tẽporeexpediamEXPLIC̃LIB̃INCIPITII᷒	tẽpore expediam EXPLIC̃ LIB̃ INCIPIT II᷒
ADEVNDẼIAÑDEC̃SVETVDINEĘCCL̃ĘDILECTISSIMOfilioIanuario	AD EVNDẼ IAÑ DE C̃SVETVDINE ĘCCL̃Ę DILECTISSIMO filio Ianuario
AUgUSTINUSLectislitt͛istuisubimecõmonuistiutdebitũ	AUgUSTINUS Lectis litt͛is tuis ubi me cõmonuisti ut debitũ
redderẽderesiduisenodandisquestionib᷒qͣsiã	redderẽ de residuis enodandis questionib᷒ qͣs iã
longeañ	longe añ
quesiuerasgͣtissimũmͥatqkarissimũdesideriũIncipitsũmamagistͥ	quesiueras gͣtissimũ mͥ atq karissimũ desideriũ Incipit sũma magistͥ
alanideꝯfessioneetpenitenciaQuoniamcircaconfessionesaĩaꝝ	alani de ꝯfessione et penitencia Quoniam circa confessiones aĩaꝝ
ꝑicl̃asuntetdifficultatesqñemerguntId̃o	ꝑicl̃a sunt et difficultates qñ emergunt Id̃o
adhonoremd̃isc̃iqNicholaiadfr̃m	ad honorem d̃i sc̃iq Nicholai ad fr̃m
utilitatematqconfitentiũ	utilitatem atq confitentiũ
salutemtractatum	salutem tractatum
breuemdeconfessioneconpilauisubcertistitulissingl̃aq̃	breuem de confessione conpilaui sub certis titulis singl̃a q̃
circaꝯfessionemrequirũt᷑etincidũtcõcludensutfacili᷒lector	circa ꝯfessionem requirũt᷑ et incidũt cõcludens ut facili᷒ lector
q̃uelitualeatinuenireCui᷒tͣctat᷒rubricesuntheI	q̃ uelit ualeat inuenire Cui᷒ tͣctat᷒ rubrice sunt he I
capitulumQͦtemꝑeinceꝑitꝯfessioIIQuaresitinstituta	capitulum Qͦ temꝑe inceꝑit ꝯfessio II Quare sit instituta
confessioIIICuifaciendasitconfessioQuando	confessio III Cui facienda sit confessio Quando
sitconfitendumVQueprecipueĩ	sit confitendum V Que precipue ĩ
ꝯfessiõereqͥrũt᷑VI	ꝯfessiõe reqͥrũt᷑ VI
Q̃sintnecc̃aaduerãpeñiam	Q̃ sint necc̃a ad uerã peñiam
VIIDeallocutiõesac͛dotisetĩductiõeadꝯfitẽd̃VIIIDe	VII De allocutiõe sac͛dotis et ĩductiõe ad ꝯfitẽd̃ VIII De
cirꝯstanciisquaspcc̃or	cirꝯstanciis quas pcc̃or
tenet᷑ꝯfiteriIXUtrumcirꝯstancie	tenet᷑ ꝯfiteri IX Utrum cirꝯstancie
agrauentpcc̃mXDe	agrauent pcc̃m X De
int̃rogationibasac̃dotefaciendisXIDegeneribusabusionumXIIDe	int̃rogationib a sac̃dote faciendis XI De generibus abusionum XII De
officioet	officio et
debitosac̃dotisergapenitẽtesXIII	debito sac̃dotis erga penitẽtes XIII
Qͥspcc̃adimͭtatetꝑq̃	Qͥs pcc̃a dimͭtat et ꝑ q̃
mortaliasiue	mortalia siue
uenialiadimittãt᷑XIIIIDemodopenitencieꝓquolibet	uenialia dimittãt᷑ XIIII De modo penitencie ꝓ quolibet
peccatoXVQuedebentconsiderari	peccato XV Que debent considerari
ininposionepenitencieNon·H·nosmip̃osdicamuss	in inposione penitencie Non ·H· nosm ip̃os dicamus s
ih̃mxp̃mdominũnr̃mnoᷤ	ih̃m xp̃m dominũ nr̃m noᷤ
aũseruosur̃osꝑih̃mqm̃d̃s	aũ seruos ur̃os ꝑ ih̃m qm̃ d̃s
qͥdixitdetenebris	qͥ dixit de tenebris
lucẽsplendesc̃eipseillux̃incordibnr̃isadilluminacionẽscĩe	lucẽ splendesc̃e ipse illux̃ in cordib nr̃is ad illuminacionẽscĩe
claritatisd̃iinfaciexͥih̃unedicogl̃iexp̃i	claritatis d̃i in facie xͥ ih̃u nedico gl̃ie xp̃i
non·H·⁊	non ·H· ⁊
c̃l̃itaꝯtinuaꝯm̃dam᷒nosinmanifestacione	c̃ l̃ ita ꝯtinua ꝯm̃dam᷒ nos in manifestacione
ũitatis⁊cet̃aͭaliafacimus	ũitatis ⁊ cet̃a ͭalia facimus
⁊h̃ꝓp̃xp̃mñ·H·di.nosmip̃os	⁊ h̃ ꝓp̃ xp̃m ñ ·H· di. nosm ip̃os
sih̃mxp̃mdo.nos..i.dicacionr̃anon	s ih̃m xp̃m do. nos. .i. dicacio nr̃a non
tenditadgl̃iamnr̃aml̃adlucra	tendit ad gl̃iam nr̃am l̃ ad lucra
nr̃asad	nr̃a s ad
gl̃iamxͥꝙ̃predicamussaluatorem	gl̃iam xͥ ꝙ̃ predicamus saluatorem
⁊dñmnr̃meẽillũ	⁊ dñm nr̃m eẽ illũ
dicam᷒eẽdñmNosaũ	dicam᷒ eẽ dñm Nos aũ
dñiseẽseruos.i.minisstrosur̃os	dñis eẽ seruos .i. minisstros ur̃os
⁊h̃ꝑxp̃m	⁊ h̃ ꝑ xp̃m
quinobish̃iniunx̃hocaut̃	qui nobis h̃ iniunx̃ hoc aut̃
facimusqm̃d̃sip.illux̃incor.	facimus qm̃ d̃s ip. illux̃ in cor.
no..i.seqͥẽlumennobisinfundit	no. .i. se qͥ ẽ lumen nobis infu n dit
qͥdixit	qͥ dixit
.i.ceptosolofecitlucem	.i. cepto solo fecit lucem
splend̃edetenebrisq̃d	splend̃e de tenebris q̃d
fuitĩseꝑacioneelem̃toꝝceꝑunt·H·	fuit ĩ seꝑacione elem̃toꝝ ceꝑunt ·H·
tenebreexquoꝯfusa	tenebre ex quo ꝯfusa
molesceli⁊t̃recep̃eẽañqͣmluxfc̃aeẽt	moles celi ⁊ t̃re cep̃ eẽ añqͣm lux fc̃a eẽt
quailluminaret᷑ꝙsñlucefuerattenebrosump᷒eaeuõ	qua illuminaret᷑ ꝙ sñ luce fuerat tenebrosum p᷒ea e uõ
accedenteluceꝙfc̃mestmeliusreddr᷑inqͦ	accedente luce ꝙ fc̃m est melius reddr᷑ in qͦ
ꝓficientishõisaffectio	ꝓficientis hõis affectio
sigc̃aturuñapl̃sloquẽstore	sigc̃atur uñ apl̃s loquẽs tore
&loquutusẽeismulta	& loquutus ẽ eis multa
inparabolisdicensExiit	in parabolis dicens Exiit
quiseminatseminare	qui seminat seminare
semensuumEtdumsemiminores	semen suum Et dum semi minores 
subditiĩeccl̃iaintelligunt᷑quiñascenduntin	subditi ĩ eccl̃ia intelligunt᷑ qui ñ ascendunt in
nauimñdumcelestibmisteriisimbuti	nauim ñdum celestib misteriis imbuti
cumxp̃oinꝑabolisLucasꝑsimilitudinẽq̃didem	cum xp̃o in ꝑabolis Lucas ꝑ similitudinẽ q̃d idem
ẽMarcus	ẽ Marcus
Dicebateisindoctrinasua	Dicebat eis in doctrina sua
Cap̃lxxiiExiitQuidiscipl̃isloq̃bat᷑	Cap̃ lxxii Exiit Qui discipl̃is loq̃bat᷑
sacramentaexiitseminareũbumdei	sacramenta exiit seminare ũbum dei
inturbas	in turbas
parabolasutiuxtauariasuoluntates	 parabolas ut iuxta uarias uoluntates
s.sentenciassuasdiũsasrecipiantdisciplinass.utuidentes	s.  sentencias suas diũsas recipiant disciplinas s. ut uidentes
ñuideantc̃Notatriplexẽ	ñ uideant  c̃ Nota  triplex ẽ
sem̃Sem̃seminatumpuluereecogitationisobscuretQue	sem̃ Sem̃ seminatum pulueree cogitationis obscuret Que
tamenñpulsarerectorisanimumnequeuntsfestinare	tamen ñ pulsare rectoris animum nequeunt s festinare
necesseestutrepugnatione	necesse est ut repugnatione
uincanturneuitiumquod	uincantur ne uitium quod
ꝑsuggestionemtemptatmolliciedelectationissubigat,cumqhec	ꝑ suggestionem temptat mollicie delectationis subigat , cumq hec
abanimotarderepelliturmucroneconsensus	ab animo tarde repellitur mucrone consensus
occidat.xiiiiSit	occidat . xiiii Sit
rectoroꝑationecipuusutuite	rector oꝑatione cipuus ut uite
uiamsubditisuiuendodenuncietgrexqui	uiam subditis uiuendo denunciet  grex qui
pastorisuocẽmoresqsequiturꝑexemplameliusquãꝑ	pastoris uocẽ mores q sequitur ꝑ exempla melius quã ꝑ
u͛bagradiaturQuienimlocisuinecessitateexigitursummadic̃e	u͛ba gradiatur Qui enim loci sui necessitate exigitur summa dic̃e
haceadem	hac eadem
necessitateconpellitursummamonstrareIllanamquox	necessitate conpellitur summa monstrare Illa namq uox
faciemruboreuestietautpallore	faciem rubore uestiet aut pallore
confũdetcui᷒	confũdet cui᷒
labiacontrahenturautsalienttoxicabit᷑linguagenua	labia contrahentur aut salient toxicabit᷑ lingua genua
trementmanusꝓt̃uiet	trement manus ꝓt̃uiet
seip̃mnugisnr̃isconuincetobnoxiumInqͥbfuitꝓpositi	se ip̃m nugis nr̃is conuincet obnoxium In qͥb fuit ꝓpositi
semꝑanugisadbonatransire	semꝑ a nugis ad bona transire
seria⁊adidquoddecetautꝓdest	seria ⁊ ad id quod decet aut ꝓdest
restituereuitamQͥaut̃iustũrehensioni	restituere uitam Qͥ aut̃ iustũ rehensioni
locũuid̃iteaex	locũ uid̃it ea ex
caritatelicent̃utat᷑⁊	caritate licent̃ utat᷑ ⁊
deem̃dationemeaacquiratsibi⁊	de em̃datione mea acquirat sibi ⁊
possideatmiumuiteScioenĩquia	possideat mium uite Scio enĩ quia
inmultiloquio	in multiloquio
pecc̃mñdeestsinuito⁊incaritatedei	pecc̃m ñ deest s inuito ⁊ in caritate dei
exhortorlectorẽqͦmeimemorinorationibussuis	exhortor lectorẽ qͦ mei memor in orationibus suis
impetretutfiliusdeiuiui⁊	impetret ut filius dei uiui ⁊
uirginisintemeratedeushomomanifestet	uirginis intemerate deus homo manifestet
seipsũ	se ipsũ
⁊palamfaciat	⁊ palam faciat
uiamquanob̃incedendumẽinbñplacitosuo⁊	uiam qua nob̃ incedendum ẽ in bñplacito suo ⁊
dirigatin	dirigat in
eogressusnostrosAMeNQue	eo gressus nostros AMeN Que
aũLibersc̃emarie	aũ Liber sc̃e marie
pontiniaciFinitolibroreddantur	pontiniaci Finito libro reddantur
iuramagistroD̃squihodiernã	iura magistro D̃s qui hodiernã
diẽapl̃orumtuorumpetri&paulimartirioconsecrastidaeccl̃ie	diẽ apl̃orum tuorum petri & pauli martirio consecrasti da eccl̃ie
tueeorum	tue eorum
inomnibsequipreceptũꝑquosreligionissumpsitexordiũ	in omnib sequi preceptũ ꝑ quos religionis sumpsit exordiũ
ꝑsc̃rHostias	ꝑ sc̃r Hostias
dñequasnominituosacrandasofferimusapl̃ica	dñe quas nomini tuo sacrandas offerimus apl̃ica
ꝓsequaturoratioꝑquamnosexpiaINCIPITPREFACIO	ꝓsequatur oratio ꝑ quam nos expia INCIPIT PREFACIO
MAGISTRIGAUFRIDIMONEMUTENSISINhistoriaBRITONUMCUMmecũ	MAGISTRI GAUFRIDI MONEMUTENSIS IN historia BRITONUM CUM mecũ
multa⁊demultis	multa ⁊ de multis
sepiusanimoreuoluensinystoriamregũbritannieincideremin	sepius animo reuoluens in ystoriam regũ britannie inciderem in
mir̃q̃dĩframentionemquamdeeisGildas⁊beda	mir̃ q̃d ĩfra mentionem quam de eis Gildas ⁊ beda
luculentotͣctufecerantnichilde	luculento tͣctu fecerant nichil de
regibquianteincarnationẽ	regib qui ante incarnationẽ
xp̃iinhabitaũãtnichil⁊̃dearturo	xp̃i inhabitaũãt nichil ⁊̃ de arturo
cet̃isqcõpl̃ibquip᷒incarnationẽsucceᷤserũt	cet̃isq cõpl̃ib qui p᷒ incarnationẽ succeᷤserũt
repperissemetgestaeoꝝdignaet̃nitatislaudecõstarent⁊	repperissem et gesta eoꝝ digna et̃nitatis laude cõstarent ⁊
amultispopulisqͧasiinscͥptaiocunde⁊memorit̃dicentur	a multis populis qͧasi inscͥpta iocunde ⁊ memorit̃ dicentur
taliamͥ⁊detalibmultociens	tali a mͥ ⁊ de talib multociens
cogitantioptulit	cogitanti optulit
Walterusoxinefordensisarchidiacon᷒uirin	Walterus oxinefordensis archidiacon᷒ uir in
oratoriaarteatqinexoticisystoriiserudit᷒quendam	oratoria arte atq in exoticis ystoriis erudit᷒ quendam
britaBRitanniainsularumoctdentaliocceanoint̃gall	brita BRitannia insularum oct dentali occeano int̃ gall
niãsitadcccmiliainlong	niã sita dccc milia in long
inlatũcõtinensquicquidusuicongruitindeficient	in latũ cõtinens quicquid usui congruit in deficient
teministratOm̃i⁊enĩgeñcãposlatesparsos	te ministrat Om̃i ⁊ enĩ geñ cãpos late sparsos
h̃t⁊collpollenticultureaptos	h̃t ⁊ coll pollenti culture aptos
indiũsitateᷤ	in diũsitateᷤ
ubertateglebetp̃ribniũth̃t⁊	ubertate glebe tp̃rib niũt h̃t ⁊
nemorauniũsisgeñibrepleta⁊quoꝝ	nemora uniũsis geñib repleta ⁊ quoꝝ
insaltͥnandisanimaliũ	in saltͥ nandis animaliũ
pastib.ueniũt⁊auolantib.apib.ũsoꝝcoloꝝmelladistͥbuit	pastib. ueniũt ⁊ a uolantib. apib. ũsoꝝ coloꝝ mella distͥbuit
tasubaeriis	ta sub aeriis
montib.amenrentiainqͥb.fonteslucidiriuosleni	montib. amen rentia in qͥb. fontes lucidi riuos leni
murmuremann᷒suauissoporisinripisuenietisrequiem	murmure man n᷒ suauis soporis in ripis uenietis requiem
animabuestrisIugũenĩ	animab uestris Iugũ enĩ
meũsuaueestetonusmeum	meũ suaue est et onus meum
leueOm̃ips̃sempiternedeusadestomagnepietatistuemisteriis	leue Om̃ips̃ sempiterne deus adesto magne pietatis tue misteriis
adestosacramentiisetadcreandosnouospopl̃osquostibifons	adesto sacramentiis et ad creandos nouos popl̃os quos tibi fons
baptismacisparturitsp̃madoptionis	baptismacis parturit sp̃m adoptionis
emitteUt	emitte Ut
quodnostrehumilitatisgenrendumẽmisteriotueuirtutis	quod nostre humilitatis genrendum ẽ misterio tue uirtutis
inpleatureffectuperdominũ	inpleatur effectu per dominũ
DñsuobiscumEtcũsp̃utuo	Dñs uobiscum Et cũ sp̃u tuo
SursumcordaHabemus	Sursum corda Habemus
addominũGr̃asagamusdominodeonostro	ad dominũ Gr̃as agamus domino deo nostro
Dignũetiustumest	Dignũ et iustum est
prefatioUeredignũ&iustũest	prefatio Uere dignũ & iustũ est
equũ&salutareNoᷤtibisemꝑ&ubiqgr̃asagere	equũ & salutare Noᷤ tibi semꝑ & ubiq gr̃as agere
dñesc̃e	dñe sc̃e
pateromnipotenset̃ned̃sQuiinuisibilipotentiasa	pater omnipotens et̃ne d̃s Qui inuisibili potentia sa
sitcarnissubstãtiatestant᷑sepuᷝchraQuisparẽtumamicoꝝfideliũꝙͣlib&	sit carnis substãtia testant᷑ sepuᷝchra Quis parẽtum amicoꝝ fideliũ ꝙͣlib&
dilectisui	dilecti sui
tangerescaturienu͛mibcarnẽpotestCaroitaqcũ	tangere scaturien u͛mib carnẽ potest Caro itaq cũ
c̃cupiscitpset᷑qͥdsitexanimis	c̃cupiscit p set᷑ qͥd sit exanimis
&intelligit᷑qͥdamat᷑Nichilqͥppe	& intelligit᷑ qͥd amat᷑ Nichil qͥppe
sadedomãdũ	s ad edomãdũ
carnaliũdesid̃ioꝝappetitũual&quãuun᷒qͥsqhocq̃duiuũ	carnaliũ desid̃ioꝝ appetitũ ual& quã u un᷒qͥsq hoc q̃d uiuũ
diligitqualesitmortuũpensetConsid̃ata	diligit quale sit mortuũ penset Consid̃ata
&enĩcorruptione	&enĩ corruptione
carnaliciti᷒cognoscit᷑qͥaillicitecarocõcupiscit᷑	carnali citi᷒ cognoscit᷑ qͥa illicite caro cõcupiscit᷑
tabesdesid̃at᷑Benegͦdeluxriosi	tabes desid̃at᷑ Bene gͦ de lux riosi
m̃tedr̃ddulcedoilli᷒ũmis;	m̃te dr̃d dulcedo illi᷒ ũmis ;
qͥaisqͥindesid̃iocarliscorruptionis	qͥa is qͥ in desid̃io car lis corruptionis
exestuatadfetorẽputredinisanhelHecsic̃	exestuat ad fetorẽ putredinis anhel Hec sic̃
inhui᷒partist̃cieinitioꝓmisissememenisub	in hui᷒ partis t̃cie initio ꝓmisisse me me ni sub
breuitatetͣnscurriuteaqueinhocoꝑesec	breuitate tͣnscurri ut ea que in hoc oꝑe sec
turqͥamagnaobscuritateimplicatas̃topitulantd̃olatius	tur qͥa magna obscuritate implicata s̃t opitulant d̃o latius
disseranturExplicitlibersext᷒deciparsterciLibermontis	disserantur Explicit liber sext᷒ deci pars terci Liber mon tis
sanctmarieuermenuelatõem	sanct marie uer men uelatõem
Isqinitinere	Isq in itinere
cumꝓph̃amaGabumrepperissetqͣntaseadu͛sitas	cum ꝓph̃am aGabum repperisset qͣnta se adu͛sitas
iniherosolimismaneretaudiuitScriptum÷	in iherosolimis maneret audiuit Scriptum ÷
qͥppeq̃didemaGabuszonampaulisuispedib	qͥppe q̃d idem aGabus zonam pauli suis pedib
inserensdixitVirumcui᷒heczonaest	inserens dixit Virum cui᷒ hec zona est
sicalligabuntiniherusalemApauloaut̃	sic alligabunt in iherusalem A paulo aut̃
ꝓtinusrespondeturEgonõsolumalligarisetiammoriin	ꝓtinus respondetur Ego nõ solum alligari s etiam mori in
ihrl̃mparatussumꝓ	ihrl̃m paratus sum ꝓ
noĩeih̃uNeqenim	noĩe ih̃u Neq enim
ciosioremfatioaĩammeamqͣmmeꝑceptionegͥreuelationis	ciosiorem fatio aĩam meam qͣm me ꝑceptione gͥ reuelationis
iherosolimamꝑgensadũsacognoscittam̃hec	iherosolimam ꝑgens adũsa cognoscit  tam̃ hec
libent̃appetit	libent̃ appetit
Auditquetimeatsadhecardentioranhelat	Audit que timeat s ad hec ardentior anhelat
Moysesitaqadꝓsꝑa	Moyses itaq ad ꝓsꝑa
desuonil	de suo nil
habetcib	habet  cib
renititurneisr̃liticeplebipreferat᷑Paulusadadũsa	renititur ne isr̃litice plebi preferat᷑ Paulus ad adũsa
etiamexsuouotoduciturmaloꝝimminentiũ	etiam ex suo uoto ducitur  maloꝝ imminentiũ
cognitionẽꝑcipits	cognitionẽ ꝑcipit s
deuotionesp̃setiamadacriora	deuotione sp̃s etiam ad acriora
feruescitIllesentispotestatis	feruescit Ille sentis potestatis
gl̃amdeouoluitiubente	gl̃am deo uoluit iubente
declinareistedeoasꝑaduradisponente	declinare iste deo asꝑa  dura disponente
sestuduit	se studuit
adgrauiorapararePreeuntegͦutrorumqducũinfractauirtute	ad grauiora parare Preeunte gͦ utrorumq ducũ infracta uirtute
instituimurutsiobedientiepalmamapprehend̃eueracit̃	instituimur ut si obedientie palmam apprehend̃e ueracit̃
nitim᷑ꝓsꝑish᷒scl̃iculualatronibuulñata	nitim᷑ ꝓsꝑis h᷒ scl̃i culu a latronib uulñata
ꝑfidẽtrinitatxxiiiiin	ꝑ fidẽ trinitat xxiiii in
hocdeẜtoreꝑatuRAlius	hoc deẜto reꝑatuR Alius
ẜmoeod̃dQUihabitatinadiutorioaltissim	ẜmo eod̃ d QUi habitat in adiutorio altissim
inꝓtectiõedeicelicõmorabiturInclinauitaltissim᷒celosetdescẽditet	in ꝓtectiõe dei celi cõmorabiturInclinauit altissim᷒ celos et descẽdit et
adeodescẽditq̃dinsil̃itudinẽhoĩumfactusẽ	adeo descẽdit q̃d in sil̃itudinẽ hoĩum factus ẽ
ethabituinuẽtusut	et habitu inuẽtus ut
h̃oAdeodescẽditq̃d	h̃o Adeo descẽdit q̃d
submanu	sub manu
ẜuihũiliauitsebaptizandũuñ	ẜui hũiliauit se baptizandũ uñ
etbaptistacõtremuitcũ	et baptista cõtremuit cũ
uid̃etsub	uid̃et sub
manibsuisinclinricaputtrem̃dũ	manib suis inclinri caput trem̃dũ
regibetpotestatibadrandũ	regib et potestatib adrandũ
Adeohũiliauitseutcũieiunassetesuriret	Adeo hũiliauit se ut cũ ieiunass et esuriret
aususẽad	ausus ẽ ad
eũacced̃etẽptatouteisdẽiacul̃cofod̃etquibpͥmũhoĩem	eũ acced̃e tẽptatout eisdẽ iacul̃ cofod̃et quib pͥmũ hoĩem
seuiuũetuuln͛atũ	se uiuũ et uuln͛atũ
reliq̃ratsuictusẽtptatoretuiciteũaltissim᷒	reliq̃rat s uictus ẽ t ptator et uicit eũ altissim᷒
Squoadiutorio	S quo adiutorio
ususẽaltissimus	usus ẽ altissimus
uteũuinc͛etneusus	ut eũ uinc͛et ne usus
adiutoriopotẽtie	adiutorio potẽtie
sueNequaPossenĩstatĩ	sue NequaPoss enĩ statĩ
ꝯtereresathanã	ꝯterere sathanã
siuelletsumemoriammĩe	si uellet su memoriam mĩe
ignoratxliiCeperuntaũaqueminuip᷒	ignorat xlii Ceperunt aũ aque minui p᷒
centũquinqͣginta	centũ quinqͣginta
dies&requieuitarchasuꝑmontesarmenieIn	dies & requieuit archa suꝑ montes armenie In
epl̃aadysatiumSeruata	epl̃a ad ysatium Seruata
ũitatehystorieqͥdẽaliudq̃d	ũitate hystorie qͥd ẽ aliud q̃d
diluuiitemporegen᷒human᷒extͣarcham	diluuii tempore gen᷒ human᷒ extͣ archam
morituraduitãuͦinarchaseruaturnͥhocq̃d	moritur ad uitã uͦ in archa seruatur nͥ hoc q̃d
nc̃aꝑtecernimusquiainfidelesquosqextraeccl̃iamunda	nc̃ aꝑte cernimus quia in fideles quosq extra eccl̃iam unda
peccatisuiꝑimit&fidelessuos	peccati sui ꝑimit & fideles suos
infide&caritatesc̃eeccl̃ie	in fide & caritate sc̃e eccl̃ie
unitasqͣsiarcheconpagocustoditQueuidelicet	unitas qͣsi arche conpago custodit Que uidelicet
archadelignis	archa de lignis
inputͥbilibcõpingit᷑	inputͥbilib cõpingit᷑
defortib	 de fortib
animab&	animab &
inbonosuoꝑseũantibARchainquahoĩes&reptilia	in bono suo ꝑseũantib ARcha in qua hoĩes & reptilia
temporediluscameccl̃iamfigurauit	tempore dilu scam eccl̃iam figurauit
i&maliꝯueniuntꝑmixta	i & mali ꝯueniunt ꝑmixta
sitatefilioꝝsicom̃s	sitatefilioꝝ  sic om̃s
adfuttñom̃sꝑinmutatõemutem	ad f ut tñ om̃s ꝑ inmutatõem u tem
spiritalisgr̃eculpisexigducatViam	spiritalis gr̃e culpis exig ducat Viam
itaqsentisscgim᷒tc̃aũ	itaq sentis sc gim᷒ tc̃ aũ
discernem᷑cũac	discernem᷑ cũ ac
nerim᷒Boniuͦsisñmalisf	nerim᷒ Boni uͦ si sñ malis f
fectebonieẽñposs̃tmirgant᷑	fecte boni eẽ ñ poss̃t  mir gant᷑
Ip̃aaũsocietasmalo	Ip̃a aũ societas malo
tioẽbonoꝝ	tio ẽ bonoꝝ
TResfiliosnoe⁊iaphetarchacontinuitsDominicaprima	TRes filios noe ⁊ iaphet archa continuit s Dominica prima
inaduentudominicapl̃mcuSupermontemexcelsum	in aduentu domini capl̃m cu Super montem excelsum
ascendequieuuangelizas	ascende qui euuangelizas
syonexalta	syon ex alta
infortitudineuocemtuamqui	in fortitudine uocem tuam qui
euuangelyzashierusalemexaltanolitimeredicciuitatibiudeecce	euuangelyzas hierusalem ex alta noli timere dic ciuitatib iude ecce
deusuesterEccedies	deus uester Ecce dies
ueniuntdicitdominuset	ueniunt dicit dominus et
suscitabodauidgermeniustumetregnabitrexetsapiens	suscitabo dauid germen iustum et regnabit rex et sapiens
eritetfacietiuditiumetiustitiam	erit et faciet iuditium et iustitiam
interraethecestnomenquoduocabunteumdominus	in terra et hec est nomen quod uocabunt eum dominus
iustusnosterIn	iustus noster In
diebusillis	diebus illis
saluabituriudaetisrahelhabitabitconfidentesEthoc	saluabitur iuda et israhel habitabit confidentes Et hoc
estnomenymnus	est nomen ymnus
Conditoralmesyderumeternaluxcredentium	Conditor alme syderum eterna lux credentium
xpisteredemptoromniumexaudicessupplicumQuicondolensinteritu	xpiste redemptor omnium exaudi ces supplicum Qui condolens interitu
mortisperireseculumsaluastimundumlanguidumdonans	mortis perire seculum saluasti mundum languidum donans
reisremediumVergentemundiuespereutisponsusdethalamoegressus	reis remedium Vergente mundi uespere uti sponsus de thalamo egressus
honestissimauirginismatrisclausulaCuiusfortipotentiegenu	honestissima uirginis matris clausula Cuius forti potentie genu
curuanturomniacelestiaterrestria	curuantur omnia celestia terrestria
nutufatentursubditaOcasumsolcustodienslunapalloremretinens	nutu fatentur subdita Ocasum sol custodiens luna pallorem retinens
candorinastrisrelucenscertosobseruatlimitesTe	candor in astris relucens certos obseruat limites Te
deprecamuragyeuentureiudexseculiconserua	deprecamur agye uenture iudex seculi conserua
nosintemporehostisatelo	nos in tempore hostis a telo
perfidiLaushonoruirtusgloriadeo	perfidi Laus honor uirtus gloria deo
patriet	patri et
filiounacumsancto	filio una cum sancto
spirituinsempiternaseculaamenHoratecelidesuperetnubes	spiritu in sempiterna secula amen Horate celi desuper et nubes
pluantiustumaperiaturcertaetgerminet	pluant iustum aperiatur certa et germinet
saluatoremIneug̃ãEcce	saluatorem In eug̃ ã Ecce
nomendominiuenit	nomen domini uenit
delonIncipitterciusliberFictilis	de lon Incipit tercius liber Fictilis
intereauasisꝯpagesolutacarc̃ecorporeocognatisreddit᷒astͥsIlle	interea uasis ꝯpage soluta carc̃e corporeo cognatis reddit᷒ astͥs Ille
olĩquiꝓpteropẽꝯtͣitalaregnaPetrũlegaratadrianus	olĩ qui ꝓpter opẽ ꝯtͣ itala regna Petrũ legarat adrianus
ppͣꝑegitextremos	ppͣ ꝑegit extremos
inpacediesm̃itiqꝓbaticlerusapl̃icafecit	in pace dies m̃itiq ꝓbati clerus apl̃ica fecit
sedeleonem	sede leonem
cuisiin	cui si in
sublimiꝯstaret	sublimi ꝯstaret
adorsiorerũAdsacrũfueratfacil̃fortunacacumenS	adorsio rerũ Ad sacrũ fuerat facil̃ fortuna cacumen S
nonblandasatisnͨadomnẽꝓsꝑacasũSicin	non blanda satis nͨ ad omnẽ ꝓsꝑa casũ Sic in
mundanisabsqõi	mundanis absq õi
turbinereb	turbine reb
nͨmeraleticiaẽ	nͨ mera leticia ẽ
nͨletaoĩouoluptasPaxubinl̃larataẽubi	nͨ leta oĩo uoluptas Pax ubi nl̃la rata ẽ ubi
gl̃ianl̃laquieta⁊nl̃lussecur᷒honosexꝑtusinalto	gl̃ia nl̃la quieta ⁊ nl̃lus secur᷒ honos exꝑtus in alto
hocleoꝯscensu	hoc leo ꝯscensu
ẽquitutiorimatenebatHuncinequo	ẽ qui tutior ima tenebat Hunc in equo
cũiãpõpamducendosed̃etAppetiitmanuũuiolenta	cũ iã põpam ducendo sed̃et Appetiit manuũ uiolenta
iniectiotͣctũNequit̃⁊	iniectio tͣctũ Nequit̃ ⁊
sacrademaiestatereuulsũQuẽpredefunctipape	sacra de maiestate reuulsũ Quẽ predefuncti pape
excecareparentesExcitoꝯtraseducteturbineplebissumpserenͨex	excecare parentes Excito ꝯtra seducte turbine plebis sumpsere nͨ ex
ocl̃isablataluc̃naẽsc̃issimiꝯf̃dignat᷒ẽmulta	ocl̃is ablata luc̃na ẽ sc̃issimi ꝯf̃ dignat᷒ ẽ multa
miracl̃aoꝑari	miracl̃a oꝑari
ꝓlog᷒CVmuetustatisin	ꝓlog᷒ CVm uetustatis in
cõmodonouercanteresferesingulasobsolericõtingatcumnouemleꝓsos	cõmodo nouercante res fere singulas obsoleri cõtingat cum nouem leꝓsos
curationepotitosnõ	curatione potitos nõ
parumreosintellexerimus	parum reos intellexerimus
quiad̃igloriam	quia d̃i gloriam
tacueruntcum	tacuerunt cum
decimoreuertentedñm	decimo reuertente dñm
glorificantessuꝑhisqueaudiuim᷒⁊uidim᷒	glorificantes suꝑ his que audiuim᷒ ⁊ uidim᷒
queadño	que a dño
factamirabiliafueruntin	facta mirabilia fuerunt in
occl̃isur̃isposteDcomitenr̃o	occl̃is ur̃is poste D comite nr̃o
Richregeanglie	Rich rege anglie
uirouidelninenobilitatis	uiro uidel nine nobilitatis
noticuiinegregiaferitate	noti cui in egregia feritate
sibicontemporaneũiconparandũortasunmata	sibi contemporaneũ i conparandũ orta sun mata
⁊infamescont	⁊ infames cont
interhomineshuiusHacdecausaquiade	inter homines huius Hac de causa quia de
rcessione⁊assignatione	r cessione ⁊ assignatione
uersasꝑgerentconseꝑsonasQuidãenĩabanturioh̃em	uersas ꝑgerent conse ꝑsonas Quidã enĩ a bantur ioh̃em
iamdtiregisfratremregemsi	iam d ti regis fratrem regem si
uid̃isnudũoꝑieũ⁊pauꝑẽ⁊absqtectoinduc	uid̃is nudũ oꝑi eũ ⁊ pauꝑẽ ⁊ absq tecto induc
intab̃naculũ	in tab̃naculũ
tuumTuncerũpettemporanealuxtua⁊sanitatestuecito	tuum Tunc erũpet temporanea lux tua ⁊ sanitates tue cito
orient᷑Hocqͦqq̃dscͥptum	orient᷑ Hoc qͦq q̃d scͥptum
ẽinLxxmisitde	ẽ in Lxx misit de
bethelsarasar⁊ebeserrexnullusnr̃oꝝ	bethel sarasar ⁊ ebeser rex nullus nr̃oꝝ
potuitexponereNeq.enĩq̃dmaleuersũẽex	potuit exponere Neq. enĩ q̃d male uersũ ẽ ex
ebreoullarationeexplanaripot̃Quisẽenĩiste	ebreo ulla ratione explanari pot̃ Quis ẽ enĩ iste
sarasar⁊ebeserrexautcui᷒ꝓuincieaut	sarasar ⁊ ebeser rex aut cui᷒ ꝓuincie aut
inquaul̃dequa	in qua ul̃ de qua
misitbethelautcui᷒bethelrexeẽpoteratebeser	misit bethel aut cui᷒ bethel rex eẽ poterat ebeser
queolimcũ	que olim cũ
iudeafuerat	iudea fuerat
destituta⁊eotpr̃nequaquãuocabat᷑bethelid	destituta ⁊ eo tpr̃ nequaquã uocabat᷑ bethel id
ẽdom᷒dñi	ẽ dom᷒ dñi
sbetauen.i.dom᷒ydoliHocqͦqq̃dseqͥr	s betauen .i. dom᷒ ydoli Hoc qͦq q̃d seqͥr
ingressaẽinm̃seqͥntosc̃ificatiosic̃fecerantiamꝑ	ingressa ẽ in m̃se qͥnto sc̃ificatio sic̃ fecerant iam ꝑ
multosannossicconant᷑	multos annos sic conant᷑
exponeresc̃ificationẽingressãuasatẽpliq̃anabucodonosorfuerant	exponere sc̃ificationẽ ingressã uasa tẽpli q̃ a nabucodonosor fuerant
sublatainillotpr̃restitutaDequintiaut̃⁊	sublata in illo tpr̃ restituta De quinti aut̃ ⁊
septimiieiuniotemptauer̃referreaddiesebdomadisS	septimi ieiunio temptauer̃ referre ad dies ebdomadis S 
seqͥrdecimiieiuniumcõpulsis̃tadm̃sesreferre	seqͥr decimi ieiunium cõpulsi s̃t ad m̃ses referre
⁊q̃dsit	⁊ q̃d sit
ipsequinti⁊septimidecimũqm̃sisieiuniũomninosiluer̃	ipse quinti ⁊ septimi decimũq m̃sis ieiuniũ omnino siluer̃
utdeprioresim᷒explanationeꝯtenti⁊ñindignem᷑ad	ut de priore sim᷒ explanatione ꝯtenti ⁊ ñ indignem᷑ ad
falsoscommentantiũconatusqͥdeint̃pretationis	falsos commentantiũ conatus qͥ de int̃pretationis
erroreuener̃Etfactũẽu͛bum	errore uener̃ Et factũ ẽ u͛bum
dñiadzachariãdicensHecdic̃dñsexercituũdicens	dñi ad zachariã dicens Hec dic̃ dñs exercituũ dicens
Iudiciũiustũiudicate⁊	Iudiciũ iustũ iudicate ⁊
miscdĩam&Sr̃	miscdĩam & Sr̃
cartãcaritatiᷤ	cartã caritatiᷤ
Antequãabbatiecist̃cien.florereinciperentdomnus	Antequã abbatie cist̃cien. florere inciperent domnus
stephanusabbasetfr̃ssuiordinauerunt	stephanus abbas et fr̃s sui ordinauerunt
utnullomͦabbatieinalicui᷒antistitisdiocesifundarent᷑anteꝙͣ	ut nullo mͦ abbatie in alicui᷒ antistitis diocesi fundarent᷑anteꝙͣ
ip̃edecretumintercisterciensecenobiũ⁊ceteraexeo	ip̃e decretum inter cisterciense cenobiũ ⁊ cetera ex eo
nataexaratũ⁊confirmatũratum	nata exaratũ ⁊ confirmatũ ratum
habetꝓpterscandalũ	habet ꝓpter scandalũ
interpontficẽ⁊monachosdeuitandũInhocgͦdec͛to	inter pontficẽ ⁊ monachos deuitandũ In hoc gͦ dec͛to
dictifr̃smutue	dicti fr̃s mutue
pacisfutuꝝcauentesnaufragiũelucidaueruntet	pacis futuꝝ cauentes naufragiũ elucidauerunt et
statuer̃suisqposterisreliquer̃	statuer̃ suisq posteris reliquer̃
quopactoquouemͦimmo	quo pacto quoue mͦ immo
quacaritatemonachieoꝝꝑabbatiasindiu͛sis	qua caritate monachi eoꝝ ꝑ abbatias in diu͛sis
mundipartibcorporibdiuihomiñsubregularidisciplina	mundi partib corporib diui homiñ sub regulari disciplina
ordinaueritnullãterrenecõmoditatisseureꝝtẽporaliũexactionẽimponimusProdesse	ordinauerit nullã terrene cõmoditatis seu reꝝ tẽporaliũ exactionẽ imponimus Prodesse
enĩill̃õibqsc̃eeccl̃ie	enĩ ill̃ õibq sc̃e eccl̃ie
filiiscupientesnilquodeosgrauetnilq̃d	filiis cupientes nil quod eos grauet nil q̃d
eorũsubstantiãminuatergaeosag̃e	eorũ substantiã minuat erga eos ag̃e
disponim᷒nedũnoshabundãtesdeeoꝝpauꝑtate	disponim᷒ ne dũ nos habundãtes de eoꝝ pauꝑtate
eẽcupim᷒	eẽ cupim᷒
auariciemalũ	auaricie malũ
q̃dscd̃mapl̃mydoloꝝ	q̃d scd̃m apl̃m ydoloꝝ
seruituscomꝓbatur	seruitus comꝓbatur
euitarenonpossim᷒Curãtñaĩaꝝilloꝝgr̃acaritatis	euitare non possim᷒ Curã tñ aĩaꝝ illoꝝ gr̃a caritatis
retinereuolumusutsiqnͦ	retinere uolumus ut si qnͦ
asc̃oꝓpositoet	a sc̃o ꝓposito et
obseruantiasc̃eregl̃edeclinareq̃dabsittẽptau͛ĩtꝑ	obseruantia sc̃e regl̃e declinare q̃d absit tẽptau͛ĩt ꝑ
nr̃amsollicitudinẽadrecINdominoconfidoquomodoanime	nr̃am sollicitudinẽ ad rec IN domino confido quomodo anime
meetransmigra	mee transmigra
inmosicut	in mo sicut
passerQuoniameccepeccatoresintenarcum	passer Quoniam ecce peccatores inten arcum
paraueruntsagittassuretrautsagittentinobscuroreQuoniam	parauerunt sagittas su retra ut sagittent in obscuro re Quoniam
queꝑfecistidestruxerustus	que ꝑfecisti destruxeru stus
autemquidfecit	autem quid fecit
Dominusintemplosanctosuoincelosedeseius	Dominus in templo sancto suo in celo sedes eius
Oculieiusinpauꝑemrespiciuntbreeiusinterrogãtfilios	Oculi eius in pauꝑem respiciunt bre eius interrogãt filios
homiDominusinterrogatiustumetquiautemdiligitiniquitateanimam	homi Dominus interrogat iustum et qui autem diligit iniquitate animam
suamPluet	suam Pluet
suꝑpeccatores	suꝑ peccatores
laqueosierisdabotͥ	laqueos i eris dabo tͥ
licdimidiũregnimeiQͤc̃exiss	lic dimidiũ regni mei Qͤ c̃ exiss
dix̃matͥsueQͥdpetãetilladix̃cap̃	dix̃ matͥ sue Qͥd petã et illa dix̃ cap̃
ioh̃isbabtisteCũqĩtͦissstatĩc̃	ioh̃is babtiste Cũq ĩtͦiss statĩ c̃
festinatiõeaRegẽpetiũdicẽsUoloutꝓtin᷒des	festinatiõe a Regẽ petiũ dicẽs Uolo ut ꝓtin᷒ des
mͥĩdisco	mͥ ĩ disco
caputiohannisbabtisteEtꝯtͥstatu᷒÷Rexꝓpt̃	caput iohannis babtiste Et ꝯtͥstatu᷒ ÷ Rex ꝓpt̃
i᷒iurãdũ⁊ꝓpt̃simulrecũbẽtes	i᷒iurãdũ ⁊ ꝓpt̃ simul recũbẽtes
noluiteãꝯtͥstareSmissospiculatorecep̃afferricap̃	noluit eã ꝯtͥstare S misso spiculatore cep̃ afferri cap̃
ei᷒ĩdisco	ei᷒ ĩ disco
Etdecollaũeũĩcarc̃e⁊adtulitcap̃	Et decollaũ eũ ĩ carc̃e ⁊ adtulit cap̃
ei᷒ĩdisco	ei᷒ ĩ disco
⁊deditillud	⁊ dedit illud
puelle⁊puella	puelle ⁊ puella
deditMatͥsueQͦauditodiᷤscipl̃i	dedit Matͥ sue Qͦ audito diᷤscipl̃i
ei᷒uener̃⁊tul̃ũtcorp᷒ei᷒⁊	ei᷒ uener̃ ⁊ tul̃ũt corp᷒ ei᷒ ⁊
posuer̃illd̃ĩmonum̃to	posuer̃ illd̃ ĩ monum̃to
Etegͤss᷒÷ih̃s⁊discipl̃iei᷒ĩ	Et egͤss᷒ ÷ ih̃s ⁊ discipl̃i ei᷒ ĩ
castellacesareephilippi	castella cesaree philippi
&ĩuiaĩt̃rogabat	& ĩ uia ĩt̃rogabat
discipl̃oᷤsuoᷤdicẽseis	discipl̃oᷤ suoᷤ dicẽs eis
QͤmmedicũthoĩneseẽQͥrespõd̃ũt	Qͤm me dicũt hoĩnes eẽ Qͥ respõd̃ũt
illidicẽtesioh̃m	illi dicẽtes ioh̃m
babtistãAlii	babtistã Alii
heliãAliiuͦqͣsiunũde	heliã Alii uͦ qͣsi unũ de
ꝓph̃isTc̃dic̃ill̃Vosuͦqͤmmedicitiᷤeẽ	ꝓph̃is Tc̃ dic̃ ill̃ Vos uͦ qͤm me dicitiᷤ eẽ
RespõdẽsPetr᷒aiteiTues	Respõdẽs Petr᷒ ait ei Tu es
xp̃sEtꝯminat᷒÷eisne	xp̃s Et ꝯminat᷒ ÷ eis ne
cͥdic̃ẽtd̃illo	cͥ dic̃ẽt d̃ illo
&ĩt̃rogabãteũdicẽtes	& ĩt̃rogabãt eũ dicẽtes
Qͥdgͦdicũt	Qͥd gͦ dicũt
pharisei⁊scͥbeqͥaheliãoꝑt	pharisei ⁊ scͥbe qͥa heliã oꝑt
pͥmũvenireQͥRespõdẽsaitill̃Heliasc̃ueñitpͥmo	pͥmũ venire Qͥ Respõdẽs ait ill̃ Helias c̃ ueñit pͥmo
restituetõia&qͦmͦ	restituet õia & qͦmͦ
scͥptũ÷ĩfiliũhõiᷤ	scͥptũ ÷ ĩ filiũ hõiᷤ
ũml̃tapaciat᷑⁊ꝯtẽpnat᷑Sdicouob̃qͥa	ũ ml̃ta paciat᷑ ⁊ ꝯtẽpnat᷑ S dico uob̃ qͥa
⁊heliasveñ⁊fec̃ũtilliq̃c̃quoluer̃sic̃	⁊ helias veñ ⁊ fec̃ũt illi q̃c̃q uoluer̃ sic̃
scͥptũ÷deeoExplicith̃scͥpsit	scͥptũ ÷ de eo Explicit h̃ scͥpsit
Barmari᷒ãnoMͦCCͦXIIIͦint̃dũ⁊forteꝗasanitas	B armari᷒ ãno MͦCCͦXIIIͦ int̃dũ ⁊ forte ꝗa sanitas
ul̃infirmitascõporisconsistitin	ul̃ infirmitas cõporis consistit in
quattuor⁊aĩeintͥbutpredixim᷒Iñẽquod	quattuor ⁊ aĩe in tͥb ut predixim᷒ Iñ ẽ quod
stolacorpõisdr̃dfut᷑ainquattuorꝓpͥetatibcorpõisgl̃ificati⁊	stola corpõis dr̃d fut᷑a in quattuor ꝓpͥetatib corpõis gl̃ificati ⁊
stolaaĩe	stola aĩe
pͥncipalit̃intͥbErũtenĩquattuorprincipales	pͥncipalit̃ in tͥb Erũt enĩ quattuor principales
dotescorpõisgl̃ificatis.subtilitas	dotes corpõis gl̃ificati s. subtilitas
⁊agilitassplendor⁊impassibilitasiux̃illd̃ĩlibro	⁊ agilitas splendor ⁊ impassibilitas iux̃ illd̃ ĩ libro
sap̃iefulgebũtiustisic̃solĩregͦpa.m̃i	sap̃ie fulgebũt iusti sic̃ sol ĩ regͦ pa. m̃i
⁊tãꝙͣscin.	⁊ tãꝙͣ scin.
ĩa.di.fulgeb̃tꝑsplẽdorẽsic̃solꝑĩmu	ĩ a. di. fulgeb̃t ꝑ splẽdorẽ sic̃ sol ꝑ ĩmu
tabilitatemadueritatẽsiueĩpassibilitatẽsolĩsuanat᷑a	tabilitatem ad ueritatẽ siue ĩpassibilitatẽ  sol ĩ sua nat᷑a
ẽĩmutabilis⁊ĩpassibil̃taꝙͣscĩtilleꝑsubtilitatẽ	ẽ ĩmutabilis ⁊ ĩpassibil̃ taꝙͣ scĩtille ꝑ subtilitatẽ
discũrẽtꝑagilitatẽHasqͣttuoͬꝓͥetatesgl̃ificati	discũrẽt ꝑ agilitatẽ Has qͣttuoͬ ꝓͥetates gl̃ificati
coͬꝑisĩ	coͬꝑis ĩ
argum̃tatiõefut᷑egl̃ificatiõis⁊̃ĩcaͬne	argum̃tatiõe fut᷑e gl̃ificatiõis ⁊̃ ĩ caͬne
moͬtalixᷤost̃nditclaritatẽqñ	moͬtali xᷤ ost̃ndit claritatẽ qñ
setͣnsfiguraũĩmõte⁊resplẽuntfaciesei᷒	se tͣnsfiguraũ ĩ mõte ⁊ resplẽunt facies ei᷒
sic̃solSubtilitatẽ	sic̃ sol Subtilitatẽ
qñclausosigͣcl̃ouirginalitãꝙͣspõsusꝓcessit	qñ clauso sigͣcl̃o uirginali tãꝙͣ spõsus ꝓcessit
detha.suoAgilitatẽsiueleuitatẽqñaliãlitt̃am	de tha. suo Agilitatẽ siue leuitatẽ qñ aliã litt̃am
ubinoshabem᷒quismundũdeinmundoconceptũinfans	ubi nos habem᷒ quis mundũ de inmundo conceptũ infans
uniusdieiẽsinepecc̃o⁊p	unius diei ẽ sine pecc̃o ⁊ p
m᷒naturafiliiireabhactñquipͥuilegiati	m᷒ natura filii ire ab hac tñ qui pͥuilegiati
fuer̃mũdatiañnatinut̃ismatrũutIer	fuer̃ mũdati añ nat in ut̃is matrũ ut Ier
emias⁊Ioannesquiexut̃omatrisQuoꝝ	emias ⁊ Io annes qui ex ut̃o matris Quoꝝ
utͥocPͥusquãte	utͥ oc Pͥus quã te
formarẽinut̃onouexiresd̃ũntresc̃ificauitequod	formarẽ in ut̃o nou exires d̃ ũntre sc̃ificaui te quod
⁊̃tendũtdeiacob⁊b̃atauͥgineq	⁊̃ tendũt de iacob ⁊ b̃ata uͥgine q
habeat᷑exssumVenialepecca	habeat᷑ exssum Veniale pecca
adillicitacitraconsensũratõiseẽnõ	ad illicita citra consensũ ratõis eẽ nõ
possumusꝗasemꝑIebuseint̃ranr̃a	possumus ꝗa semꝑ Iebuse in t̃ra nr̃a
quenob̃spinas⁊tͥbunitg͛minare	que nob̃ spinas ⁊ tͥbu nit g͛minare
d̃hocaitb̃atusioannesSi	d̃ hoc ait b̃atus io annes Si
dix̃imusquodpeccatũñ	dix̃imus quod peccatũ ñ
h̃emseducim᷒⁊ũitas	h̃em se ducim᷒ ⁊ ũitas
innob̃ñẽMorInepistolisbeatipauliapostoli	in nob̃ ñ ẽ Mor In epistolis beati pauli apostoli
PRIMUMQUERITURquareposteugl̃iaquesupplementũ	PRIMUM QUERITUR quare post eugl̃ia que supplementũ
legissunt⁊inquib᷒nobis	legis sunt ⁊ in quib᷒ nobis
exempla⁊ceptauiuendi	exempla ⁊ cepta uiuendi
plenissimedigestasuntuolueritapl̃shasepl̃asadsingulas	plenissime digesta sunt uoluerit apl̃s has epl̃as ad singulas
ęccl̃asdestinareHac	ęccl̃as destinare Hac
aut̃causauidet᷑	aut̃ causa uidet᷑
factũScilicetutinicionascentisęccl̃ęnouiscausis	factũ Scilicet ut inicio nascentis ęccl̃ę nouis causis
existentib&sentia⁊mienciaresequaretuicia⁊	existentib & sentia ⁊ miencia resequaret uicia ⁊
utpostfuturasexcluder&questionesexemplo	ut post futuras excluder& questiones exemplo
ꝓphetarũqͥposteditãlegẽ	ꝓphetarũ qͥ post editã legẽ
moysiinquaõiadeimandata	moysi in qua õia dei mandata
legebant᷑nichilomin᷒dedoctrinasuarediuiuasemꝑppl̃i	legebant᷑ nichilomin᷒ de doctrina sua rediuiua semꝑ ppl̃i
conpresserepeccata	conpressere peccata
tͣnsmigrationẽierl̃minmenseqͥntor̃Isti	tͣnsmigrationẽ ierl̃m in mense qͥnto r̃ Isti
suntdiesquosobseruaredebetistemꝑibussuis	sunt dies quos obseruare debetis temꝑibus suis
qͣrtadecimadieaduesꝑmpaschadñi	qͣrtadecima die ad uesꝑm pascha dñi
ẽ̃ĩqͥntadecimasollempnitatẽcelebrabitisaltissimodñoũLoquutus	ẽ ̃ ĩ qͥntadecima sollempnitatẽ celebrabitis altissimo dño ũ Loquutus
ẽdñsadmoysendicens	ẽ dñs ad moysen dicens
loquerefiliisisr̃ldicesadeosQͣrtal̃	loquere filiis isr̃l  dices ad eos Qͣrta l̃
scd̃aEtfc̃mẽũbumdominiadmedicensPriusꝙͣ	scd̃a Et fc̃m ẽ ũbum domini ad me dicens Priusꝙͣ
teformareminuteronouite	te formarem in utero noui te 
anteꝙͣexiresdeuuluasanctificauiteꝓph̃amingentib	anteꝙͣ exires de uulua sanctificaui te  ꝓph̃am in gentib
dediteEtdixi	dedi te Et dixi
a.a.a.dñe	a. a. a. dñe
deusEccenescioloqui	deus Ecce nescio loqui
pueregosumr̃Multiplicati	 puer ego sum r̃ Multiplicati
suntquitͥbulantme	sunt qui tͥbulant me 
dicuntñ	dicunt ñ
ẽsalusip̃iindeoer̃	ẽ salus ip̃i in deo er̃
Exurgedñesaluuᷤmefacdeusm̃uᷤQui	Exurge dñe saluuᷤ me fac deus m̃uᷤ Qui
tͥbulantmeexultabuntsimot᷒fuero	tͥbulant me exultabunt si mot᷒ fuero
egoaut̃ĩmĩatuasꝑauiEt	ego aut̃ ĩ mĩa tua sꝑaui Et
dix̃dominusad	dix̃ dominus ad
meNolidic̃epuersũl̃IIIͣExurgeqm̃	me Noli dic̃e  puer sũ l̃ IIIͣ Exurge qm̃
adõiaquemittamteibisuniũsaq̃cumq	ad õia que mittam te ibis  uniũsa q̃cumq
mandauerotͥloquerisNetimeasafacieeoꝝtecum	mandauero tͥ loqueris Ne timeas a facie eoꝝ  tecum
egosumuteruamtedicitdic̃dominusEtmisit	ego sum ut eruam te dicit dic̃ dominus Et misit
dominusmanũsuam	dominus manũ suam 
tetigitosmeumr̃Quicustodiebantaĩammeam	tetigit os meum r̃ Qui custodiebant aĩam meam
ꝯsiliũfecer̃tĩunumdicentesD̃sdereliqͥteum	ꝯsiliũ fecer̃t ĩ unum dicentes D̃s dereliqͥt eum
ꝑseqͥminiꝯhenditeeumñ	ꝑseqͥmini  ꝯhendite eum  ñ
ẽqͥlibereteumdeusm̃sneelongesa	ẽ qͥ liberet eum deus m̃s ne elonges a
medeusm̃sĩadiutoriũ	me deus m̃s ĩ adiutoriũ
meumĩtendeũOmnesinimici	meum ĩtende ũ Omnes inimici
meiadũsummedicentesD̃sl̃iiiiͣEt	mei adũsum me dicentes D̃s l̃ iiiiͣ Et
dix̃dominusadmeEccedediũba	dix̃ dominus ad me Ecce dedi ũba
meainoretuoecceconstituite	mea in ore tuo ecce constitui te
hodiesuꝑgentesegyptumetestoibi	hodie suꝑ gentes egyptum et esto ibi
usqdũdicamtͥFuturumẽenimutherodes	usq dũ dicam tͥ Futurum ẽ enim ut herodes
queratpuerũadꝑdendũ	querat puerũ ad ꝑdendũ
eumQuiconsurgensaccepitpuerũ	eum Qui consurgens accepit puerũ
⁊matremei᷒nocte	⁊ matrem ei᷒ nocte
etsecessitin	et secessit in
egiptũEteratibi	egiptũ Et erat ibi
usqadobitumherodisutadimpleret᷑q̃ddictũẽ	usq ad obitum herodis ut adimpleret᷑ q̃d dictũ ẽ
adñoꝑꝓph̃amdicentẽExegiptouocaui	a dño ꝑ ꝓph̃am dicentẽ Ex egipto uocaui
filiũmeumTuncherodesuidensqm̃illususeẽt	filiũ meum Tunc herodes uidens qm̃ illusus eẽt
amagisiratusest	a magis iratus est
ualdeEtmittensocciditom̃s	ualde Et mittens occidit om̃s
puerosqͥerantin	pueros qͥ erant in
bethleem⁊inom̃ibfinibei᷒abimatu	bethleem ⁊ in om̃ib finib ei᷒ ab imatu
⁊infrascd̃mtempusq̃dexquisieratamagisTuncadimpletum	⁊ infra scd̃m tempus q̃d exquisierat a magis Tunc adimpletum
ẽquoddictum	ẽ quod dictum
ẽꝑieremiamꝓph̃amdicentem	ẽ ꝑ ieremiam ꝓph̃am dicentem
Voxinramaauditaẽ	Vox in rama audita ẽ
ploratus⁊ululatusmultusrachel	ploratus ⁊ ululatus multus rachel
ploransfiliossuosEtnoluitconsolariquianonsunt.	plorans filios suos Et noluit consolari quia non sunt .
coll̃DeuscuiushodiernaInl̃aHerodesiratusoccidit	coll̃ Deus cuius hodierna In l̃ a Herodes iratus occidit
multospuerosinbethleemiude	multos pueros in bethleem iude
ciuitatedauidcap̃Uidisupͣmontẽsyonagnumstantẽet	ciuitate dauid cap̃ Uidi supͣ montẽ syon agnum stantẽ et
cũeocentumquadragintaqͣtuor	cũ eo centum quadraginta qͣtuor
miliahabentesnomeneiusetnom̃patͥs	milia habentes nomen eius et nom̃ patͥs
eiusscriptũinfrontibsuis	eius scriptũ in frontib suis
r̃ExultentiustiũIusti	r̃ Exultent iusti ũ Iusti
inꝑpetuumAdbñaHi	in ꝑpetuum Ad bñ a Hi
suntqui	sunt qui
cũmulierib	cũ mulierib
ñsuntcoinquinati	ñ sunt coinquinati
uͥginesenĩs̃t⁊secunt᷑agnũqͦcũqieritcoll̃	uͥgines enĩ s̃t ⁊ secunt᷑ agnũ qͦcũq ierit coll̃
utsupͣAd	ut supͣ Ad
iͣaAngl̃i	iͣ a Angl̃i
eorũsemꝑuident	eorũ semꝑ uident
faciempatrisAdiiiͣaVoxin	faciem patris Ad iiiͣ a Vox in
ramaaudita	rama audita
ẽplorat᷒⁊ululat᷒rachelploransfiliossuoscap*	ẽ plorat᷒ ⁊ ululat᷒ rachel plorans filios suos cap *
⁊coll*sicutinl*Adviͣ	⁊ coll * sicut in l * Ad viͣ
aSubthronod̃i	a Sub t h rono d̃i
sc̃iclamabantuindicasanguinẽ	sc̃i clamabant uindica sanguinẽ
nr̃md̃s	nr̃m d̃s
nr̃capitulumHiisuntquicũmulieribñ	nr̃ capitulum Hii sunt qui cũ mulierib ñ
suntcoinquinatiuirginesenĩsunt	sunt coinquinati uirgines enĩ sunt
hisecunt᷑agnũqͦcũqierituoĩ	hi secunt᷑ agnũ qͦcũq ierit uo ĩ
feudumñsuccedatnisipriusddominosat̃fec̃itp̃rimodo	feudum ñ succedat nisi prius d domino sat̃fec̃it p̃ri modo
ꝓõib.idomesticissuishoc	ꝓ õib. i domesticis suis hoc
faciatIllud	faciat Illud
quocipimusutsi	quo cipimus ut si
uassallusdefeudosuoaliumuassallũh̃ũit	uassallus de feudo suo alium uassallũ h̃ũit
etuassalusuassallidñmdñisuioffẽd̃itnisi	et uassalus uassalli dñm dñi sui offẽd̃it nisi
ꝓẜuitõalt̃ius	ꝓ ẜuitõ alt̃ius
dominisuih̃fec̃itq̃msñfraudeañah̃ũitfeudo	domini sui h̃ fec̃it q̃m sñ fraude aña h̃ũit feudo
suoppriuetur⁊addñmsuũ	suo p priuetur ⁊ ad dñm suũ
aquoip̃e	a quo ip̃e
tenebatreũtaturnisirequisitusabeopactusfũit	tenebat reũtatur nisi requisitus ab eo pactus fũit
sat̃fac̃emaioridño	sat̃fac̃e maiori dño
ꝙ̃offendit⁊nisiuassallusid̃asuodomino	ꝙ̃ offendit ⁊ nisi uassallus id̃ a suo domino
requisituseũquimaiorẽdominũoffenditrequisieritut	requisitus eũ qui maiorẽ dominũ offendit requisierit ut
satisfaciatsuumfeudũamittatt̃easi	satis faciat suum feudũ amittat t̃ea si
defeudoint̃duosuassallossit	de feudo int̃ duos uassallos sit
ꝯtroũsiadominisitꝯgnitõ	ꝯtroũsia domini sit ꝯgnitõ
⁊pereum	⁊ per eum
ꝯtroũsiat̃mineturSiuõĩt̃dñm	ꝯtroũsia t̃minetur Si uõ ĩt̃ dñm
etuassallũlisoriat᷑ꝑpares	et uassallũ lis oriat᷑ ꝑ pares
curieaddomĩo	curie a d domĩo
s̃odebitofidelitatis	s̃o debito fidelitatis
ꝯiuraitost̃mineturIlludquo	ꝯiuraitos t̃minetur Illud quo
s̃cimuᷤutinomnisac̃m̃to	s̃cimuᷤ ut in omni sac̃m̃to
fidelitatisnominatiminmperatorexcipiaturExplicitliberautenticorumExplicit	fidelitatis nominatim inmperator excipiatur Explicit liber autenticorum Explicit
lib̃autenticorumvidebr̃siñfastidioamabr̃siñfatigatõe	lib̃ autenticorum videbr̃ siñ fastidio amabr̃ siñ fatigatõe
laudabr̃hocmun᷒ceterumquifuturisuntꝓm̃itis	laudabr̃ hoc mun᷒ ceterum qui futuri sunt ꝓ m̃itis
miorum⁊gradobonorũatq	miorum ⁊ grado bonorũ atq
gl̃iarumquisestydo᷒	gl̃iarum quis est ydo᷒
cogitareqͣntomag̃	cogitare qͣnto mag̃
dic̃etm̃fut᷑umsintñẽãbigend̃	dic̃e  tm̃ fut᷑um sint ñ ẽ ãbigend̃
atqita⁊̃bt̃ailla	atq ita ⁊̃ bt̃a illa
ciuitasmagnumin	ciuitas magnum in
sedonumuidebitq̃dnullisuperiorinullusinf̃iorinuidebitsic̃	se donum uidebit q̃d nulli superiori nullus inf̃ior inuidebit sic̃
ñĩuidẽtarchãgl̃isãgl̃icet̃iTamnollet	ñ ĩuidẽt archãgl̃is ãgl̃i cet̃i Tam nollet
eẽun᷒ꝗsqq̃dñaccepitqͣmuissitpacatissimouinculocõcordie	eẽ un᷒ꝗsq q̃d ñ accepit qͣmuis sit pacatissimo uinculo cõcordie
eiquiaccep̃obstrictusqͣmnecĩ	ei qui accep̃ obstrictus qͣm nec ĩ
corꝑeuultoculiu	corꝑe uult ocul i u
seẽquiẽdigituscummebrum	s eẽ qui ẽ digitus cum mebrum
utr̃qcontineattocipartispaccatacompagosicitaqhabebitdonũali	utr̃q contineat toci partispaccata compago sic itaq habebit donũ ali
aliomin	alio min
uthocqͦdonũh̃atneul̃it	ut hoc qͦ donũ h̃at ne ul̃it
ampliusviciaper	amplius vicia per
sapientiedoctͥnaalit̃	sapientie doctͥna alit̃
ꝑinsipiẽtispessimamuitãita⁊obliuiones	ꝑ insipiẽtis pessimam uitã ita ⁊ obliuiones
maloꝝdues̃tAlr̃eanamqobliuiscitur	maloꝝ due s̃t Alr̃ ea namq obliuiscitur
eruditus⁊doctus	eruditus ⁊ doctus
Alit̃expert⁊passIllesipericiam	Alit̃ expert ⁊ pass Ille si periciam
negligatistesimiseriacareat.Scd̃mhãcobliuiõe	negligat iste si miseria careat . Scd̃m hãc obliuiõe
quãpost̃iorelocoposuinõeruntmemoressc̃i	quã post̃iore loco posui nõ erunt memores sc̃i
preteritorummaloꝝCarebũteĩom̃ib.itaut	preteritorum maloꝝ Carebũt eĩ om̃ib. ita ut
penitdeleatureorumsensibusEt	penit deleatur eorum sensibus Et
tm̃potẽtia	tm̃ potẽtia
scĩeq̃m̃gñĩeiseritñsolũsua	scĩe q̃ m̃gñ ĩ eis erit ñ solũ sua
t̃itas⁊̃dãpñtoꝝeossẽpit̃ñmiẜiañlateb̃	t̃ita s ⁊̃ dãpñtoꝝ eos sẽpit̃ñ miẜia ñ lateb̃
ĩuocabim⁊uidebim᷒⁊am̃bim᷒am̃bim᷒	ĩuocabim ⁊ uidebim᷒ ⁊ am̃bim᷒ am̃bim᷒
⁊laudabim᷒Ecceꝙer̃ĩfĩesũfine	⁊ laudabim᷒ Ecce ꝙ er̃ ĩ fĩe sũ fine
ExplicitHũclibꝝfec̃scͥbidñsBdecastãetod̃i	Explicit Hũc libꝝ fec̃ scͥbi dñs B de castãeto d̃i
gr̃aep̃salbieñannodñimͦcccͦorganiciin	gr̃a ep̃s albieñ anno dñi mͦ cccͦ organici in
eodẽinstãtiinquodesunteẽ	eodẽ instãti in quo desunt eẽ
talisꝑsdesinitibi	talis ꝑs desinit ibi
esseaĩanecsequit᷑p̃phocq̃d	esse aĩa nec sequit᷑ p̃p hoc q̃d
inedeminstãtiibisitnõsit	in edem instãti ibi sit  nõ sit
necĩimoĩstãtipesuel	 nec ĩ imo ĩstãti pes uel
manusestꝑsul̃	manus est ꝑs ul̃
nõꝑsip̃iuscorꝑisutrumãimasit	nõ ꝑs ip̃ius corꝑis utrum ãima sit
simpliciorom̃ibaliisformisSEcundoquerit᷑utrumaĩa	simplicior om̃ib aliis formis SEcundo querit᷑ utrum aĩa
sitsimplicõrom̃ibaliisformisvidet᷑q̃dnõ	sit simplicõr om̃ib aliis formis  videt᷑ q̃d nõ 
formaqueest	forma que est
plurib	 plurib
modiscõpoĩta	modis cõpoĩta
qͣmalieestꝯpositõriillissaĩahũana	qͣm alie est ꝯpositõr i illis s aĩa hũana
cõpoĩtaestexeẽeẽncia	cõpoĩta est ex eẽ  eẽncia
formeaut̃emq̃educit᷑	forme aut̃em q̃ educit᷑
depotẽciamat͛ieñsũtexeẽ	de potẽcia mat͛ie ñ sũt ex eẽ
eẽnͣꝯpoĩtecũeisnõꝯpetateẽgͦ	 eẽnͣ ꝯpoĩte cũ eis nõ ꝯpetat eẽ gͦ
aĩaestcõpoĩcõreis	aĩa est cõpoĩcõr eis
Pͣeẽunũcõpoĩci᷒	Pͣ eẽ unũ cõpoĩci᷒
aliodicitqddqͦsdamgͣdus	alio dicit qdd qͦsdam gͣdus
snulliforͤsb̃alicõpetith̃re	s nulli forͤ sb̃ali cõpetit h̃re
gradusẜmeẽmͣcũquelib	gradus ẜm eẽmͣ cũ quelib
talissimplici	talis simplici 
ĩuariabl̃ieẽnͣcõsistatnec	ĩuariabl̃i eẽnͣ cõsistat nec
ẜmeẽq̃dh̃tinsb̃o	ẜm eẽ q̃d h̃t in sb̃o
cũsb̃mformesb̃alissitip̃mylegͦsaltẽ	cũ sb̃m forme sb̃alis sit ip̃m yle gͦ saltẽ
formissb̃alibaĩaip̃anõ	formis sb̃alib aĩa ip̃a nõ
eritsimplicõrpͣforͣillaq̃pot̃dicihoc	erit simplicõr pͣ forͣ illa q̃ pot̃ dici hoc
aliqͥdẽcõpoĩtõrillaq̃hocaͥddicinõpot̃	aliqͥd ẽ cõpoĩtõr illa q̃ hoc aͥd dici nõ pot̃
saĩahũanasinecorꝑepot̃	s aĩa hũana sine corꝑe pot̃
dicihoc	dici hoc
aͥdcũsitĩdiduũingen͛esb̃e	aͥd cũ sit ĩdiduũ in gen͛e sb̃e
gͦeritcõpoĩtõraliisformis	gͦ erit cõpoĩtõr aliis formis
quibind̃iduatõsinemͣuelcorꝑe	quib ind̃iduatõ sine mͣ uel corꝑe
nõtingitꝯͣriũestaug̃VIdetͥni.caͦVI	nõ tingit ꝯͣriũ est aug̃ VI de tͥni. caͦ VI
uͥdicitq̃dcreaturasp̃ualis	uͥ dicit q̃d creatura sp̃ualis
sic̃estaĩaincõrꝑatõequidẽcorꝑis	sic̃ est aĩa in cõ r ꝑatõe quidẽ corꝑis
simplicõrẽlicetĩcõꝑatõedeisitmultiplex	simplicõr ẽ licet ĩ cõꝑatõe dei sit multiplex  
quelalia	quel alia
formapotestdicicorꝑaliscũmole	forma potest dici corꝑalis cũ mole
corꝑisdiffundat᷑Id̃osequit᷑	corꝑis diffundat᷑ Id̃o sequit᷑
q̃daĩaaliisformissitsimplicõrR̃nsiodd̃q̃dtriasũt	q̃d aĩa aliis formis sit simplicõr R̃nsio dd̃q̃d tria sũt
illaqueadsimplicitaterequirũt᷑pͥmũ	illa que ad simplicitate requirũt᷑ pͥmũ
̃ĩd̃isibl̃itaqua·H·lib̃tatep᷒s̃t	̃ ĩd̃isibl̃ita qua ·H· lib̃tate p᷒s̃t
alioscorriꝑe	alios corriꝑe
dũtacitesibir̃ndentse	dũ tacite sibi r̃ndent se
ead̃corrigũtꝯmissiseqm̃	ead̃ corrigũt ꝯmissise qm̃
ñpͭhortatoreẽuiduitatisqͥꝯiugia	ñ pͭ hortator eẽ uiduitatis qͥ ꝯiugia
ftaũitIneuãg̃qͦꝓbat᷑eũqͥtͣbẽgestat	f taũit In euãg̃ qͦ ꝓbat᷑ eũ qͥ tͣbẽ gestat
ĩocl̃o	ĩ ocl̃o
suoñp᷒sefeseduc̃deocl̃ofr̃is	suo ñ p᷒se fes educ̃ de ocl̃o fr̃is
suiIt̃d̃dpcc̃oriãdixͭde᷒qr̃	sui It̃ d̃d pcc̃ori ã dixͭ de᷒ qr̃
tuenar.i᷒ticiaset	tu enar. i᷒ticias et
assũistest̃ͫm.ꝑos	assũis test̃ͫ m. ꝑ os
tuũEtẜgg̃ͫ	tuũ Et ẜ gg̃ͫ
c᷒uitadespic᷑ꝯre	c᷒ uita despic᷑ ꝯ re
statutdicatõꝯdẽpnet᷑hĩcẽ	stat ut dicatõ ꝯdẽpnet᷑ hĩc ẽ
eĩꝙysaias	eĩ ꝙ ysaias
adñoaddicand̃mittend᷒pͥ᷒abtatemũda᷑et	a dño ad dicand̃ mittend᷒ pͥ᷒ ab tate mũda᷑ et
ose᷒calcl̃otãgi᷑qͥforcipetolli᷑de	os e᷒ calcl̃o tãgi᷑ qͥ forcipe tolli᷑ de
altaripri᷒gͥdebsac̃dotes	altari pri᷒ gͥ deb sac̃dotes
erratasuacorrig̃ep᷒moͫ	errata sua corrig̃e  p᷒moͫ
adalienadiluendafestĩarNãgall᷒pͥ᷒se	ad aliena diluenda festĩar Nã  gall᷒ pͥ᷒ se
ipͫalaꝝũb̃ecorripitdeiñad	ipͫ alaꝝ ũb̃e corripit  deiñ ad
horascinendasceditsac̃dotes	horas cinendas cedit sac̃dotes
·H·pler̃exemͦsuepassiõisaccendũtqͦss̃uitdoctͥne	 ·H· pler̃ exemͦ sue passiõis accendũt qͦs s̃uit doctͥne
diuti᷒ꝯfͬmareñp᷒s̃tetuita	diuti᷒ ꝯfͬmare ñ p᷒s̃t et uita
disciplinisñerudita	disciplinis ñ erudita
exẽpreligiõisdesepr̃are	exẽp religiõis de se pr̃are
nescͭq̃	nescͭ q̃
ĩseip̃aexꝑimẽtoñdidicͭUt	ĩ se ip̃a exꝑimẽto ñ didicͭ Ut
guitaꝯũsaͦ	g uita  ꝯũsaͦ
ur̃airrehẽsibl̃isappareat	ur̃a irrehẽsibl̃is appareat
cet͛isluceatꝑplũexpedituͭ	 cet͛is luceat ꝑ plũ expedit uͭ
sitiuxͣeccͣmcellaur̃anl̃lusur̃marma	sit iuxͣ eccͣm cella ur̃a nl̃lus ur̃m arma
l̃glaad	l̃ gla ad
feriend̃feratnͥfortetpr̃guerrel̃exꝓbabl̃ic̃a	feriend̃ ferat nͥ forte tpr̃ guerre l̃ ex ꝓbabl̃i c̃a
timornl̃l᷒comã	timor nl̃l᷒ comã
nutͥatne	nutͥat ne
barbãetun᷒qͥscoronãtõsurãh	barbã et un᷒qͥs coronã  tõsurã h
ꝯgͧentesquas̃ꝯiugatiñbigamipͥuilegiocl̃icaliguaud̃e	ꝯgͧentes quas ̃ ꝯiugati ñ bigami pͥuilegio cl̃icali guaud̃e
tespubliceportentnl̃lusautcanũautauiũiocis	tes publice portent nl̃lus aut canũ aut auiũ iocis
ĩs͛uiatnl̃lutatibcrapulis.i.gulositatibuslitib	ĩs͛uiat nl̃lu tatib crapulis .i. gulositatibus litib
scurrilitatib᷒ꝑcussiõib᷒etblasfemiisunull᷒spͨtacl̃isaliqͥbq̃	scurrilitatib᷒ ꝑcussiõib᷒ et blasfemiis u null᷒ spͨtacl̃is aliqͥb q̃
autĩnuptiisautĩcenisfũitexhĩtersit	aut ĩ nuptiis aut ĩ cenis fũit exh ĩtersit
spõpasscl̃iꝯuiuia	s põpas scl̃i  ꝯuiuia
notapucafugiatpͥuatauͦñpudica	nota puca fugiat pͥuata uͦ ñ pudica
s⁊sobriacolatUn᷒qͥsur̃mdolosꝯiuratões	s ⁊ sobria colat Un᷒qͥs ur̃m dolos  ꝯiuratões
codiũeml̃atõesobtͤctatõesatĩuidiãeffugiatñ	c odiũ eml̃atões obtͤctatões at ĩuidiã effugiat ñ
uagisoc	uagis oc
effͤnatalĩguaautpetulãtifluidoqĩgestuĩcedats	effͤnata lĩgua aut petulãti fluidoq ĩ gestu ĩcedat s
puacueꝯdiã	pu ac ueꝯdiã
mẽtissĩplici	mẽtis sĩplici
h̃ituĩcessuq	h̃itu ĩcessuq
ost̃ndatobscenitatẽboꝝmẽbroꝝsic̃	ost̃ndat obscenitatẽ boꝝ  mẽbroꝝ sic̃
operũpẽit᷒execret᷑senioribdebitatob̃iamn	 operũ pẽit᷒ execret᷑ seniorib debit at ob̃iam n
ulloiactãciestudioseipͫattollat	ullo iactãcie studio se ipͫ attollat
bonismostudeat	bonis mo studeat 
abõibillicitiscoraclĩguãcorp᷒adeot̃re	ab õib illicitis cor ac lĩguã  corp᷒ adeo t̃re
ꝯsõis·H·iactãciaatĩmod̃atõabõis÷	ꝯs õis ·H· iactãcia at ĩmod̃atõ a bõis ÷
moribalienanull᷒	morib aliena null᷒
ꝑq̃dꝓuocem᷑adhũilitatemexemplosue	ꝑ q̃d ꝓuocem᷑ ad hũilitatem exemplo sue
conũsatõisꝑq̃dĩformem᷑adsc̃itatẽEtmemoriapassionis	conũsatõis ꝑ q̃d ĩformem᷑ ad sc̃itatẽ Et memoria passionis
ꝑq̃dincitemuradkaritatẽQͣrto	ꝑ q̃d incitemur ad karitatẽ Qͣrto
scribiturinhoctemplocordissp̃ualealphabetũsiue	scribitur in hoc templo cordis sp̃uale alphabetũ siue
sp̃ualisscripturaHecãscͥpturaq̃	sp̃ualis scriptura Hec ã scͥptura q̃
ibiscͥbiturtriplexests.	ibi scͥbitur triplex est s.
dictamĩafaciendoꝝ	dictamĩa faciendoꝝ
testiõadiuinoꝝbñficioꝝ	testiõa diuinoꝝ bñficioꝝ
ꝓpͥoꝝacc̃atõdelictoꝝDehiis	ꝓpͥoꝝ acc̃atõ delictoꝝ De hiis
tribusRIICIIGentesque	tribus R II C II Gentes que
legẽnõh̃ntnaturalr̃quelegissuntfaciunt	legẽ nõ h̃nt naturalr̃ que legis sunt faciunt
hi᷒legemnõhabentesipisibisuntlexqui	hi᷒ legem nõ habentes ipi sibi sunt lex qui
ostendũtopuslegisscriptũincordibsuisEcce	ostendũt opus legis scriptũ in cordib suis Ecce
pͥmũtest̃millisReddenteꝯscĩaipoꝝeccescd̃metintra	pͥmũ test̃m illis Reddente ꝯscĩa ipoꝝ ecce scd̃m et intra
secogitatõemaccusantiũul̃etiãdeffẽdenciũecce	se cogitatõem accusantiũ ul̃ etiã deffẽdenciũ ecce
terciumQuintodebent	tercium Quinto debent
pingicruces	pingi cruces
.i.assumipñieasꝑritatesqueqͥdem	.i. assumi pñie asꝑritates que qͥdem
debẽtinungiet	debẽt inungi et
igneillustrarinõ	igne illustrari  nõ
solumferende	solum ferende
suntpacienter	sunt pacienter
setiãlibent̃q̃dꝑunctionẽetardenter	s etiã libent̃ q̃d ꝑ unctionẽ et ardenter
perignemUñB᷒Quiminatur	per ignem Uñ B᷒ Qui minatur
terrorecrucemxp̃iportat	terrore crucem xp̃i portat
pacient̃qui	pacient̃ qui
ꝑficitĩspeportatlibent̃squiꝯsumaturin	ꝑficit ĩ spe portat libent̃ s qui ꝯsumatur in
karitateamplectitur	karitate amplectitur
iamardenterb̃multiuidentcrucesnr̃assnon	iam ardenter b̃ multi uident cruces nr̃as s non
uidentunctionesnr̃as	uident unctiones nr̃as
quigͥhocinse	qui gͥ hoc in se
habebitueretemplũadhonoremdeidedicatumeritDignusplane	habebit uere templũ ad honorem dei dedicatum erit Dignus plane
ĩquoxp̃sh̃itetꝑgr̃amuttand̃ineo	ĩ quo xp̃s h̃itet ꝑ gr̃am ut tand̃ in eo
habitatedignetur	habitate dignetur
ꝑgl̃amQ̃dipe	ꝑ gl̃am Q̃d ipe
nobisprestaredignet᷑Quiuiuitetregnat	nobis prestare dignet᷑ Qui uiuit et regnat
deusperom̃iascl̃ascl̃oꝝameNHicliberscriptus	deus per om̃ia scl̃a scl̃oꝝ ameN Hic liber scriptus
fuitapudcysterciumAnnodominimillesimoCCCͦ	fuit apud cystercium Anno domini mil lesimo CCCͦ
IIIIͦdecimokalẽdasmarciiExpliciuntlegende	IIIIͦ decimo kalẽdas marcii Expliciunt legende
sanctoꝝul̃passionale	sanctoꝝ ul̃ passionale
adbreuiatumScriptoremgratumfaciatd̃satqbeatum	adbreuiatum Scriptorem gratum faciat d̃s atq beatum
Etsibipͥmatumtribuatdeleatin	Et sibi pͥmatum tribuat deleat in
reatumamẽScriberequifecithunclibrumnon	reatum amẽ Scribere qui fecit hunc librum non
malefecitIllediuduretpostmortemsyderacuretamẽ	malefecit Ille diu duret post mortem sydera curet amẽ
Huncdegillento	Hunc de gillento
CscripsitnonpedelentoQuemdeusĩcelistradat	C scripsit non pede lento Quem deus ĩ celis tradat
manibmichaelisAMEN	manib michaelis AMEN
utrũtaliaob̃aꝯc̃ꝯstãciistalibbsͨsintd̃isa	utrũ talia ob̃a ꝯ c̃ꝯstãciis talibb sͨ sint d̃isa
s.ꝙaliqͥssicẽdispoĩt᷒ꝙtalebonũ	s. ꝙ aliqͥs sic ẽ dispoĩt᷒ ꝙ tale bonũ
nõfac̃etꝯtemplacõneminorisboniul̃	nõ fac̃et ꝯtemplacõne minoris boni ul̃
malissolũ	mali s solũ
cõtẽplatõnemaioris	cõtẽplatõne maioris
putaꝓuitãdodãpnoXIId̃nõ	puta ꝓ uitãdo dãpno XII d̃ nõ
iretadeccamsꝓ	iret ad eccam s ꝓ
uitãdauna	uitãda una
ũb̃atõneĩcapitl̃obñiretali᷒aut̃	ũb̃atõne ĩ capitl̃o bñ iret ali᷒ aut̃
sicestdispoĩt᷒	sic est dispoĩt᷒
ꝙtl̃ebonũopusnõfac̃etꝯtẽplatõnemaioris	ꝙ tl̃e bonũ opus nõ fac̃et ꝯtẽplatõne maioris
boniul̃malissolũminorisputaꝓ	boni ul̃ mali s solũ minoris puta ꝓ
uitãdaunaũb̃atõeĩcapl̃onõ	uitãda una ũb̃atõe ĩ capl̃o nõ
iretsꝓuitãdodãpnoamusionisXIId̃bñiret	iret s ꝓ uitãdo dãpno amusionis XII d̃ bñ iret
lñsinealt̃oilloꝝnã	l ñ sine alt̃o illoꝝ nã
sic̃ob̃a	sic̃ ob̃a
apuddiũsossich̃ntdiũsasc̃ꝯstãciasitaꝙ	apud diũsos sic h̃nt diũsas c̃ꝯstãcias ita ꝙ
iͤh̃tob̃m	iͤ h̃t ob̃m
ꝯtalic̃ꝯstanciailleueroaliatũc	ꝯ tali c̃ꝯstancia ille uero alia tũc
facilr̃pot̃im᷒ꝯꝑareact᷒adĩuicẽsi	facilr̃ pot̃im᷒ ꝯꝑare act᷒ ad ĩuicẽ si
uõc̃ꝯstãcie	uõ c̃ꝯstãcie
utͦbiqsĩttõisdeb̃etamitt̃etXIId̃si	utͦbiq sĩt tõis deb̃et amitt̃et XII d̃ si
·H·gͣuit̃pcc̃atcui᷒uolũtastẽtõneuilioris	·H· gͣuit̃ pcc̃at cui᷒ uolũtas tẽtõne uilioris
finisĩclinatpcc̃andũita	finis ĩclinat pcc̃andũ ita
m᷒ũtuose	 m᷒ ũtuose
aqͥexmi᷒bonofineĩclinat᷑afaciẽdũsi·H·	a qͥ ex mi᷒ bono fine ĩclinat᷑ afaciẽdũ si ·H·
ut̃qtaliũeq̃lũtarieul̃	ut̃q taliũ eq̃ lũtarie ul̃
ĩuolũtarieferaip̃mbonũuolitũ	ĩuolũtarie fera ip̃m bonũ uolitũ
ꝙͣntũadh̃nõur̃dmagisul̃	ꝙͣntũ ad h̃ nõ ur̃d magis ul̃
m᷒bñfa	m᷒ bñ fa
ꝙͣali᷒ẜrõmipi᷒	ꝙͣ ali᷒ ẜ rõm ipi᷒
uolũtariisꝯtĩgitexrõnec̃ꝯstãcie	uolũtarii s ꝯtĩgit ex rõne c̃ꝯstãcie
addUñsic̃fortitudoẽũtusnobꝙͣlib̃alitas	add Uñ sic̃ fortitudo ẽ ũtus nob ꝙͣ lib̃alitas 
auariciapei᷒	auaricia pei᷒
uꝙͣtimiditasamareẜ	u ꝙͣ timiditas  amare ẜ
rõnũcorꝑis	rõ nũ corꝑis
ẽmeli᷒ꝙͣamareext̃ioraẜrõmsb̃di	ẽ meli᷒ ꝙͣ amare ext̃iora ẜ rõm  sb̃di
ẜappeꝑamorẽĩordinatũbonisexb	ẜ appe ꝑ amorẽ ĩordinatũ bonis ex b
ẽpei᷒ꝙͣsb̃diẜappetitũANnodñiMͦ	ẽ pei᷒ ꝙͣ sb̃di ẜ appetitũ  ANno dñi Mͦ
CCͦNonagͦVͦnõfuitcelebratũcapͫ	CCͦ Nonagͦ Vͦ nõ fuit celebratũ capͫ
gñaleꝓpt̃mortẽueñabilispr̃ismagistriordinis	gñale ꝓpt̃ mortẽ ueñabilis pr̃is magistri ordinis
fr̃issteph̃idebisũcioquiobiitĩꝯuẽtuluchanoromane	fr̃is steph̃i debisũcio qui obiit ĩ ꝯuẽtu luchano romane
ꝓuĩcieĩ	ꝓuĩcie ĩ
festosc̃ececilieuirginiset	festosc̃e cecilie uirginis et
martirisAnnodñiMͦ	martiris Anno dñi Mͦ
CCͦNonagͦIIIIͦANnodñiMͦCCͦNonagͦVIͦcelebratũ	CCͦ Nonagͦ IIIIͦ ANno dñi Mͦ CCͦ Nonagͦ VIͦ celebratũ
fuitLXXIcapͫgñaleĩargẽtinaĩꝓuinciatheutõie	fuit LXXI capͫ gñale ĩ argẽtina ĩ ꝓuincia theutõie
inqͦcapͦfuitelc̃us	in qͦ capͦ fuit elc̃us
inmagistrũordinis	in magistrũ ordinis
ueñabilispater	ueñabilis pater
dñsfraterNycholausdetriuisioqͥtũc	dñs frater Nycholaus de triuisio qͥ tũc
eratpͥorꝓuĩcialislõbardieANnodñiMͦCCͦ	erat pͥor ꝓuĩcialis lõbardie ANno dñi Mͦ CCͦ
NonagͦVIIͦcelebratũfuitLXXII	Nonagͦ VIIͦ celebratũ fuit LXXII
capͫgñaleueneciisinꝓuĩcialõbardie	capͫ gñale ueneciis in ꝓuĩcia lõbardie
ANnodñiMͦCCCIͦcelebratumfuitLXXVcapͫgñale	 ANno dñi Mͦ CCCIͦ celebratum fuit LXXV capͫ gñale
colõieinꝓuĩcia	colõie in ꝓuĩcia
th̃otonieinquocapͦfuit	th̃otonie in quo capͦ fuit
elc̃usinmagistrũordinisfrat̃	elc̃us in magistrũ ordinis frat̃
B̃nard᷒deiuzicodyoc̃uasaceñdeꝓuĩcia	B̃nard᷒ de iuzico dyoc̃ uasaceñ de ꝓuĩcia
tholosanaquitũceratpͥor	tholosana qui tũc erat pͥor
ꝓuĩcialisꝓuĩcie	ꝓuĩcialis ꝓuĩcie
nõdũdiuiseANnodñiMͦCCCIIͦcelebratumfuit	nõdũ diuise ANno dñi Mͦ CCCIIͦ celebratum fuit
LXXVIcapͫgñalebononieĩꝓuĩcialõbardieafato	LXXVI capͫ gñale bononie ĩ ꝓuĩcia lõbardie a fato
magr̃o͛quiobiitpostdictũcapͫĩ	magr̃o ͛ qui obiit post dictũ capͫ ĩ
ꝯuẽtutreũensi	ꝯuẽtu treũensi
ĩꝓuĩciatheutonieXVͦkls̃octobrisinfesto	ĩ ꝓuĩcia theutonie XVͦ kls̃ octobris in festo
b̃tilamb̃tiANnodñiMͦ	b̃ti lamb̃ti ANno dñi Mͦ
CCCIIIIͦcelebratũfuit	CCCIIIIͦ celebratũ fuit
LXXVIIIcapͫgñale	LXXVIII capͫ gñale
tholosexp̃ianusIlleuerexp̃ianusestqͥom̃ibmĩam	tholose xp̃ianus Ille uere xp̃ianus est qͥ om̃ib mĩam
facitquinulla	facit qui nulla
oĩomouet᷑ĩiuriaquialienũdolorẽtãqͣmꝓpͥumsentit	oĩo mouet᷑ ĩiuria qui alienũ dolorẽ tãqͣm ꝓpͥum sentit
cui᷒mensãnl̃luspaup̃ignoratquicorãhõibingl̃ius	cui᷒ mensã nl̃lus paup̃ ignorat qui corã hõib ingl̃ius
habet᷑utcorãdeoangelisgl̃iet᷑quit̃rena	habet᷑ ut corã deo  angelis gl̃iet᷑ qui t̃rena
ꝯtempnitutpossith̃recelestiaqui	ꝯtempnit ut possit h̃re celestia qui
oppͥmiͭpauꝑẽsesentenõ	oppͥmiͭ pauꝑẽ se sente nõ
patit᷑quimis̃is	patit᷑ qui mis̃is
sb̃uenitquiad	sb̃uenit qui ad
fletumfletibꝓuocat᷑alienisq̃dbenefaciebatpaulus	fletum fletib ꝓuocat᷑ alienis q̃d bene faciebat paulus
quisĩfirmat᷑	quis ĩfirmat᷑ 
egouõĩfirmor	ego uõ ĩfirmor
aug̃liodeuitaxp̃ͥana	aug̃ lio de uita xp̃ͥana
xp̃ianinom̃illefrustͣ	xp̃iani nom̃ ille frustͣ
sortit᷑quixp̃mm̃imeĩmitat᷑quid·H·	sortit᷑ qui xp̃m m̃ime ĩmitat᷑ quid ·H·
tͥꝓdest	tͥ ꝓdest
uocariꝙnões	uocari ꝙ nõ es
nom̃uiuat	 nom̃ uiuat
cruxestatquemrtymagxim᷒ĩs̃natal̃dñiubi	crux est atque mrty magxim᷒ ĩ s̃ natal̃ dñi ubi
fidesũitasfxp̃saEsuriuit	fides ũitas f xp̃s a Esuriuit
xp̃sqͥom̃spasitiuitꝑquem	xp̃s qͥ om̃s pa sitiuit ꝑ quem
causat᷑ontusquisp̃ualit̃	causat᷑ on tus  qui sp̃ualit̃
paniserienciũfonsqsitientiũ	panis e rienciũ fonsq sitientiũ
at̃restͥ	a t̃restͥ
fatigat᷒est	fatigat᷒ est
quisenob̃uiãfecitĩcelũuelu	qui se nob̃ uiã fecit ĩ celũ uelu
mutuitobsurduit	mutuit  obsurduit
corãciantibꝑquẽmut᷒locusurd᷒audiuituinct᷒	corã ciantib ꝑ quẽ mut᷒ locu  surd᷒ audiuit uinct᷒
estdeĩfirmitatũuincl̃isnos	est de ĩfirmitatũ uincl̃is nos
solflagellat᷒est	sol flagellat᷒ est
quiom̃iflagloꝝdehoĩm	qui om̃i flag loꝝ de hoĩm
corꝑibexpulitfix᷒est	corꝑib expulit fix᷒ est
quicruciat᷒nr̃osfimortuu᷒estqͥ	qui cruciat᷒ nr̃os fi mortuu᷒ est qͥ
mortuossuscsresurrexitnũꝙͣmorituAcidisse	mortuos susc s  resurrexit nũꝙͣ moritu Acidisse
aliquẽĩmocredũtpectorabrachia⁊uultũipu	aliquẽ ĩmo credũt pectora brachia ⁊ uultũ ipu
gen᷒cibi⁊ex	gen᷒ cibi ⁊ ex
hocauctorexclamãdodicitgͦꝗd	hoc auctor exclamãdo dicit gͦ ꝗd
dic̃etpictaul̃quonõ	dic̃et picta ul̃ quo nõ
fugeretsiuidẽt	fugeret si uidẽt
hecmõstraquiabstinuitcũctisb.	hec mõstra qui abstinuit cũctis b.
tanꝙͣabhoĩenecindulsit	tanꝙͣ ab hoĩe nec indulsit
uentriom̃elegum̃qiͣ	uentri om̃e legum̃ qiͣ
dicatagorascredebatessemagnũ	dica tagoras credebat esse magnũ
nephasnocomed̃ehoĩegiptii	nephas no comed̃e hoĩ egiptii
sedmanducare	sed manducare
aĩalia⁊õialeguminaꝙforti᷒ẽĩ	aĩalia ⁊ õia legumina ꝙ forti᷒ ẽ ĩ
iinger̃eretardabat	i inger̃e retardabat
finitolibrositlaus⁊	finito libro sit laus ⁊
gl̃axp̃oam̃Isteliberquisenatori᷒uocat᷑	gl̃a xp̃o am̃ Iste liber qui senatori᷒ uocat᷑
fuitscͥpt᷒ꝑmenicolaũolimde	fuit scͥpt᷒ ꝑ me nicolaũ olim de
ꝑannodñimillͦcccͦviiͦindictiõevͣtp̃redñi	ꝑ anno dñi millͦ cccͦ viiͦ indictiõe vͣ tp̃re dñi
clem̃tispannoei᷒ẜomẽsisalis	clem̃tis p anno ei᷒ ẜo mẽsis alis
diexixͣ⁊fuitꝯpilat᷒quoad	die xixͣ ⁊ fuit ꝯpilat᷒ quo ad
lectinobilẽ⁊illustrẽuirũdñmGentilẽde	lecti nobilẽ ⁊ illustrẽ uirũ dñm Gentilẽ de
filiisursitpr̃suisenat᷒PAsceoues	filiis ursi tpr̃ sui senat᷒ P Asce oues
measinio.Sicutestinoꝑibmechanicis	meas in io. Sicut est in oꝑib mechanicis
itaestinoꝑibusnostresalutis	ita est in oꝑibus nostre salutis
suomodoSeduidemusquodqñ	suo modo Sed uidemus quod qñ
artifexaͥcuiusartis	artifex aͥcuius artis
mechãicedebetaͥcubiꝓficisci	mechãice debet aͥcubi ꝓficisci
instruitaͥꝙͤ	instruit aͥꝙͤ
deartesuapͤcipueet	de arte sua pͤcipue et
inforͣtcuicõmittitofficiũsuũpostrecessũsuũ	inforͣt cui cõmittit officiũ suũ post recessũ suũ
exeꝙͤdumSicfecitdñsih̃sxp̃sipe·H·qui	exeꝙͤdum Sic fecit dñs ih̃s xp̃s ipe ·H· qui
eratinhocmũdorectoretpastorouiũtocius	erat in hoc mũdo rector et pastor ouiũ tocius
gͤgiseccͤrecessurusamũdoetascensurusin	gͤgis eccͤ recessurus a mũdo et ascensurus in
celũlocosuiinstituitad	celũ loco sui instituit ad
regim̃suigregisb̃tm	regim̃ sui gregis b̃tm
apl̃msuũpetr̃etdemodoregisinforͣuit	apl̃m suũ petr̃ et de modo regis inforͣuit
dicenspasce	dicens pasce
ouesmeasinquibũbis	oues meas in quib ũbis
tͥanoͣnturpͥm̃estauctoͣspͤlatipͤsidentispascescd̃m	tͥa noͣntur pͥm̃ est auctoͣs pͤlati pͤsidentis pasce scd̃m
estcondc̃opp̃obedientisoues	est condc̃o pp̃ obedientis oues
t̃ciũestaffc̃oxͥꝯmͭtentisin	t̃ciũ est affc̃o xͥ ꝯ mͭtentis in
easobligacio	eas obligacio
pͤsidentisestin	pͤsidentis est in
subuẽiendocũsollicitudĩeCondc̃opp̃estinobediendocũmansuetudine	subuẽiendo cũ sollicitudĩe Condc̃o pp̃ est in obediendo cũ mansuetudine
affc̃ocõmͭtentisestin	affc̃o cõmͭtentis est in
cõmendandocũten͛itudĩe	cõmendando cũ ten͛itudĩe
Pͥm̃gͦquodnoͣturinũbisꝓpoĩtis	Pͥm̃ gͦ quod noͣtur in ũbis ꝓpoĩtis
estobligaciopͤlatipͤsidentisqueconsistitin	est obligacio pͤlati pͤsidentis que consistit in
subuẽiendocũsollicitudĩeinh̃quoddicit᷑pasce	subuẽiendo cũ sollicitudĩe in h̃ quod dicit᷑ pasce
Adhoc·H·obligant᷑pͤsidentes	Ad hoc ·H· obligant᷑ pͤsidentes
etpͤlatiutgͤgemsͥcõmissũsollicitepascantnõut	et pͤlati ut gͤgem sͥ cõmissũ sollicite pascant nõ ut
tondeantuel	tondeant uel
excorientde	excorient de
hocpͭexpõi	hoc pͭ expõi
quoddr̃dIͣpe.Vpascitequi	quod dr̃d Iͣ pe. V pascite qui
inuobisestgͤgemcõmissũs.pͣcõnisũbout	in uobis est gͤgem cõmissũ s. pͣcõnis ũbo ut
indilectionedeiet	in dilectione dei et
cogͥtionesuiꝓficiatcõũsacionis	cogͥtione sui ꝓficiat cõũsacionis
exonegͤgem	exo ne gͤgem
inuiamoꝝ	in uia moꝝ
errarefaciatAmbulateindilc̃onesicutet	errare faciat Ambulate in dilc̃one sicut et
xᷤdilexitnosad	xᷤ dilexit nos ad
ephesᷤVsapiensinꝓũbiis	ephesᷤ V sapiens in ꝓũbiis
uitamiusti	uitam iusti
cõꝑatluce	cõꝑat luce
.ꝓu͛biisiiiiiustoꝝ	. ꝓu͛ biis iiii iustoꝝ
semitaq.lux	semita q. lux
splendẽsproceditetcͤscitusadꝑfc̃mdiemlux	splendẽs procedit et cͤscit us ad ꝑfc̃m diem lux
aũdieisicseh̃tquodsemꝑcͤscitueldecͤscit	aũ diei sic se h̃t quod semꝑ cͤscit uel decͤscit
nõꝙͣin	nõꝙͣ in
eod̃statu	eod̃ statu
ꝑmanetSicestdeuitaiustisemꝑ·H·cͤsc̃	ꝑmanet Sic est de uita iusti semꝑ ·H· cͤsc̃
ueldecͤscitinbonosicutdicitBernardusin	uel decͤscit in bono  sicut dicit Ber nardus in
uiadeinõꝓgͤdiregͤdiest	uia dei nõ ꝓgͤdi regͤdi est
etidcircoapl̃usinũbisꝓpoĩtis	et idcirco apl̃us in ũbis ꝓpoĩtis
nonhortaturadꝓficiendũinuiamoꝝ	non hortatur ad ꝓficiendũ in uia moꝝ
dicẽsambulateetc̃Inquibusũbispͦnoshortaturapl̃usad	dicẽs ambulateetc̃ In quibus ũbis pͦ nos hortatur apl̃us ad
ꝓfectumcontinuũambulatescd̃osubditmodũꝯgruũin	ꝓfectum continuũ ambulate scd̃o subdit modũ ꝯgruũ in
dilectionedeit̃ciosubiũg̃exẽplũpͤcipuũSicutetxᷤ	dilectione dei t̃cio subiũg̃ exẽplũ pͤcipuũ Sicut et xᷤ
dilexitnos	dilexit nos
Primogͥ	Primo gͥ
noshortaturapl̃usad	nos hortatur apl̃us ad
ꝑfc̃mcontinuũcũ	ꝑfc̃m continuũ cũ
diciturambulatenõpedibus	dicitur ambulate nõ pedibus
corporissedoꝑibus	corporis sed oꝑibus
uirtutisꝑficiendos.de	uirtutis ꝑficiendo s. de
uirtuteinuirtutemnõ	uirtute in uirtutem nõ
iacendocũ	iacendo cũ
uoluptuosisꝑcarnalemcõcupĩamnõ	uoluptuosis ꝑ carnalem cõcupĩam nõ
sedendocũ	sedendo cũ
insidiosisꝑintentionismalitiamnõstãdocũaccidiosisperignauiam	insidiosis ꝑ intentionis malitiam nõ stãdo cũ accidiosis per ignauiam
etpigͥtiamnõ	et pigͥtiam nõ
equitandocũpõposisetambitiosis	equitando cũ põposis et ambitiosis
ꝑelacõmet	ꝑ elacõm et
suꝑbiamsedambulãdocũlaboriosiset	suꝑbiam sed ambulãdo cũ laboriosis et
festinantibusad	festinantibus ad
pr̃iamdeistoꝑfc̃ũambul̃onisdr̃d	pr̃iam de isto ꝑfc̃ũ ambul̃onis dr̃d
MicheeVIiudicabo	Michee VI iudicabo
tͥohomo	tͥ o homo
geliiSecunduMatheumixINillotp̃reAngl̃sdñi	gelii Secundu Matheum ix IN illo tp̃re Angl̃s dñi
apparuitinsõnisiosephdicẽs	apparuit in sõnis ioseph dicẽs
Surgeaccipepuerũet	Surge  accipe puerũ et
matrẽeius	matrẽ eius
fugein	 fuge in
egiptũestoibiusqdũdicamtibiEtrel̃	egiptũ  esto ibi usq dũ dicam tibi Et rel̃
homelialectiõiseiusdeminxp	homelia lectiõis eiusdem in xp
mamariũ	ma mari ũ
fidmẽeꝑpro	fid mẽ e ꝑ pro
reddramꝑegͥnusꝑficiopericl̃mperiuriũperseũanͣpeticiopetr᷒	redd ram ꝑegͥnus ꝑficio pericl̃m periuriũ perseũanͣ peticio petr᷒
apl̃spetr᷒	apl̃s petr᷒
martirpietaspigriciapiscatorpolluciopotenciapotuspreceptũ	martir pietas pigricia piscator pollucio potencia potus preceptũ
predestinacõpredicaciopredicatorpredoprelatusprelaciopositus	predestinacõ predicacio predicator predo prelatus prelacio positus
scienciasermoserpenss̃uiciũseũitassignũsilenciũ	sciencia sermo serpens s̃uiciũ seũitas signũ silenciũ
siluest̃simiasymonmag᷒symoniudassymonia	siluest̃ simia symon mag᷒ symon  iudas symonia
sĩplicitassimulaciosingl̃aritassitissobrietassompn᷒	sĩplicitas simulacio singl̃aritas sitis sobrietas sompn᷒
sortilegiũspectacl̃m	sortilegiũ spectacl̃m
solitudosoluciosponsaliastatusFinishuicuenit	solitudo solucio sponsalia status Finis huic uenit
eccenũcuenithi᷒alphabetifinisilli	 ecce nũc uenit hi᷒ alphabeti finis illi
gr̃asqui÷alphao	gr̃as qui÷ alpha  o
pͥncipiũfinisꝘ	pͥncipiũ  finis Ꝙ
qͥhũclibꝝlecturisunt	qͥ hũc libꝝ lecturi sunt
oraredeuotedignent᷑uthoꝝꝯpilator	orare deuote dignent᷑ ut hoꝝ ꝯpilator
c᷒nom̃ĩꝓlogo	c᷒ nom̃ ĩ ꝓlogo
ꝯtinet᷑eoꝝoracõibadiutusfinẽlegatũ	ꝯtinet᷑ eoꝝ oracõib adiutus finẽ legatũ
ꝯsequim̃eat᷑Ꝙipepr̃aredignetur	ꝯsequi m̃eat᷑ Ꝙ ipe pr̃are dignetur
sc̃atrinitas	sc̃a trinitas
un᷒de᷒sñfinebenedc̃us	un᷒ de᷒ sñ fine benedc̃us
inscl̃ascl̃oꝝamenAnnodñimͦcccmoviiiFRatrẽ	in scl̃a scl̃oꝝ amen Anno dñi mͦ cccmo viii FRatrẽ
Guill̃mpetridegodinobaioneñord̃fr̃mdicatoꝝmagr̃mĩ	Guill̃m petri de godino baioneñ ord̃ fr̃m dicatoꝝ magr̃m ĩ
theologiaꝑisĩassũpsit	theologia ꝑisĩ assũpsit
inpresbiteriumcardinalẽtitulisc̃ececilieidemdñsclemens	in presbiterium cardinalẽ tituli sc̃e cecilie idem dñs clemens
ppͣv᷒sabb̃oinieiuniisiiiiortp̃oꝝin	ppͣ v᷒ sabb̃o in ieiuniis iiiior tp̃oꝝ in
aduẽtuxͦkls̃	aduẽtu xͦ kls̃
ianuariiAnnodñi	ianuarii Anno dñi
mͦcccͦxiiͦpõtificatsuiannoviiiͦEratãt	mͦ cccͦ xiiͦ põtificat sui anno viiiͦ Erat ãt
tc̃l̃ctorsacripalacii	tc̃ l̃ctor sacri palacii
uͥlegeratiãvi	uͥ legerat iã vi
annisfueratqpͥorꝓuĩcial̃	annis fueratq pͥor ꝓuĩcial̃
ĩꝓuinciaꝓuĩcieord̃dic̃primoetin	ĩ ꝓuincia ꝓuĩcie ord̃ dic̃ primo et in
ꝓuinciatholosanahũcp᷒modũfec̃ep̃m	ꝓuincia tholosana hũc p᷒modũ fec̃ ep̃m
cardinalẽsabinẽcẽ	cardinalẽ sabinẽcẽ
dñsioh̃es	dñs ioh̃es
papahicfec̃construitotãeccamt̃capusfr̃md̃	papa hic fec̃ construi totã eccam t̃ capus fr̃m d̃
tholosesuis	tholose suis
sũptibetexpẽcisRatrẽmatheũ	sũptib et expẽcis Ratrẽ matheũ
deurssinisde	de urssinis de
c̃itateromanamagr̃mĩtheulogiaꝑisĩdecuiospicio	c̃itate romana magr̃m ĩ theulogia ꝑisĩ de cui ospicio
añlongefuerãtassũptiaqͥdampapeet	añ longe fuerãt assũpti a qͥdam pape et
eciãinperatoresnͨnõetplurescardinalesassũpsitinpresbiteꝝ	eciã inperatores nͨ nõ et plures cardinales assũpsit in presbiteꝝ
cardinalemtͥtͥsc̃oꝝioh̃isetpaulidñsioh̃espapa	cardinalem tͥtͥ sc̃oꝝ ioh̃is et pauli dñs ioh̃es papa
inieiuniisiiiior	in ieiuniis iiiior
tẽpoꝝaduẽtusxiiiiͦkl̃ianuariiannodñimͦcccͦ	tẽpoꝝ aduẽtus xiiiiͦ kl̃ ianuarii anno dñi mͦ cccͦ
xxͦviiͦistefuitinviicapogñali	xxͦ viiͦ iste fuit in vii capo gñali
burdegal̃celebrato	burdegal̃ celebrato
annodñimͦcccͦxxͦ	anno dñi mͦ cccͦ xxͦ
iiiiͦerateĩpͥorꝓuĩcial̃	iiiiͦ erat eĩ pͥor ꝓuĩcial̃
romaneꝓuĩcieinquocapl̃o	romane ꝓuĩcie in quo capl̃o
fuitgrauit̃infirmFr̃emGeraldũdedomaro	fuit grauit̃ infirm Fr̃em Geraldũ de domaro
Briueñord̃fr̃mdicaꝝmagr̃mĩ	Briueñ ord̃ fr̃m dicaꝝ magr̃m ĩ
theologiaꝑisĩassũpsitĩbr̃mcard̃	theologia ꝑisĩ assũpsit ĩ br̃m card̃
tͥtͥsc̃esabinedñsclemenspapa	tͥtͥ sc̃e sabine dñs clemens papa
vi᷒sasab̃toĩieiuniisiiiiorfest̃	vi᷒ sa sab̃to ĩ ieiuniis iiiior fest̃
exaltacõissc̃ecruciscũuomitucipuein	exaltacõis sc̃e crucis cũ uomitu cipue in
egͥtudinibacutisethoriscrisisEtqñestcũ	egͥtudinib acutis et horis crisis Et qñ est cũ
cõitateñuoꝝuenientiũadeaac̃ebronucha	cõitate ñuoꝝ uenientiũ ad ea a c̃ebro  nucha
cũꝯũitate	cũ ꝯũitate
quãc̃ebꝝ	quã c̃ebꝝ
h̃tcũeisFennouade	h̃t cũ eis Fen noua de
dispositionibusgutturiscuiusestunustractatuscõtinenstresdecim	dispositionibus gutturis cuius est unus tractatus cõtinens tresdecim
capitulaCapitulũprimũest	capitula Capitulũ primũ est
deanathomiagutturiᷤ	de anathomia gutturiᷤ
PErgutturintelligim᷒spatiũĩquosuntmeat᷒hanelit᷒	PEr guttur intelligim᷒ spatiũ ĩ quo sunt meat᷒ hanelit᷒
etcibiEtdeeosunt	et cibi Et de eo sunt
additõqueestunaEtamigdale	additõ que est una Et amigdale
EtgalsamathiEttuquid̃iamsciuistianathomiã	Et galsamathi Et tu quid̃ iam sciuisti anathomiã
meryetanͣm	mery et anͣm
epyglotisUna	epyglotis Una
uõestsub̃ia	uõ est sub̃ia
carnosapendenssuprasupremãꝑtẽepiglotissicut	carnosa pendens supra supremã ꝑtẽ epiglotis sicut
uelam̃Eteiusquid̃iuuam̃tũestgͣdatõaeris	uelam̃ Et eius quid̃ iuuam̃tũ est gͣdatõ aeris
utnonꝑcutiat	ut non ꝑcutiat
suofrigorepl̃monemsubitoEtꝓh̃eatpulũem	suo frigore pl̃monem subito Et ꝓh̃eat pulũem
fumũEt	 fumũ Et
utsitꝑcutiensuocemqua	ut sit ꝑcutiens uocem qua
confortet᷑etmagnificeturqiͣ	confortet᷑ et magnificetur qiͣ
ipasitportacustodienssuꝑexitũ	ipa sit porta custodiens suꝑ exitũ
uocisqͣntitatesuaEtp̃phocuocetei᷒incisio	uocis qͣntitate sua Et p̃p hoc uocet ei᷒ incisio
uocietꝑatpl̃monẽ	uoci et ꝑat pl̃monẽ
adrecipiendũfrig᷒etnocum̃tũei᷒et	ad recipiendũ frig᷒ et nocum̃tũ ei᷒ et
tussimabeoDue	tussim ab eo Due
uõamigdale	uõ amigdale
suntduecarnesnateinradicelingue	sunt due carnes nate in radice lingue
tendentesadsuꝑiora	tendentes ad suꝑiora
acdubiumnonestIdemqͣre	ac dubium non est Idem qͣre
diedominicosac̃dotũordinacõescelebrant᷑QUodin	die dominico sac̃dotũ ordinacões celebrant᷑ QUod in
diedñicoordinacionessac̃dotũ	die dñico ordinaciones sac̃dotũ
ep̃oꝝcelebrãturnõtm̃exconsuetudĩeseteciã	ep̃oꝝ celebrãtur nõ tm̃ ex consuetudĩe set eciã
exapl̃icanouim᷒uẽire	ex apl̃ica nouim᷒ uẽire
doctrinascripturaact᷒xiiiũsuspͥnmãifestanteq̃dcũ	doctrina scriptura act᷒ xiii ũsus pͥn mãifestante q̃d cũ
apl̃ipaulũbarnabam	apl̃i paulũ  barnabam
exsp̃ssc̃iceptoadeuͣngl̃iumgentib	ex sp̃s sc̃i cepto ad euͣngl̃ium gentib
mitt̃entdicandũieiunantesorantes	mitt̃ent dicandũ ieiunantes  orantes
imposũunteismanusutintl̃ligamusqͣnta	imposũunt eis manus ut intl̃ligamus qͣnta
danciũaccipienciũdeuocionecurand̃sitnetantebñdc̃onis	 danciũ  accipienciũ deuocione curand̃ sit ne tante bñdc̃onis
sacr̃mneggligent̃uideat᷑impletũ	sacr̃m neggligent̃ uideat᷑ impletũ
iõpielaudabl̃rapl̃icismorẽgesẜisinstitutissi	 iõ pie  laudabl̃r apl̃icis morẽ gesẜis institutis si
hͣncordinãdorũsac̃doctũforͣmꝑ	hͣnc ordinãdorũ sac̃do c tũ forͣm ꝑ
eccl̃iasquibus	eccl̃ias quibus
dñsessete	dñs esse te
uoluit̃	uoluit ̃
ipeẜuaũisiciiacmedianeebdomadesabb̃iieiuniocirca	ipe ẜuaũis icii ac mediane ebdomade  sabb̃i ieiunio circa
uesꝑasip̃asordĩacõesnoũitiscelebͣndasNeccuiuslib	uesꝑas ip̃as ordĩacões noũitis celebͣndas Nec cuiuslib
utilitatisc̃apbr̃mseudyaconẽhiisferre	utilitatis c̃a pbr̃m seu dyaconẽ hiis ferre
audeantqui	audeant qui
añiposfũintordinati	añ ipos fũint ordinati
dist̃lxxviQUibtp̃ribieiuniacelebͣndasuntcalixtusppͣdet̃minat	dist̃ lxxvi QUib tp̃rib ieiunia celebͣnda sunt calixtus ppͣ det̃minat
scͥbensbñdc̃oep̃oquibtp̃ribieiuniacelebrenturIEiuniũq̃dter	scͥbens bñdc̃o ep̃o quib tp̃rib ieiunia celebrentur IEiuniũ q̃d ter
iap̃nos	i ap̃ nos
inannocelebraredidicistisꝯuẽiencius	in anno celebrare didicistis ꝯuẽiencius
nob̃nũcꝑqͣtuortemꝑaf̃idec̃nim᷒ut	nob̃ nũc ꝑ qͣtuor temꝑa f̃i dec̃nim᷒ ut
sic̃annusꝑqͣtuor	sic̃ annus ꝑ qͣtuor
uoluit̃tpr̃sicnosqͣternũsollempneagam᷒ieiuniũ	uoluit̃ tpr̃ sic  nos qͣternũ sollempne agam᷒ ieiuniũ
ꝑqͣtuorãnitpr̃Itemexcon.	ꝑ qͣtuor ãni tpr̃ Item ex con.
magociẽsideeodẽConstituim᷒utqͣtuortpr̃anni	magociẽsi de eodẽ Constituim᷒ ut qͣtuor tpr̃ anni
abõibhom̃ibꝯ	ab õib hom̃ib ꝯ
Inparidelictouelcausapociorestconditõpossidentis	In pari delicto uel causa pocior est conditõ possidentis
IDemCUmconstatpereumquomin᷒conditõimpleaturh̃ri	IDem CUm con stat per eum quomin᷒ conditõ impleatur h̃ri
dꝑindeacsi	d ꝑinde ac si
impletafuissIDemQuodalicuisuononlicet	impleta fuiss IDem Quod alicui suo non licet
noĩenecalienolicebitIDemPotestquis	noĩe nec alieno licebit IDem Potest quis
peraliumquod	per alium quod
potestfac̃eꝑseip̃mIDemInmalispromissis	potest fac̃e ꝑ se ip̃m IDem In malis promissis
fidemnõ	fidem nõ
expeditobẜuariIDemInalt̃natiuis	expedit obẜuari IDem In alt̃natiuis
debitorisẽelectõetsufficitalt̃madĩpleriIDemQui	debitoris ẽ electõ et sufficit alt̃m adĩpleri IDem Qui
adagendũadmittit᷑ẽadexcipiẽdũml̃tomagisadmittẽd᷒	ad agendũ admittit᷑ ẽ ad excipiẽdũ ml̃to magis admittẽd᷒
IDemQuifacit	IDem Qui facit
ꝑaliumestꝑindeacsi	ꝑ alium est ꝑinde ac si
faciatꝑ	faciat ꝑ
seip̃mIDemFactũlegitime.i.	se ip̃m IDem Factũ legitime .i.
ꝯpleteretractarinõ	ꝯplete retractari nõ
debetlicetcasus	debet licet casus
posteaeueniatexactumit̃mexigaturIDemCUmquid	postea eueniat exactum it̃m exigatur IDem CUm quid
unauianõprohibeturalicuiadid	una uia nõ prohibetur alicui ad id
alianõdadmittiIDemContractus	alia nõ d admitti IDem Contractus
exconuẽtõnelegemacciꝑedinoscũt᷑IDeDanpnũquodquissua	ex conuẽtõne legem acciꝑe dinoscũt᷑ IDe Danpnũ quod quis sua
culpasentit	culpa sentit
sibidnõ	sibi d nõ
aliisĩputariIDeInfamibporte	aliis ĩputari IDe Infamib porte
nõpateãt	nõ pateãt
dignitumIDemCertumestꝙis	dignitum IDem Certum est ꝙ is
ꝯmͭtitinlegemquilegisuerbacõplectenscontralegisnittitur	ꝯmͭtit in legem qui legis uerba cõplectens contra legis nittitur
uoluntatemExplicitlibersextus	uoluntatem Explicit liber sextus
decretaliumconpletusperdielune	decretalium conpletus per die lune
ĩuigiliab̃timartini	ĩ uigilia b̃ti martini
hyemalisdeograciasannodñimͦcccͦ	hyemalis deo gracias anno dñi mͦ cccͦ
xvͦInstudiodictihicẽuerꝓpheta	xvͦ In studio dicti hic ẽ uer ꝓpheta
quiuẽturĩmũdũEstaut̃ualdeꝯuẽens	qui uẽtur ĩ mũdũ Est aut̃ ualde ꝯuẽens
ꝙaduẽt	ꝙ aduẽt
dñiĩcedẽtedñica	dñi ĩ cedẽte dñica
inchoet᷑utecciaad	inchoet᷑ ut eccia ad
aduẽtũxp̃ieic̃tificaꝓmissiõeꝯsolata	aduẽtũ xp̃i ei c̃tifica ꝓmissiõe ꝯsolata
respirãsdeuoci⁊uericlamatAtte	respirãs deuoci ⁊ ueri clamat At te
leuauiaĩa	leuaui aĩa
meãAdcuiꝯtẽplacõeaĩenr̃e	meã Ad cui ꝯtẽplacõe aĩe nr̃e
sicleuẽt᷑utĩaduẽtudistrictiiudic̃beat̃	sic leuẽt᷑ ut ĩ aduẽtu districti iudic̃ beat̃
sociẽt᷑ꝙgraciosenob̃ꝯcedatqui	sociẽt᷑ ꝙ graciose nob̃ ꝯcedat qui
sñfĩeuiuit⁊regnatamenaͦ	sñ fĩe uiuit ⁊ regnat amen aͦ
dñimͦccccͦistoãnofinit⁊ꝯpletẽiste	dñi mͦ ccccͦ isto ãno finit ⁊ ꝯplet ẽ iste
lib̃laustibisitxp̃equoniamliberexplicitiste	lib̃ laus tibi sit xp̃e quoniam liber explicit iste
permanusiohãnisleufferswillen	per manus iohãnis leufferswillen
scriptorẽnostiamconsideransdicitquide	scriptorẽ nos tiam considerans dicit qui de
t̃raestdeterraloquiturqͥdecelo	t̃ra est de terra loquitur qͥ de celo
uenitsuper	uenit super
omnesẽTuautemdominer̃Descẽdetdominus	omnes ẽ Tu autem domine r̃ Descẽdet dominus
sicutpluuiainuellusOrieturindiebeiusi᷒ticiaet	sicut pluuia in uellus Orietur in dieb eius i᷒ticiaet
habundanciapacisũEtadorabunteumomnesregesom̃sgentes	habundancia pacis ũ Et adorabunt eum omnes reges om̃s gentes
seruienteiOrieturl̃viiiͣ	seruient ei Orietur l̃ viiiͣ
Curincarc̃epositusmittensdiscipulos	Cur in carc̃e positus mittens discipulos
requirittuesquiuenturuseᷤanaliumexpectamus	requirit tu es qui uenturus eᷤ an alium expectamus
tãꝙͣsiignoretquemõnderatetan	tãꝙͣ si ignoret quem õnderat et an
ipesitnesciatquemip̃meẽ	ipe sit nesciat quem ip̃m eẽ
ꝓph̃andobaptisandoostendendoclamauerats	ꝓph̃ando baptisando ostendendo clamauerat s
hecciciusquestiosoluitursigestereitempusetordo	hec cicius questio soluitur si geste rei tempus et ordo
penseturTuautẽr̃monteᷤremanip̃eueniatrequirit	pensetur Tu autẽ r̃ monteᷤ rem an ip̃e ueniat requirit
nonquiaip̃meẽmundiredemptorẽdubitatsedqueritut	non quia ip̃m eẽ mundi redemptorẽ dubitat sed querit ut
sciatsiisquiperseinmundumueneratper	sciat si is qui per se in mundum uenerat per
seeciamadinferniclaustradescendat	se eciam ad inferni claustra descendat
Quemenimprecurrensmundonunciauerathuncmoriendoetad	Quem enim precurrens mundo nunciauerat hunc moriendo et ad
inferoscurrebatTuaut̃r̃Ecceradixiesseascendet	inferos currebat Tu aut̃ r̃ Ecce radix iesse ascendet
insalutempopulorumip̃mgentesdeprecabunturEt	in salutem populorum ip̃m gentes deprecabuntur Et
eritnomẽeiusgloriosumũ	erit nomẽ eius gloriosum ũ
Dabitillidominusdeussedemdauidpr̃iseiusetregnabit	Dabit illi dominus deus sedem dauid pr̃is eius et regnabit
domoiacobĩet̃numEt	domo iacob ĩ et̃num Et
eritGloriapr̃ir̃Ecceradix	erit Gloria pr̃i r̃ Ecce radix
ũañl̃OstendeInl̃ãUeniet	ũ añ l̃ Ostende In l̃ ã Ueniet
dominusetnõtardabitetilluminabitdumscelestisprimoqchristi	dominus et nõ tardabit et illuminabit dum scelestis primoq christi
quadringentesimonatidiequeresecundauicesimaianiAntoniusdictussancii	quadringentesimo nati dieq uere secunda uicesima iani Antonius dictus sancii
cognominefultusIspanusnatu	cognomine fultus Ispanus natu
astigiefõteperunctushunc	astigie fõte perunctus hunc
librumscripsitiussusanctissimipatrisQuicunctispanditcelestia	librum scripsit iussu sanctissimi patris Qui cunctis pandit celestia
RegnabeatisProhuiusstatu	Regna beatis Pro huius statu
oretplebschristi	oret plebs christi
fidelisQuiuteamsaluetpressurassubitinterris	fidelis Qui ut eam saluet pressuras subit in terris
ymoutplebischristusabstergatpeccataPius	ymo ut plebis christus abstergat peccata Pius
pastororetquiestdignusuitabeataQuifec̃hos	pastor oret qui est dignus uita beata Qui fec̃ hos
ũsusdeuotusnim᷒	ũsus deuotus nim᷒
ꝓhẽialit̃dictasinttantaDIcamusautemresumẽtesquoniamomnis	ꝓhẽialit̃ dicta sint tanta DIcamus autem resumẽtes quoniam omnis
cogͥtioetelectio	cogͥtio et electio
bonũaliq̃ddesideratquidesthocq̃ddicimusCiuilemdesiderare	bonũ aliq̃d desiderat quid est hoc q̃d dicimus Ciuilem desiderare
etquidestomnium	et quid est omnium
operatorumsũmũbonũNominequidẽ	operatorum sũmũ bonũ Nomine quidẽ
ig᷑fereapl̃imiscõfessũestfelicitatemeni	ig᷑ fere a pl̃imis cõfessũ est felicitatem eni
etmultietexcellentesdicũtbeneuiũe	et multi et excellentes dicũt bene uiũe
aut̃etbñoꝑariidemexistimãteiq̃d	aut̃ et bñ oꝑari idem existimãt ei q̃d
estessefelicemdefelicitateaut̃29Deqͣlitate	est esse felicem de felicitate aut̃ 29 De qͣlitate
uisionisquaĩfuturoscl̃osc̃ideumuidebunt30	uisionis qua ĩ futuro scl̃o sc̃i deum uidebunt 30
Deeternafelicitateciuitatisdei	De eterna felicitate ciuitatis dei
sabb̃oqꝑpetuo	sabb̃oq ꝑpetuo
31Deoꝑis	31 De oꝑis
ꝯsũmatõnecumgr̃aꝝactioneExplicittabula	ꝯsũmatõne cum gr̃aꝝ actione Explicit tabula
librideciuitatedeibt̃iAugustinique	libri de ciuitate dei bt̃i Augustini que
scriptafuitAnnodñiMͦCCCCͦpͥ	scripta fuit Anno dñi Mͦ CCCCͦ pͥ
Marciidie26ͣuigentescismateetppͣbenedc̃o13ͦin	Marcii die 26ͣ uigente scismate et ppͣ benedc̃o 13ͦ in
palatioAuinioneñsubclausuraiamperbienniũdetẽtoꝓ	palatio Auinioneñ sub clausura iam per bienniũ detẽto ꝓ
thdolorCeescripstGuylleminCronierpour	th dolor Ce escripst Guyllemin Cronier pour
desprelatsleper	des prelats le per
mierEt	mier Et
sebienson	se bien son
nomweulzscavoir	nom weulz scavoir
PrenleRougeet	Pren le Rouge et
laysselenoir	laysse le noir
Omortaliummiserandaconditioquesemperinarduumlabentium	O mortalium miseranda conditio que semper in arduum labentium
inanitertendis	inaniter tendis
utlapsugrauioreruasQuerishicfulgentia	ut lapsu grauiore ruas Queris hic fulgentia
dunoreseximioslongosqpotentatusubi	du nores eximios longosq potentatus ubi
nullapotentiapotenseuerushonosnullum	nulla potentia potens e uerus honos nullum
consistensdyademasomniacasushumanetquicquid	consistens dyadema s omnia casus human et quicquid
inaltumfortunatulitruitura	in altum fortuna tulit ruitura
leuatRespicereges	leuat Respice reges
etregnaquonperiainterlaudantiumoraatq	et regna quon peria inter laudantium ora atq
mirantiumrepentecorruisseutdeturintesectanturnonadid	mirantium repente corruisse ut detur inte sectantur non ad id
quotendunteuolantsadymadedecorosesepissimeiuxtaeuangelicum	quo tendunt euolant s ad yma dedecorose sepissime iuxta euangelicum
dictumQuiseexaltathumiliabiturlucexiiii	dictum Qui se exaltat humiliabitur luce xiiii
Quisꝗsmesuirtutumesseconcupiscitstabilifixoqgradumanere	Quisꝗs mes uirtutum esse concupiscit stabili fixoq gradu manere
interradiantchorosfelicitercollocari	inter radiant choros feliciter collocari
normamuirtutumut	normam uirtutum ut
hicduxnosterfecitdiscatuniut	hic dux noster fecit discat uni ut
inquitTulliusinphilippicisOmniaalia	inquit Tullius in philippicis Omnia alia
incertasuntcaducaetmobiliaestunaaltissimisinfixa	incerta sunt caduca et mobilia est una altissimis infixa
radicibusquenullauilabefactaripotestnecdimoQuicũq	radicibus que nulla ui labefactari potest nec dimo Quicũq
gͦuirtutis	gͦ uirtutis
uestigiasequeturuthicduxinclitusmerito	uestigia sequetur ut hic dux inclitus merito
sibidiceturqu	sibi dicetur qu
principiodiximusposuiteumducemuirtutum	principio diximus posuit eum ducem uirtutum
uniuersarumq̃dfuitthcuiusdeclarationepotest	uniuersarum q̃d fuit th cuius declaratione potest
talisratioformari	talis ratio formari
Quisꝗscompositementisinpresentiseterniducissigna	Quisꝗs composite mentis in presentis eterni ducis signa
sequituranimoseillumdeusponitducemuir	sequitur animose illum deus ponit ducem uir
uersarumsduxnosterinclitus	uersarum s dux noster inclitus
mentecelodedituseterniducissignamucutus	mente celo deditus eterni ducis signa mu cutus
ergoillumdeus	ergo illum deus
posuitducemuirtutumuniuersarum	posuit ducem uirtutum uniuersarum
Primaparsanpatetperilludapostolisecundethesalõicensespͥmo	Prima pars an patet per illud apostoli secunde thesalõicenses pͥmo
Nonenimdeditnobisdeustimorisseduirtutis	Non enim dedit nobis deus timoris sed uirtutis
Eteccͥxl	Et eccͥ xl
uirtutesexaltantcor.Ethecpaucadeprimap	uirtutes exaltant cor . Et hec pauca de prima p
detissecũdaparsantecedẽtis	detis secũda pars antecedẽtis
queestsduxnosterĩclitus⁊	que est s dux noster ĩclitus ⁊
c̃patetperilld̃ioINpͥncipioẽatũbũ	c̃ patet per illd̃ io IN pͥncipio ẽat ũbũ
etũbũẽataputd̃m	et ũbũ ẽat aput d̃m 
deusẽatũbũhocẽatinpͥncipioaputd̃mOm̃ia	deus ẽat ũbũ hoc ẽat in pͥncipio aput d̃m Om̃ia
ꝑip̃mfc̃as̃tsineipofc̃m÷nichil	ꝑ ip̃m fc̃a s̃t  sine ipo fc̃m ÷ nichil
Qͦtfc̃m÷inipouita	Qͦt fc̃m ÷ in ipo uita
ẽatEtuitaẽatluxhoĩmEt	ẽat Et uita ẽat lux hoĩm Et
luxintenebͥs	lux in tenebͥs
lucettenebreeãnonꝯhenderũtfuithomomissus	lucet  tenebre eã non ꝯhenderũt fuit homo missus
adeocuinomẽẽatiohãnesHic	a deo cui nomẽ ẽat iohãnes Hic
uenitĩtestimõiͫ	uenit ĩ testimõiͫ
uttestimõͫꝑhib̃etdelumĩe	ut testimõͫ ꝑhib̃et de lumĩe
utom̃escred̃entꝑillũ	ut om̃es cred̃ent ꝑ illũ
Nonẽatilleluxsuttestimomꝑhib̃etdelumĩe	Non ẽat ille lux s ut testimom ꝑhib̃et de lumĩe
Ẽatlux	Ẽat lux
ũaq̃illuĩatom̃emhomĩemuenientẽin	ũa q̃ illuĩat om̃em homĩem uenientẽ in
hũcmũdumInmundoillumsedseasidione	hũc mũdum In mundo illum sed se asidione
procreatumVerumpostꝙͣasillanauiolenciacesarianaequitas	procreatum Verum postꝙͣ a sillana uiolencia cesariana equitas
reduxitgubernaculaRomaniImperiiiustioreprincipeoptinentein	reduxit gubernacula Romani Imperii iustiore principe optinente in
pubcacustodiasp̃umposuitEodempreside	pubca custodia sp̃um posuit Eodem preside
R.pubceinconsiml̃imendacio	R. pubce in consiml̃i mendacio
muliebristemẽitasrepressaestSiquidemcumseprorubria	muliebris temẽitas repressa est Siquidem cum se pro rubria
quedamperindeacfalsocredita	quedam perinde ac falso credita
essincendioperpetinichilad	ess incendio perpeti nichil ad
seꝑtinentibbonisinser̃etneqeiautsplendiditestes	se ꝑtinentib bonis inser̃et neq ei aut splendidi testes
autcohortisAugusti	aut cohortis Augusti
fauordeesspropterinexpungnabl̃emCesarisconstanciam	fauor deess propter inexpungnabl̃em Cesaris constanciam
irritapropoĩtinefariiabiitIdembarbarumquendamproptereximiam	irrita propoĩti nefarii abiit Idem barbarum quendam propter eximiam
sil̃itudinemCapadocieRegnumaffectantemtamꝙͣAriathesessquem	sil̃itudinem Capadocie Regnum affectantem tamꝙͣ Ariathes ess quem
aM.Antoniointeremptumluceclariuseratꝙͣꝙͣpene	a M . Antonio interemptum luce clarius erat ꝙͣꝙͣ pene
tociusorientisCiuitatiumetgentiumcredulasuffragacõnefultumcaputdementer	tocius orientis Ciuitatium et gentium credula suffragacõne fultum caput dementer
ImpẽioinminensiustoImpendisuppliciocoegitExplicitUalerius	Impẽio inminens iusto Impendi supplicio coegit Explicit Ualerius
MaximusAnnomͦ	Maximus Anno mͦ
ccccmoterciocͥcafestũassupͦͥᷤMariaFilimandata	ccccmo tercio cͥca festũ assupͦͥᷤ Maria Fili mandata
dataquesuntcongrualaudiIncipitspeculũsacerdotũcclesie	data que sunt congrua laudi Incipit speculũ sacerdotũ cclesie
sancteRegimẽquiduc̃esancteuishec	sancte Regimẽ qui duc̃e sancte uis hec
metralegedesc̃aꝯditalegeQuesiꝑleg̃e	metra lege de sc̃a ꝯdita lege Que si ꝑleg̃e
bñuis⁊corde	bñ uis ⁊ corde
tenereactiꝯplerepot̃isbonasemꝑhaberehoc	tenere acti ꝯplere pot̃is bona semꝑ habere hoc
speculũclarũcurãmõstrans	speculũ clarũ curã mõstrans
aĩarũCondotibicarũplusꝙͣsitgẽmauelaurũ	aĩarũ Condo tibi carũ plusꝙͣ sit gẽma uel aurũ
Quopossisaĩas	Quo possis aĩas
sacͣmẽt̃redderemũdasCriminauitareuirtutesmultiplicareut	sacͣmẽt̃ reddere mũdas Crimina uitare uirtutes multiplicare ut
bñuiuẽdosubiectissanctadocendoTandemleterisincelis⁊	bñ uiuẽdo subiectis sancta docendo Tandem leteris in celis ⁊
speculerisadducẽdogregẽsũmũꝑsecularegẽhocꝯcedentedño	speculeris adducẽdo gregẽ sũmũ ꝑ secula regẽ hoc ꝯcedente dño
bñcũctaregenteprimotñdñmrogotrinũ	bñ cũcta regente primo tñ dñm rogo trinũ
sẽꝑ⁊unũaquocũctabonamanãtutdet	sẽꝑ ⁊ unũ a quo cũcta bona manãt ut det
michidonaCũquibhocspeculũualeãꝯplerenouellũutile	michi dona Cũ quib hoc speculũ ualeã ꝯplere nouellũ utile
mũdanisaĩabusedificandisdemodo	mũdanis aĩabus edificandis de modo
⁊formahui᷒libriDetitulopandãtibiprimoꝯmoda	⁊ forma hui᷒ libri De titulo pandã tibi primo ꝯmoda
quedãut	quedã ut
ẜuesuitãpost	ẜues uitã post
hecdiceturhonestam	hec dicetur honestam
Quedebesscirefaciãpostistasubirehincꝙin	Que debes scire faciã post ista subire hinc ꝙ in
eccl̃aresidenciasit	eccl̃a residencia sit
faciendaQuesũtofficiatibisubiũgã	facienda Que sũt officia tibi subiũgã
fugiendaposthec	fugienda post hec
officiatibidebitaiũgonouenaScilicinsacradignetractes	officia tibi debita iũgo nouena Scilic in sacra digne tractes
sac̃mentautmissascelebresdeuotepostea	sac̃menta ut missas celebres deuote post ea
cernesposteamonstraturquidquomodo	cernes postea monstratur quid quomodo
ꝯfiteaturQuomododoctrinãtradastransportatieẽnt⁊ea	ꝯfiteatur Quomodo doctrinã tradas transportati eẽnt ⁊ ea
suplem̃toadductoquoãpli᷒duab.legionib.	suplem̃to adducto quo ãpli᷒ duab. legionib.
ꝙͣxmilia⁊quadringẽtipedites	ꝙͣ x milia ⁊ quadringẽti pedites
sexcentieꝗteseẽnt⁊sociũlat̃inoĩisduodecĩmiliasexcẽti	sexcenti eꝗtes eẽnt ⁊ sociũ lat̃i noĩis duodecĩ milia sexcẽti
eꝗtesquoꝝfortioꝑaadũsusceltiberosliisususꝗnt᷒fului᷒	eꝗtes quoꝝ forti oꝑa adũsus celtiberos liis usus ꝗnt᷒ fului᷒
eẽtquossi	eẽt quos si
uideret᷑secũ	uideret᷑ secũ
deportaret⁊suplicatõesdec̃teꝙisꝓspererempublicãgesisset	deportaret ⁊ suplicatões dec̃te ꝙ is ꝓspere rem publicã gesisset
⁊cet̃itoresĩꝓuĩciasꝗntofabiobutroniꝓrogatũin	⁊ cet̃i tores ĩ ꝓuĩcias ꝗnto fabio butroni ꝓrogatũ in
galliãimꝑiũ	galliã imꝑiũ
ẽoctolegiones	ẽ octo legiones
terex̃citũuet̃emꝗĩ	ter ex̃citũ uet̃em ꝗ ĩ
ligurib.ĩspeꝓpinquamissiõiserãteoãnoeẽplacuit	ligurib. ĩ spe ꝓpinqua missiõis erãt eo ãno eẽ placuit
⁊isipeex̃cit᷒egreexplebat᷑ꝑꝑ	⁊ is ipe ex̃cit᷒ egre explebat᷑ ꝑꝑ
pestilentiaq̃t̃ciũiããnuurbẽroͣnaatqitaliã	pestilentia q̃ t̃ciũ iã ãnu urbẽ roͣna atq italiã
uastabattortit᷒minuti᷒⁊	uastabat tor tit᷒ minuti᷒ ⁊
hautitaml̃top᷒ꝯsulgne᷒calfurni᷒morit᷑ml̃tiqalii	haut ita ml̃to p᷒ ꝯsul gne᷒ calfurni᷒ morit᷑ ml̃tiq alii
õiuordinũillustresuiripost̃moꝓdigiilocoeacladesh̃ri	õiu ordinũ illustres uiri post̃mo ꝓdigii loco ea clades h̃ri
ceptagne᷒ẜuili᷒pontifexmaxi᷒piaculairedeũ	cepta gne᷒ ẜuili᷒ pontifex maxi᷒ piacula ire deũ
ꝯꝗr̃eiussi	ꝯꝗr̃e iussi
xuirilibrosinspic̃eꝯsulapol̃iexculapio	x uiri libros inspic̃e ꝯsul apol̃i exculapio
salutisdona	salutis dona
uouere⁊daresignaĩaurataq̃uouitdeditqxuiri	uouere ⁊ dare signa ĩaurata q̃ uouit deditq x uiri
suplicationẽĩbiduũualitudinisc̃a⁊	suplicationẽ ĩ biduũ ualitudinis c̃a ⁊
ꝑõiafora	ꝑ õia fora
ꝯciliabulaqedixeruntNUncitaqquoniamprincipales	ꝯciliabulaq edixerunt NUnc itaq quoniam principales
erroresnõhabentiũlegẽinpremissahui᷒opusculiꝑte	errores nõ habentiũ legẽ in premissa hui᷒ opusculi ꝑte
satisuidẽtureuersiAdiugulandũerroreslegemhabentiũ	satis uidẽtur euersi Ad iugulandũ errores legem habentiũ
Eritulterius	Erit ulterius
insistendũPorro	insistendũ Porro 
iudeiint̃legẽh̃ntesPrimũsibiarrogantlocũpͥmiĩ	iudei int̃ legẽ h̃ntes Primũ sibi arrogant locũ pͥmi ĩ
hacẜaparteaggrediẽdisuntSciendumigit᷑Q̃diudeis	hac ẜa parte aggrediẽdi sunt Sciendum igit᷑ Q̃d iudeis
scissuradecẽtribuũhoc	scissura decẽ tribuũ hoc
nom̃inposuitAnteaquippe	nom̃ inposuit Antea quippe
hebreiul̃ysraeldicebãtur	hebrei ul̃ ysrael dicebãtur
Exquoautẽ	Ex quo autẽ
induoregnapopulusillediuisus	in duo regna populus ille diuisus
estQuicũqexeisregeshabuerũtdestirpeiude	est Quicũq ex eis reges habuerũt de stirpe iude
seudetribu	seu de tribu
iudaIudeiddictisũtDecem	iuda Iudei d dicti sũt Decem
uõtrib.etquicũqin	uõ trib. et quicũq in
samariaIhẽoboamregẽsibiconstituerũtIsraelisuntuocati	samaria Ihẽoboam regẽ sibi constituerũt Israel i sunt uocati
Quib.yeroboãduosuitulosaureosfatiẽsUnũposuitin	Quib. yeroboã duos uitulos aureos fatiẽs Unũ posuit in
danetalteꝝinbethelDixitqeisregnũtelorũSed	dan et alteꝝ in bethel Dixitq eis regnũ telorũ Sed
tamendc̃iIudeiexpectauerunt⁊	tamen dc̃i Iudei expectauerunt ⁊
credideruntuenturũsicutpatreseorũantiquicrediderũtEttñ	crediderunt uenturũ sicut patres eorũ antiqui crediderũt Et tñ
ininfernofuerũtEtquisiuixissentusqad	in inferno fuerũt Et qui si uixissent usq ad
tempusaduentusꝓphetexp̃itãtũcredidissentipixp̃mquãtum	tempus aduentus ꝓphete xp̃i tãtũ credidissent ipi xp̃m quãtum
etisticrediderũtCũ	et isti crediderũt Cũ
xp̃sꝓph̃ãaggrauaredebebatcordaIudeorũet	xp̃s ꝓph̃ã aggrauare debebat corda Iudeorũ et
eorũoculosexcecareetauresclaudereutysa.vi	eorũ oculos excecare et aures claudere ut ysa. vi
Etperconsequenscrederenonpoterantut	Et per consequens credere non poterant ut
Io.xiiNonne	Io. xii Nonne
antiquipr̃eseorũ	antiqui pr̃es eorũ
ĩterfecer̃tsanctosꝓph̃asetiãadeomissos	ĩterfecer̃t sanctos ꝓph̃as etiã a deo missos
sicutysayametIeremiãetaliosꝙͣ	sicut ysayam et Ieremiã et alios ꝙͣ
pluressedtñdicti	plures sed tñ dicti
antiquietsanctipatresininfernodãpnatifueruntin	antiqui et sancti patres in inferno dãpnati fuerunt in
sanguĩetestam̃tisaluatideinfernoergo	sanguĩe testam̃ti saluati de inferno ergo
etistiDicitemichioIusticiaquidhabuitsignificarede	et isti Dicite michi o Iusticia quid habuit significare de
laterexp̃iiudicisnostrisanguĩemetclarãaquam	latere xp̃i iudicis nostri sanguĩem et clarã aquam
emanasseAitIusticianescioAitmisericordiaPostꝙͣnescis	emanasse Ait Iusticia nescio Ait misericordia Postꝙͣ nescis
tedoceboEtaitipasãguĩeillefuit	te docebo Et ait ipa sãguĩe ille fuit
sanguisfederisde	sanguis federis de
quosupͣdc̃mestInquosan	quo supͣdc̃m est In quo san
guĩeom̃escircũcisosnon	guĩe om̃es circũcisos non
preuaricatoreslegisetadeoetlegisnonfornicatoreseducere	preuaricatores legis et adeo et legis non fornicatores educere
debebatdeinfernoAquailla	debebat de inferno Aqua illa
fuitfederisgentiũpopuliInquaaquaipedc̃asgentes	fuit federis gentiũ populi In qua aqua ipe dc̃as gentes
inppl̃met	in ppl̃m et
regnumdebebathereditareut	regnum debebat hereditare ut
ysayeliiSicingloriosuseritinteruirosaspectuset	ysaye lii Sic ingloriosus erit inter uiros aspectus et
formaeiusinterfilios	forma eius inter filios
hoĩmipeasꝑget	hoĩm ipe asꝑget
gentesmultassuꝑip̃m	gentes multas suꝑ ip̃m
cõtinebunt᷑regesos	cõtinebunt᷑ reges os
suũquiaquib᷒nonestnarratũnondeeouidebunt	suũ quia quib᷒ non est narratũ non de eo uidebunt
etquinonaudieruntcontemplati	et qui non audierunt contemplati
suntetetiã	sunt et etiã
ipexp̃squidebuitexpͥmicũ	ipe xp̃s qui debuit expͥmi cũ
semperinteristosduos	semper inter istos duos
populosfũitdistinctioutgẽxxvetesterx	populos fũit distinctio ut gẽ xxv et ester x
dequibussanguĩeetaquahabetur	de quibus sanguĩe et aqua habetur
figuraleuixiiiicinfine	figura leui xiiii c in fine
ubisacerdoslegisinsanguĩe	ubi sacerdos legis in sanguĩe
etaquisuiuentibaspergebatleprosũ	et aquis uiuentib aspergebat leprosũ
etmũdabaturItaxp̃elegissacerdosaspergens	et mũdabatur Ita xp̃e legis sacerdos aspergens
desuolateresanguĩem⁊	de suo latere sanguĩem ⁊
aquãuiuammũdũleꝓsũinpc̃tismũdauit	aquã uiuam mũdũ leꝓsũ in pc̃tis mũdauit
⁊mũdabitAsillusquosdicisdetribussceleribus	⁊ mũdabit As illus quos dicis de tribus sceleribus
etdequarto	et de quarto
⁊c̃TuIusticiadebes	⁊c̃ Tu Iusticia debes
scireteOratiosanctiambrosiiquedebet	scire te Oratio sancti ambrosii que debet
diciantemissamSumme	dici ante missam Summe
sacerdosetuerepontifexqui	sacerdos et uere pontifex qui
teobtulistideo	te obtulisti deo
patrihostiampurametimmaculatam	patri hostiam puram et immaculatam
inaracrucispronobismiserispcc̃oribusquiqdedistinobis	in ara crucis pro nobis miseris pcc̃oribus quiq dedisti nobis
carnemtuamadmanducandumetsanguinem	carnem tuam ad manducandum et sanguinem
tuũadbibendum	tuũ ad bibendum
etposuistimisteriumistudinuirtutespiritussãcti	et posuisti misterium istud in uirtute spiritus sãcti
dicenshecquocienscũqfeceritisinmeimemoriam	dicens hec quocienscũq feceritis in mei memoriam
faNecletheosseuaperamnesUosfata	fa Nec letheos seua per amnes Uos fata
trahentsedcũsũmasExigethorasconsumptadiesIter	trahent sed cũ sũmas Exiget horas consumpta dies Iter
adsuperosgl̃iapandetSedtudomitormagneferaꝝOrbisq	ad superos gl̃ia pandet Sed tu domitor magne feraꝝ Orbisq
siml̃pacatoradesNũc	siml̃ pacator ades Nũc
quoqnr̃asrespiceterrasEt	quoq nr̃as respice terras Et
siquanoua	si qua noua
beluauultuQuatietppl̃osterroregrauiTufulminib.frange	belua uultu Quatiet ppl̃os terrore graui Tu fulminib. frange
trisulcisFortiusipogenitoretuoFulmina	trisulcis Fortius ipo genitore tuo Fulmina
mittesExpliciuntTragedieSenece	mittes Expliciunt Tragedie Senece
DeoGraciasAmenScripteac	Deo Gracias Amen Scripte ac
conpletepermanusIohãnisTenNordedeDoetinchemClericiTraiecteñ	conplete per manus Iohãnis Ten Norde de Doetinchem Clerici Traiecteñ
dyoc̃SubAnnodñiMͦ	dyoc̃ Sub Anno dñi Mͦ
ccccͦviiiiDiedecimanonaMensis	ccccͦ viiii Die decimanona Mensis
IanuariiEpitaphiuSeneceCuralabormeritusũptiꝓmunerehonores	Ianuarii Epitaphiu Senece Cura labor meritu sũpti ꝓ munere honores
ItealiasposthancsolicitateanimasMeprocul	Ite alias post hanc solicitate animas Me procul
auob̃deus	a uob̃ deus
euocatilicetactisRebusterrenishospitaterraualeCorpusauara	euocat ilicet actis Rebus terrenis hospita terra uale Corpus auara
tñsolẽpnib.accipesaxisNamqaĩamceloreddim᷒ossatibi	tñ solẽpnib. accipe saxis Namq aĩam celo reddim᷒ ossa tibi
ExpliciuntuocabulaugucionisincipientiaaZXplicit	Expliciunt uocabula ugucionis incipientia a Z Xplicit
Expositiouocabulorumexsententiaugutionisꝯpilacione	Expositio uocabulorum ex sententia ugutionis ꝯpilacione
IacobiꝯdamMag̃ri	Iacobi ꝯdam Mag̃ri
Isaacphisici	Isaac phisici
depaduacompleta	de padua completa
clugieAnnoxp̃iMcccxxiiidems̃nouembrisEtscripta	clugie Anno xp̃i Mcccxxiii de ms̃ nouembris Et scripta
ꝑmeIohannem	ꝑ me Iohannem
ꝯdamd̃Siluestrideluxaueneciaruoriginariu	ꝯdam d̃ Siluestri de luxa ueneciaru originariu
⁊teruisiiciuem	⁊ teruisii ciuem
publicumImperiali	publicum Imperiali
Auct̃enotarium⁊tũcCancelarium	Auct̃e notarium ⁊ tũc Cancelarium
Magnifici⁊potentisdñidñiNicolaiMudatioproẜenisimo	Magnifici ⁊ potentis dñi dñi Nicolai Mudatio pro ẜenisimo
⁊excellentissimoducalidñioveneciaꝝtociusInsulecretehonorabilis	⁊ excellentissimo ducali dñio veneciaꝝ tocius Insule crete honorabilis
capitañgeneralis⁊CompletaInciuitatecandideAnno	capitañ generalis ⁊ Completa In ciuitate candide Anno
natiuitatisdñinr̃iih̃uxp̃iMccccxiiIndic̃quĩta	natiuitatis dñi nr̃i ih̃u xp̃i Mccccxii Indic̃ quĩta
dieSabatixviimensisdecembris	die Sabati xvii mensis decembris
ciosaqualiasuntõiasignamortẽꝓnosticia	ciosa qualia sunt õia signa mortẽ ꝓnosticia
Queuõin	Que uõ in
parteauferũtuelauferrisignificantut	parte auferũt uel auferri significant ut
signanũciãtiatorturãuelꝑalisimautappoͣ̃uelcardiacãaͭ	signa nũciãtia torturã uel ꝑalisim aut appoͣ̃ uel cardiacã aͭ
sil̃iapessimaquidẽsuntsmĩorismalicieꝙͣillaque	sil̃ia pessima quidẽ sunt s mĩoris malicie ꝙͣ illa que
cisemortẽꝓnosticãtDeqͥbom̃ibspãlr̃ꝑtractãenõ	cise mortẽ ꝓnosticãt De qͥb om̃ib spãlr̃ ꝑtractãe nõ
spectatintͦduconumpñtiũformesiuetenorispredc̃isꝯtenti	spectat intͦduconum pñtiũ forme siue tenori s predc̃is ꝯtenti
gr̃asr̃ferimdñoih̃u	gr̃as r̃ferim dño ih̃u
xp̃oqͥꝯsid̃acões	xp̃o qͥ ꝯsid̃acões
intͦductoriaspͥmepartismenequetheoricadr̃d	intͦductorias pͥme partis mene que theorica dr̃d
adimpleuitEtqui	adimpleuit Et qui
iãinr̃giͭͦsanitatisnr̃o⁊affomisdeIngenio	iã in r̃giͭͦ sanitatis nr̃o ⁊ affomis de Ingenio
sanitatish̃undanterinchoauitconsid̃acõespraticenecc̃as⁊	sanitatis h̃undanter inchoauit consid̃acões pratice necc̃as ⁊
sꝑamcũdeuocõeꝙipeꝑficietinꝯto	sꝑam cũ deuocõe ꝙ ipe ꝑficiet in ꝯto
dc̃oꝝaffoꝝ⁊inaliisaffomisꝑticuterexpͥmentib	dc̃oꝝ affoꝝ ⁊ in aliis affomis ꝑticuter expͥmentib
quepermedicũsapientemconsid̃andasunt	que per medicũ sapientem consid̃anda sunt
inmorbisquoꝝdãm̃brorum	in morbis quoꝝdã m̃brorum
ꝑticuriuminquib	ꝑticurium in quib
uelutinexemplosiuespeculoclaro	uelut in exemplo siue speculo claro
uiarc̃ꝓcessusincetẽisaꝑtissimecognoscaͬacũctisamatõibus	uia rc̃ ꝓcessus in cetẽis aꝑtissime cognoscaͬ a cũctis amatõibus
ũitatisducentumparuulosad	ũitatis ducentum paruulos ad
uiamqueducitad	uiam que ducit ad
xp̃mQuiconuertifeceritpeccatoremaberrore	xp̃m Qui conuerti fecerit peccatorem ab errore
uiesuesaluabitaĩameiusamorteetoperit	uie sue saluabit aĩam eius a morte et operit
multitudinempeccatorumExhocuerbotraherepotuit	multitudinem peccatorum Ex hoc uerbo trahere potuit
gregoriusnullumessedeoaccepciussacrificium	gregorius nullum esse deo accepcius sacrificium
ꝙͣzelumanimarumꝙsitanta	ꝙͣ zelum animarum ꝙ si tanta
sollicitudinisinquietudinesi	sollicitudinis inquietudine si
totuigiliisetcuriisĩmortalibuspermediauitepericulaquerunt	tot uigiliis et curiis ĩmortalibus per media uite pericula querunt
hominessaluateresuanasiamiamperiturassicolligere	homines saluate res uanas iam iam perituras si colligere
sataguntuilesterrenarũopumsarcinulasquas	satagunt uiles terrenarũ opum sarcinulas quas
apostolusarbitrabaturutstercoraEtdumhecaguntlaudanturut	apostolus arbitrabatur ut stercora Et dum hec agunt laudantur ut
industriiut	industrii ut
diligẽtesutofficiosietutiles	diligẽtes ut officiosi et utiles
reipubliceUideteoroquantaestuelinherciauelinfidelitas	rei publice Uidete oro quanta est uel inhercia uel infidelitas
deanimarum	de animarum
ĩmortaliumsalutenon	ĩmortalium salute non
curarexp̃ianosymoqualisillaestimpudentissimaperuersitas	curare xp̃ianos ymo qualis illa est impudentissima peruersitas
eosinculpareDñsq	eos inculpare Dñs q
nuncapertisnuncoccultis	nunc apertis nuncoccultis
prepedirequiducere	prepedire qui ducere
paruulossatagũtaiatArdisTantaardebatcurautarchitecto	paruulos satagũt aiat Ardis Tanta ardebat cura ut architecto
permiserituelut	permiserit uel ut
suãpecuniamconsumeretdũmodoperduceretspecusepistrinisin	suã pecuniam consumeret dũmodo perduceret specus epistrinis in
mareabiectamolequaestusbisquotidieabexorͭaluna	mare abiecta mole qua estus bis quotidie ab exorͭa luna
adproximũ	ad proximũ
nouãintroireacredirerursusinmarepossetac	nouã introire ac redire rursus in mare posset ac
refrigerarepiscinasNoscumhęc&eccestrepitusdestra	refrigerare piscinas Nos cum hęc & ecce strepitus destra
atq.leuacandidatusnosterdesignatusĘdilisadest	atq. leua candidatus noster designatus Ędilis adest
aduillã	ad uillã
Cuinosoccidimus&gratulati	Cui nos occidimus & gratulati
ĩCapitoliũpersequimurIlloindecunctosuãdomũ	ĩ Capitoliũ persequimur Illo inde cuncto suã domũ
nosnostrãOppinioninostrosermonedepastione	nos nostrã Oppinioni nostro sermone de pastione
uillaticasumatimhocquẽexposuihabitoMTerrencii	uillatica sumatim hoc quẽ exposui habito M Terrencii
Uarronisrerũrusticarum	Uarronis rerũ rusticarum
deuillaticispastionibusliberterciusexplicitfeliciter1414M	de uillaticis pastionibus liber tercius explicit feliciter 1414 M
TCEPISTOLARŨADATTICŨLXIIIINCIPITFELICITER	T C EPISTOLARŨ AD ATTICŨ L XIII INCIPIT FELICITER
CICEROatticosal.Adciceronemita	CICERO attico sal. Ad ciceronem ita
scripsistiutneqseueriusneqtemperatiusscribipotueritnec	scripsisti ut neq seuerius neq temperatius scribi potuerit nec
magisꝙͣquẽadomodũego	magis ꝙͣ quẽad o modũ ego
maximeuellemprudentissimeet̃adtulliosquare	maxime uellem prudentissime et̃ ad tullios quare
autistaproficientautaliudagamusDepecunia	aut ista proficient aut aliud agamus De pecunia
uͦuideoateomnẽdiligentiamadhiberiuelpotiusiam	uͦ uideo a te omnẽ diligentiam adhiberi uel potius iam
adhibitãesseefficisatehortos	adhibitã esse efficis a te hortos
habeonecuͦullumgenuspossessionisestquodmalimmaxime	habeo nec uͦ ullum genus possessionis est quod malim maxime
scilicetob	scilicet ob
eamcausamquaesusceptaest	eam causam quae suscepta est
cuiusfestinationemihitollisqm̃deestatepollicerisuelpotius	cuius festinatione mihi tollis qm̃ de estate polliceris uel potius
recipisdeindeet̃adκαταβίuitãMarciTulliiCiceroniscontra	recipis deinde et̃ ad καταβί uitã Marci Tullii Ciceronis contra
CatilinamOracionesiiiiorQuousq	Catilinam Oraciones iiiior Quo usq
tandemabut̃ecatilinapac̃ianr̃aQuãdiu	tandem abut̃e catilina pac̃ia nr̃a Quãdiu
furoristetuusnoseludet	furor iste tuus nos eludet
Quẽadfinemeffrenataseseiactabit	Quẽ ad finem effrenata sese iactabit
audaciaNichilne	audacia Nichil ne
nocturnũpresidiũpalacii	nocturnũ presidiũ palacii
nichilurbisvigilienichil	nichil urbis vigilie nichil
timoresppl̃inichilconcursusbonoꝝ	timores ppl̃i nichil concursus bonoꝝ
oĩmnichilhicmunitissim᷒habendi	oĩm nichil hic munitissim᷒ habendi
senatusloc᷒nich̃hoꝝorauultusq	senatus loc᷒ nich̃ hoꝝ ora uultusq
mouerũtPateretua	mouerũt Patere tua
consilianonsentisConstrictãiam	consilia non sentis Constrictã iam
hoꝝomniũscienciateneri	hoꝝ omniũ sciencia teneri
coniuracionẽtuãnõuidesQͥdꝓximaquidsuperiorinocteegeris	coniuracionẽ tuã nõ uides Qͥd ꝓxima quid superiori nocte egeris
ubifuerisquidconsiliiceperisquoscõuocauerisquẽ	ubi fueris quid consilii ceperis quos cõuocaueris quẽ
nr̃mignorarearbitraris	nr̃m ignorare arbitraris
Otp̃raomoressenat᷒hoc	O tp̃ra o mores senat᷒ hoc
intelligitconsuluidethic	intelligit consul uidet hic
tamenuiuituiuitImmoueroinsenatũuenit	tamen uiuit uiuit Immo uero in senatũ uenit
fitpublicicõsiliiparticeps	fit publici cõsilii particeps
Notat⁊designatoculisadcedẽunũqͤnq	Notat ⁊ designat oculis ad cedẽ unũqͤnq
nr̃mNosautẽfortesuiri	nr̃m Nos autẽ fortes uiri
satisfac̃ereipubliceuidem᷑siistiustelaacfuroremuitem᷒	satisfac̃e rei publice uidem᷑ si istius tela ac furorem uitem᷒
Admortemtecatilinaduciiussuconsulis	Ad mortem te catilina duci iussu consulis
iãpͥdemoportebatIntecõferri	iã pͥdem oportebat In te cõferri
pestemistam	pestem istam
ꝙͣtuĩnos	ꝙͣ tu ĩ nos
om̃siãmachinarisAnuerouiramplissim᷒p	om̃s iã machinaris An uero uir amplissim᷒ p
scipiopõtifex	scipio põtifex
maxim᷒tiberinũgracchũmediocriter	maxim᷒ tiberinũ gracchũ mediocriter
labefactãtestatũr.pae	labefactãte statũ r. pae
pͥuatusinterfecitCatilinaueroorbemterre	pͥuatus interfecit Catilina uero orbem terre
cedeatqincendiͦuastarecupientẽ	cede atq incendiͦ uastare cupientẽ
nosꝯsulesperferem᷒Namillanimisantiqͣpret̃eo	nos ꝯsules perferem᷒ Nam illa nimis antiqͣ pret̃eo
q̃dqsercaderetUoluitenĩin	q̃dq ser caderet Uoluit enĩ in
excelsumleuariadco	excelsum leuari ad co
niũutruenteillũdeexcelsooculiom̃iũꝑui	niũ ut ruente illũ de excelso oculi om̃iũ ꝑui
giturestiniquitaselatõnisutinaltũselimese	gitur est iniquitas elatõnis ut in altũ se lime se
erigatSedsc̃aoratio	erigat Sed sc̃a oratio
omnẽhumiamuniũsam	omnẽ humi am uniũsam
deicituanitatẽItemsermoBEatoꝝmartyrũclara	deicit uanitatẽ Item sermo BEatoꝝ martyrũ clara
gestaetsmina	gesta et s mina
fideliumincitam̃tasunteArmanturenĩ	fidelium incitam̃ta sunt e Armantur enĩ
filioꝝanimidũp	filioꝝ animi dũ p
turtriumphiClamatutiqxp̃ianoꝝ	tur triumphi Clamat utiq xp̃ianoꝝ
corpioꝝsanguissp̃ualiũ	cor pioꝝ sanguis sp̃ualiũ
bellatoꝝqͣntũamartriahecMaior	bellatoꝝ qͣntũ amar tria hec Maior
aũhisestcaritasxiiii	aũ his est caritas xiiii
SectaminicaritatẽEmulaminisp̃ualiamagisautẽutꝓph̃etisQͥ	Sectamini caritatẽ Emulamini sp̃ualia magis autẽ ut ꝓph̃etis Qͥ
enĩloquitur	enĩ loquitur
linguanõhõibloquit᷑seddeoNemoenĩauditSp̃s	lingua nõ hõib loquit᷑ sed deo Nemo enĩ audit Sp̃s
aũloquitur	aũ loquitur
myst̃iaNãquiꝓph̃athõibloquitur	myst̃ia Nã qui ꝓph̃at hõib loquitur
adedificatõemetexhortatõemet	ad edificatõem et exhortatõem et
consolationẽQͥloquitur	consolationẽ Qͥ loquitur
linguasemetip̃medificat	lingua semet ip̃m edificat
Qͥautemꝓph̃ateccl̃amdeiedificatUoloaũuos	Qͥ autem ꝓph̃at eccl̃am dei edificat Uolo aũ uos
om̃sloquilinguismagisaũproph̃areNammaiorestqui	om̃s loqui linguis magis aũ proph̃are Nam maior est qui
proph̃atquã	proph̃at quã
quiloquitur	qui loquitur
linguanisiforteinterteturuteccl̃aedificatõemaccipat	lingua nisi forte intertetur ut eccl̃a edificatõem accipat
Nuncaũfr̃essiueñoaduos	Nunc aũ fr̃es si ueño ad uos
linguisloquensquiduoꝓderonisi	linguis loquens quid uoꝓdero nisi
uobisloquarautinreuelatõeautinscĩaau	uobis loquar aut in reuelatõe aut in scĩa au
menetillesũĩuẽitGestaãthuisc̃iiuliani	men et illesũ ĩuẽit Gesta ãt hui sc̃i iuliani
adintegrũhabereneqͥuimad	ad integrũ habere neqͥuim ad
manũSC̃ebrigide	manũ SC̃e brigide
uirg̃iskl̃isfebroariiexgestis	uirg̃is kl̃is febroarii ex gestis
eiusBEata	eius BEata
brigidaortafuitĩscociadebonaꝓsapiaex	brigida orta fuit ĩ scocia de bona ꝓsapia ex
patredubtochomatrebrocaꝓgehec	patre dubtocho  matre broca ꝓgehec
asuapuericiabonaꝝ	a sua puericia bonaꝝ
rerumstudiisinoleuitpudicicieacsobrietatiintenta	rerum studiis inoleuit pudicicie ac sobrietati intenta
semꝑdebonisadmeliora	semꝑ de bonis ad meliora
crescebatetabipa	crescebat et ab ipa
puellarietate	puellari etate
uirtutũsignisextititadmirandaCũenĩa	uirtutũ signis extitit admiranda Cũ enĩ a
matresuatrãsmissaeẽtutdeuaccaꝝlactebutirumcõgregaret	matre sua trãsmissa eẽt ut de uaccaꝝ lacte butirum cõgregaret
etadpondus	et ad pondus
redderetsicutaliepuelleĩillisregionibfac̃esolebãt	redderet sicut alie puelle ĩ illis regionib fac̃e solebãt
heciamtũcuirgohospitalismagisuolẽsobediredeoꝙͣ	hec iam tũc uirgo hospitalis magis uolẽs obedire deo ꝙͣ
hõibpauꝑibhospitib᷒tamlacꝙͣbutirumlargit᷑distribuere	hõib pauꝑib  hospitib᷒ tam lac ꝙͣ butirum largit᷑ distribuere
cepitEtcumtp̃saduenissetut	cepit Et cum tp̃s aduenisset ut
om̃sredderentfructumuaccaꝝcooꝑatrices	om̃s redderent fructum uaccaꝝ cooꝑatrices
eiusmonstraueruntoꝑasua	eius monstrauerunt oꝑa sua
cõpletaUentumestadbrigidam	cõpleta Uentum est ad brigidam
utredderetopussuũ	ut redderet opus suũ
Quenonhabensquid	Que non habens quid
redderettotũpauꝑib᷒erogauerattimore	redderet  totũ pauꝑib᷒ erogauerat timore
matrispauidatotamsecõINnominedomini	matris pauida totam se cõ IN nomine domini
amenPateat	amen Pateat
uniuersissensinstrumẽtumpublicuminspecturis	uniuersis sens instrumẽtum publicum inspecturis
q̃dannodñimillesimotrecentesimotͥcesimoseptimodieuicesimasexta	q̃d anno dñi millesimo trecentesimo tͥcesimo septimo die uicesima sexta
mensisIuniiindictõnequinta	mensis Iunii indictõne quinta
Pontificat᷒sanctissimiinxp̃o	Pontificat᷒ sanctissimi in xp̃o
pr̃isacdñinr̃idñi	pr̃is ac dñi nr̃i dñi
bñdictisacͦsancteRomaneac	bñdicti sacͦsancte Romane ac
uniuersaliseccesũmipontificisxiiannot̃cioapd̃monasteriumsancti	uniuersalis ecce sũmi pontificis xii anno t̃cio apd̃ monasterium sancti
petͥdecult᷑acenom̃ordinissanctibñdicti	petͥ de cult᷑a cenom̃ ordinis sancti bñdicti
capituloꝓuincialiAllatummonast̃ioꝝmonachoꝝnigroꝝꝓuincierothomageñetturoneñ	capitulo ꝓuinciali Allatum monast̃ioꝝ monachoꝝ nigroꝝ ꝓuincie rothomageñ et turoneñ
auct̃eapl̃icacongregatofuitin	auct̃e apl̃ica congregato fuit in
meiinfrascriptipublici	mei infrascripti publici
notariiettestiumsubscriptoꝝsencia	notarii et testium subscriptoꝝ sencia
exꝑteueñabiliumpatrumdñoꝝd̃igr̃amaioris	ex ꝑte ueñabilium patrum dñoꝝ d̃i gr̃a maioris
moͣst̃iituroñ	moͣst̃ii turoñ
etsanctiflorenciidesalmuroaudegaueñ	et sancti florencii de salmuro audegaueñ
dioc̃adid	dioc̃ ad id
ꝑsedemapl̃icamspecialr̃	ꝑ sedem apl̃icam specialr̃
deputatoꝝabAgnellidebentimmolari	deputatoꝝ ab Agnelli debent immolari
quiaagnusfuturusẽcrucifigiqui	quia agnus futurus ẽ crucifigi qui
tollitpcc̃amundiSouesululãtmr̃esquiaagnosꝑdunt	tollit pcc̃a mundi S oues ululãt mr̃es quia agnos ꝑdunt
sñuocebalantesGrandemartiriũcrudelespectaculũlc̃	sñ uoce balantes Grande martiriũ crudele spectaculũ lc̃
vͣEximitur	vͣ Eximitur
macheranullaint̃uenͭc̃aSolastridetinuidia	machera  nulla int̃uenͭ c̃a Sola stridet inuidia
cũquinatusẽnullifaciatuiolenciãS	cũ qui natus ẽ nulli faciat uiolenciã S
ouescernimusmr̃esque	oues cernimus mr̃es que
suꝑantagnoslugentesUoxinramaauditaẽploratus	suꝑant agnos lugentes Uox in rama audita ẽ ploratus 
ululatusmagnuspignorasuntnõcreditased	ululatus magnus pignora sunt nõ credita sed
creatanõdeposita	creata nõ deposita
sedexpositatestisẽipa	sed exposita testis ẽ ipa
n᷑aquepugnabatin	n᷑a que pugnabat in
mr̃escũtyrãn᷒iactaretĩfãteslc̃vͣMatercrines	mr̃es cũ tyrãn᷒ iactaret ĩfãtes lc̃ vͣ Mater crines
capitisdissipabatqueornamentũcapitisamͭtebatQuantis	capitis dissipabat que ornamentũ capitis amͭtebat Quantis
modisinfantẽ	modis infantẽ
uolebatabscondere	uolebat abscondere 
ipeseinfantuluspublicabatNesciebattac̃e,quiaciamin	ipe se infantulus publicabat Nesciebat tac̃e , quia ciam in
eternuAmen	eternu Amen
AmenExplicitor̃osc̃iambrosii	Amen Explicit or̃o sc̃i ambrosii
quedicit᷑antemissamOrate	que dicit᷑ ante missam Orate
prohenricopauꝑeclericoquicõpleuithũclibrumAnno	pro henrico pauꝑe clerico qui cõpleuit hũc librum Anno
dñiMͦcccͦ	dñi Mͦ cccͦ
xlͦviiiͦIncrastinofestibt̃imartini	xlͦ viiiͦ In crastino fe sti bt̃i martini
hyemalisProdñoludowicodecanometñ	hyemalis Pro dño ludowico decano metñ
eccl̃ierigritaꝝGetuloꝝqpassimuagantiumNelittoraꝗ	eccl̃ie rigritaꝝ Getuloꝝq passim uagantium Ne littora ꝗ
infecundas̃tp᷑pura&murice	infecunda s̃t p᷑pura & murice
efficass̃isadtingendum&ubiq	efficass̃is ad tingendum & ubiq
q̃ĩtinxereclarissimaReliqͣestoramauritanięext̃ior&ĩ	q̃ ĩtinxere clarissima Reliqͣ est ora mauritanię ext̃ior & ĩ
finẽsuifastigãtisseafricęnouissimusangulusiisdemopibus	finẽ sui fastigãtis se africę nouissimus angulus iisdem opibus
sminusdiuesCęt̃umsolo	s minus diues Cęt̃um solo
ditiõ&ad̃oestfertilisutfrugũgñanõ	ditiõ & ad̃o est fertilis ut frugũ gña nõ
cũserant᷑modobenignissimeꝓcreetsq̃damꝓfũdat	cũ serant᷑ modo benignissime ꝓcreet s q̃dam ꝓfũdat
&̃notahicAntheusregnassedicit᷑Etsignũ	&̃ nota hic Antheus regnasse dicit᷑ Et signũ
q̃dfabulęprorsusõnditurclaꝝ	q̃d fabulę prorsus õnditur claꝝ
collismodicusresupinihõisimagĩeiacẽtisillius	collis modicus resupini hõis imagĩe iacẽtis illius
utĩcolęferũttumulusUndeuͥaliqͣꝑs	ut ĩcolę ferũt tumulus Unde uͥ aliqͣ ꝑs
eruptaestsolentimbressꝑgi&doneceffossarepleant᷑euẽiunt	erupta est solent imbres sꝑgi & donec effossa repleant᷑ euẽiunt
hoĩumꝑs	hoĩum ꝑs
siluasfreq̃ntãtminusꝙͣ	siluas freq̃ntãt minus ꝙͣ
quosm̃odiximusuagiꝑsĩurbibusagũt	quos m̃o diximus uagi ꝑs ĩ urbibus agũt
qͣꝝutĩt̃ꝑuasopulẽtissimę	qͣꝝ ut ĩt̃ ꝑuas opulẽtissimę
h̃nt᷑proculamariGilodanoDulbritaniaꝓpiusautemsola	h̃nt᷑ procul a mari Gilodano Dulbritania ꝓpius autem sola
&lixiofluminilimoꝓxima	& lixio flumini limo ꝓxima
Ultraestcolonia&fluuiusGnaEtundeinitium	Ultra est colonia & fluuius Gna Et unde initium
fecimusAmpelusia	fecimus Ampelusia
ĩnostrũiamfretumuergensꝓmontoriũoꝑishuius	ĩ nostrũ iam fretum uergens ꝓmontoriũ oꝑis huius
atatlanticilittoristerminusΤέλοςXXIIIIAprilis1450	at atlantici littoris terminus Τέλος XXIIII Aprilis 1450
AntheusAntheitulusGNAflAmpelusiarenturinanesalique	Antheus Anthei tu lus GNA fl Ampelusia rentur inanes alique
fuisseque	fuisse que
furtieẽntexcicatesictuet̃sicq̃dscribes	furti eẽnt excicate sic tu et̃ sic q̃d scribes
scribitotm̃nefurtũcessationisquesimilevideasUaldeeĩ	scribito tm̃ ne furtũ cessationis que simile videas Ualde eĩ
misemꝑetueraetdulciatuisepl̃isnũciantur	mi semꝑ et uera et dulcia tuis epl̃is nũciantur
AmanosetualeQuintusCiceroTironisuosal̃p.	Ama nos et uale Quintus Cicero Tironi suo sal̃ p.
dicitMIrificauimiuerberationemcessatiõisepl̃adedistiNamquefrater	dicit MIrificaui mi uerberationem cessatiõis epl̃a dedisti Nam que frater
ꝑtiusꝑscripseratuerecondiau	ꝑtius ꝑscripserat uerecondia u
etproꝑationeeãtu	et proꝑatione eã tu
sineassensioneuterantdeme	sine assensione ut erant de me
scripsistietmaximecoss.designatisquosegopẽitus	scripsisti et maxime coss. designatis quos ego pẽitus
nouilibidinũ	noui libidinũ
etlangoriset	et langoris et
effeminatissimiãiplenosquiubiagubernaculisrecesẜint	effeminatissimi ãi plenos qui ubi a gubernaculis recesẜint
maxĩuabuniuerso	maxĩu ab uniuerso
naufragioꝑiculũestIncredibileestqueegoillos	naufragio ꝑiculũ est Incredibile est que ego illos
scioappoĩtisgalloru	scio appoĩtis galloru
castrisĩestiuis	castris ĩ estiuis
fecissequosillelatroubi	fecisse quos ille latro ubi
aliquidfirmiusfuit	aliquid firmius fuit
societateuitiorũdelinietResestauttribunicisconsiliis	societate uitiorũ deliniet Res est aut tribunicis consiliis
minuendaNamisti	minuenda Nam isti
duouixsunt	duo uix sunt
digniquibusalteriCossutiͣnarumtabernarumfundamentacredasTe	digni quibus alteri Cossutiͣnarum tabernarum fundamenta credas Te
utdixiferecelerisEgouosadIIIIkl̃uidebo	ut dixi fere celeris Ego uos ad IIII kl̃ uidebo
tuosqoculosetsi	tuosq oculos et si
teuenies	te uenies
ĩmedioforouideodissamabor	ĩ medio foro uideo dissamabor
.MeamaUale	. Me ama Uale
LXVDeoGratiasAmen1450ciscentisdominiiniutãneceminterfectus	LXV Deo Gratias Amen 1450 ciscentis domini iniutã necem interfectus
&huicmaiorutroqhanibal	& huic maior utroq hanibal
imperatorAmilcarisfiliussucceditsiquidẽresgestasutriusq	imperator Amilcaris filius succedit siquidẽ res gestas utriusq
suꝑgressusuniuersamhyspaniãdomuitInderomanisillatobello	suꝑgressus uniuersam hyspaniã domuit Inde romanis illato bello
ytaliamꝑ	ytaliam ꝑ
annossexdecimuariis	annos sexdecim uariis
cladibusfatigauitCumintereaRomanimissis	cladibus fatigauit Cum interea Romani missis
inhyspaniaScipionibusprimopoenos	in hyspania Scipionibus primo poenos
prouinciaexpuleruntpostea	prouincia expulerunt postea
cũipsis	cũ ipsis
hyspanisgrauiabellagesseruntNecpriusꝑdomiteprouincieiugumqhyspani	hyspanis grauia bella gesserunt Nec prius ꝑdomite prouincie iugumq hyspani
acciperepotueruntꝙͣCesarAugustusperdomitoorbe	accipere potuerunt ꝙͣ Cesar Augustus perdomito orbe
uictriciaadeosarma	uictricia ad eos arma
transtulitpopulumqferumac	transtulit populumq ferum ac
barbarumlegibusadcultioremuiteusumtraductuminformã	barbarum legibus ad cultiorem uite usum traductum in formã
prouincieredegitDEOGRATIASHISPANIIUSTINIXXXXIIIIorUOLUMINUMTROGIPOMPEI	prouincie redegit DEO GRATIAS HISPANI IUSTINI XXXXIIIIor UOLUMINUM TROGI POMPEI
ABREVIATORISLIBEREXPLICITScriptumpermedominicũMacth̃i	ABREVIATORIS LIBER EXPLICIT Scriptum per me dominicũ Macth̃i
deReate	de Reate
manuꝓͥaREATEMCCCCLIIIIIII	manu ꝓͥa REATE MCCCCLIII IIII
kl̃MaiiRISSIMUMIMPERATOREMACILLUSTRISSIMUMPRINCIPEM	kl̃ Maii RISSIMUM IMPERATOREM AC ILLUSTRISSIMUM PRINCIPEM
COMITEMFRANCISCUMSFORTIAMVICECOMITEMFrancisciAleardiueronẽsislaudatio	COMITEM FRANCISCUM SFORTIAM VICECOMITEM Francisci Aleardi ueronẽsis laudatio
NONdubitoforeꝑmultosPrincepsillustrissimequirerum	NON dubito fore ꝑ multos Princeps illustrissime qui rerum
tuarũmagnitudinemadmiratipręstantiingeniouirilitterisetmonumentis	tuarũ magnitudinem admirati pręstanti ingenio uiri litteris et monumentis
suiseasmandareetillustrareconabunturpartim	suis eas mandare et illustrare conabuntur partim
utgratiamtuã	ut gratiam tuã
quamuelsũmisopibusuelamplissĩsdiuitiismeritoanteponantfacilius	quam uel sũmis opibus uel amplissĩs diuitiis merito anteponant facilius
cõsequanturPartimutintuisrebusmendandis	cõsequantur Partim ut in tuis rebusmendandis
uelingeniasuaexerceantuel	uel ingenia sua exerceant uel
intecollaudandomateriamnacticopiosissimamnomensuum	in te collaudando materiam nacti copiosissimam nomen suum
quoq.ĩmortalitatitransmittantDeniq.nõincideret&	quoq. ĩmortalitati transmittant Deniq. nõ incideret &
uoxindeerupit&sanguissicutdocet	uox inde erupit & sanguis sicut docet
Ouidi᷒driadesuõs̃tquęĩterarboreshabitant	Ouidi᷒ driades uõ s̃t quę ĩter arbores habitant
hocaut̃adsuꝑioraꝑtinetquędixeratmixtislustrabo	hoc aut̃ ad suꝑiora ꝑtinet quę dixerat mixtis lustrabo
menalanimphisNeccarminauobisipa	menala nimphis Nec carmina uobis ipa
placẽtdixeratcarminapastorissiculimodulaborauena	placẽt  dixerat carmina pastoris siculi modulabor auena
Ipsęrursuscõceditesiluę	Ipsę rursus cõcedite siluę
ꝑꝑilludIammihiꝑrupesvideorlucosqsonãtes	ꝑꝑ illud Iam mihi ꝑ rupes videor lucosq sonãtes
Necsifrigorib.mediuebrũqbibamusmanifeste	Nec si frigorib. mediu ebrũq bibamus manifeste
hocdicitamor̃secarer̃nõ	hoc dicit amor̃ se carer̃ nõ
posseNecsiebrumTracięfluuiũmediis	posse Nec si ebrum Tracię fluuiũ mediis
frigorib.bibatnecestib.nimiisfiuntĩardẽtiꝓuincia	frigorib. bibat nec estib. nimiis fiunt ĩ ardẽti ꝓuincia
dicitaut̃hocẜmphisicosquimorbosautaꝯtrariis	dicit aut̃ hoc ẜm phisicos qui morbos aut a ꝯtrariis
autasimilib.asserũtposse	aut a similib. asserũt posse
depelliSitionasqniuesSitonmonsẽtracięliber	depelli Sitionasq niues Siton mons ẽ tracię liber
corticisparsĩteriorUersemurpascamus	corticis pars ĩterior Uersemur pascamus
hecsaterit	hec sat erit
Iamadmusasloquiturgracilifiscellã	Iam ad musas loquitur gracili fiscellã
texitibiscoacsidiceretnisi	texit ibisco ac si diceret nisi
hacreoccupat᷒minimecanerẽallegoricosaut̃	hac reoccupat᷒ minime canerẽ allegoricos aut̃
significatsecõposuissehunclibellũtenuissimostiloquãtum	significat se cõposuisse hunc libellũ tenuissimo stilo quãtum
uerenououiridissesubicitalnusAmoinquitGallũ	uere nouo uiridis se subicit alnus Amo inquit Gallũ
sedlatentersicutarbores	sed latenter sicut arbores
crescũtnamoꝑatioista	crescũt nam oꝑatio ista
hocsignificatꝑꝑcęsarẽEtfrugib.umbręquãtomagis	hoc significat ꝑꝑ cęsarẽ Et frugib. umbrę quãto magis
hõib.uñ&̃ĩgeorgicis	hõib. uñ &̃ ĩ georgicis
&aurisoptati	& auris optati
fpuItedomũSaturęuenithesꝑus	f p u Ite domũ Saturę uenit hesꝑus
itecapellęuerecũdesecapellaꝝ	ite capellę uerecũde se capellaꝝ
dicitpastorẽ.i.uilissimoꝝanimaliuNambuccolica	dicit pastorẽ .i. uilissimoꝝ animaliu Nam buccolica
scribẽsdebuit	scribẽs debuit
sedicer̃boum	se dicer̃ boum
eẽpastorẽsuitãsãogãtiamultimũseuoluit	eẽ pastorẽ s uitãs ãogãtiam ultimũ se uoluit
eẽprincipẽĩscribẽdisbuccolicisfinisUiterbiiMͦCCCCLVmẽs̃	eẽ principẽ ĩ scribẽdis buccolicis finis Uiterbii MͦCCCCLV mẽs̃
maiiN.Vpont̃Mͦ	maii N. V pont̃ Mͦ
sedẽteEgoAngl̃usscarponi᷒scolaris	sedẽte Ego Angl̃us scarponi᷒ scolaris
hũclibrũscripsiDe	hũc librũ scripsi De
uassanoscilicortañdioc̃cepitq̃	uassano scilic ortañ dioc̃ cepit q̃
iasonihocordinetͣdiditꝯseruandaDetͣditõeRerũadincãtand̃	iasoni hoc ordine tͣdidit ꝯseruanda De tͣditõe Rerũ ad incãtand̃
INpͥmistͣdiditeiquãd̃ymaginẽargenteãꝙͣdixit	IN pͥmis tͣdidit ei quãd̃ ymaginẽ argenteã ꝙͣ dixit
esseꝑincantatõemnodos	esse ꝑ incantatõem nodos 
ml̃tiartificiiũtutecõstructamq̃adũsusincantatõesiãfc̃as	ml̃ti artificii ũtute cõstructam q̃ adũsus incantatões iã fc̃as
ẽualdepotissĩacassansuidelq̃fc̃aIamsũt&	ẽ ualde potissĩa cassans uidel q̃ fc̃a Iam sũt &
eoꝝuotiuaexpulsionefinaliRepellensDehacgͥiasonẽsͨ	eoꝝ uotiua expulsione finali Repellens De hac gͥ iasonẽ sͨ
instͧxituteãcautesupͣsedeferatnãadũsusincantatões	instͧxit ut eã caute supͣ se deferat nã adũsus incantatões
qͣslualeresesciet	qͣsl ualere se sciet
uociuoꝝincantatõisuiribanl̃latisScd̃osͥtradidͭcui᷒dãumguẽtiodoriferi	uociuoꝝ incantatõis uirib anl̃latis Scd̃o sͥ tradidͭ cui᷒dã umguẽti odoriferi
medicamẽquoip̃m	medicamẽ quo ip̃m
liuiresuasitasẜensineoũtutẽineẽut	liuire suasit asẜens in eo ũtutẽ ineẽ ut
adũsusꝯflãmas	adũsus ꝯflãmas
ualdeualeat	ualde ualeat
extingatincendia⁊om̃eꝙh̃tpotenciãꝯburendiincessa	extingat incendia ⁊ om̃e ꝙ h̃t potenciã ꝯburendi incessa
fumositateResoluatDem̃	fumositate Resoluat Dem̃
ꝙͣdãanulũsͥ	ꝙͣdã anulũ sͥ
deditinquotalisũtutũ	dedit in quo talis ũtutũ
lapiserat	lapis erat
inclususutq̃cũquenenacorriꝑẽtcorũnocum̃taRepelleret⁊	inclusus ut q̃cũq uenena corriꝑẽt corũ nocum̃ta Repelleret ⁊
ꝙͣueneniRabiesꝑfusaforsaninfic̃etuelut	ꝙͣ ueneni Rabies ꝑfusa forsan infic̃et uelut
abaqͥsinnãdequaillũ	ab aqͥs in nã de qua illũ
instuxitutꝙͣpͥmũꝑueniretadboueslicoreillo	instuxit ut ꝙͣ pͥmũ ꝑueniret ad boues licore illo
ineoꝝoraꝑfund̃etcrebris	in eoꝝ ora ꝑfund̃et  crebris
asꝑsionibirroraretIn	asꝑsionib irroraret In
licoreẽillo	licore ẽ illo
hancineẽuirtutẽasẜuntutꝙͣ	hanc ineẽ uirtutẽ asẜunt ut ꝙͣ
pͥmũorabouminfũderent᷑	pͥmũ ora boum infũderent᷑
exabillouelutq̃duiscoso	ex ab illo uelut q̃d uiscoso
glutinosͨꝯpactaꝯstring̃ent᷑ĩunũꝙeoꝝaꝑtura	glutino sͨ ꝯpacta ꝯstring̃ent᷑ ĩ unũ ꝙ eoꝝ aꝑtura
nõtamdifficilis	nõ tam difficilis
ꝙͣimpossibiliseẽt	ꝙͣ impossibilis eẽt
inillissͨdesingl̃issuccessiuemedea	in illis  sͨ de singl̃is successiue medea
Iasonẽdiligent̃	Iasonẽ diligent̃
instͧxitMedeagͥsuis	instͧxit Medea gͥ suis
instructionibdoctrinissͨ	instructionib  doctrinis sͨ
demũfinẽimposuitetdataiasonilicentiaRecedẽdi	demũ finẽ imposuit et data iasoni licentia Recedẽdi
añdieicõminãtislucisaduent̃Iasonin	añ diei cõminãtis lucis aduent̃ Iason in
decretãsͥCamerãfurtiuispassibse	decretã sͥ Camerã furtiuis passib se
RecepitInsurgẽtegͥRoseisaurorasplendoribetsole	Recepit Insurgẽte gͥ Roseis aurora splendorib et sole
aureolucemodicaCacumĩamontiũ	aureo luce modica Cacumĩa montiũ
illustranteiasonfutiuo	illustrante iason futiuo
surgitathalamoincomitiauidel	surgit a thalamo in comitia uidel
h̃culissuoꝝoetisRegisadiuitsoliũ	h̃culis  suoꝝ  oetis Regis adiuit soliũ
inquoipeRexiamseReceꝑatml̃toꝝastantichoraule	in quo ipe Rex iam se Receꝑat ml̃toꝝ astanti choraule
palliotyriantinoquoilleuelutspolionobilitatisexultatmesale	pallio tyriantino quo ille uelut spolio nobilitatis exultat mesale
nomẽuxõisiamꝗdlineaspetitaᷤ	nomẽ uxõis iam ꝗd lineas petitaᷤ
egyptoloquarQuidtyroetsydonatenuitateꝑlucidaᷤ	egypto loquar Quid tyro et sydona tenuitate ꝑ lucidaᷤ
micãtespũpuraplumãdidifficultateꝑnobilesdõatisũ	micãtes pũpura plumãdi difficultate ꝑ nobiles dõati sũ
atrabatitisbiripetitidonatibiricanussini	atrabatitis biri petiti donati biri canussini
africaneopesinscenaripri᷒uiseEthecquideidcĩco	africane opes inscenari pri᷒ uise Et hec quide idcĩco
egoĩlitterasretuliꝙfuturoseditões	ego ĩ litteras retuli ꝙ futuros editões
pudõetang̃etnepr̃imoniasuaproscriptislegitimis	pudõe tang̃et ne pr̃imonia sua pro scriptis legitimis
hr̃dib᷒mimis	hr̃dib᷒ mimis
etbalteõib.deputarẽtHabe	et balteõib. deputarẽt Habe
miamice	mi amice
meũmim᷒ꝙegoutsepedixinõ	meũ mim᷒ ꝙ ego ut sepe dixi nõ
eloquiẽtiecausasedcũiositatis	eloquiẽtie causa sed cũiositatis
inlumẽEdidiidcipueagẽsutsiꝗseloquẽsuellet	in lumẽ Edidi id cipue agẽs ut siꝗs eloquẽs uellet
fc̃aprĩcipu	fc̃a prĩcipu
reẜaremateriãnõreꝗuir̃eth̃iturosmeos	reẜare materiã nõ reꝗuir̃et h̃ituros meos
libellosministroseloquiitequeso	libellos ministros eloquii te queso
sisꝯtẽtusnosq.sicuoluissescriberemeli᷒ꝙͣpotuissecontẽdas	sis ꝯtẽtus nosq. sic uoluisse scribere meli᷒ ꝙͣ potuisse contẽdas
FeLiCiTerAm̃Expliciteuite	Fe Li Ci Ter Am̃ Explicite uite
DiuersoꝝPrĩcipũEtTyrãnoꝝA	Diuersoꝝ Prĩcipũ Et Tyrãnoꝝ A
diuoAdrianousqadNum̃ianumFeliciterUt̃e	diuo Adriano usq ad Num̃ianum Feliciter Ut̃e
FelixScript᷒fuitsub	Felix Script᷒ fuit sub
MillĩocccͦLVI	Millĩo cccͦ LVI
demensefebr̃	de mense febr̃
Etscripsiteum	Et scripsit eum
Frat̃ioh̃esdeCampagnolaRegiñ	Frat̃ ioh̃es de Campagnola Regiñ
dioc̃DeoG̃asAm̃Am̃am̃	dioc̃ Deo G̃as Am̃ Am̃ am̃
PErcorrer	PEr correr
miglioraqqOmailanauicelladelmioinChelascia	miglior aqq Omai la nauicella del mio in Che lascia
dietroasemarEcanterodiquel	dietro a se mar E cantero di quel
secondoOue	secondo Oue
lumanospirito	l umano spirito
sipurEdi	si pur E di
saliraddiodiuentade	salir a ddio diuenta de
MaquilamortapoesiriO	Ma qui la morta poesi ri O
santemusepoi	sante muse poi
cheuostEquicaliopealquantosur	che uost E qui caliope alquanto sur
Seghuitandoelmiocanto	Seghuitando el mio canto
conquelsonodichuilepicchemiseresentirolo	con quel sono di chui le picche misere sentiro lo
colpotalchedesperarꝑdonoDolcecolord	colpo tal che desperar ꝑdono Dolce color d
orientalzaphiroChesacolgeuanelsereno	oriental zaphiro Che s acolgeua nel sereno
aspectoDilaerpuroinsino	aspecto Dilaer puro insino
alprimogiroAgliocchimeiricomincio	al primo giro Agli occhi mei ricomincio
dilectotostoch	dilecto tosto ch
iouscidelauramortaChe	io usci de l aura morta Che
mauiacontristatigliocchielp	m auia contristati gli occhi e l p
Lobelpianetache	Lo bel pianeta che
damarconfortaFaceuatucto	d amar conforta Faceua tucto
riderloriente	rider l oriente
UelandoeipescicheraminsuascortREuerende	Uelando ei pesci ch eram in sua scort REuerende
discretõnisdñomagr̃ohugonicantuariensisdñi	discretõnis dño magr̃o hugoni cantuariensis dñi
ppͤnuncioinangliafraterNicolaustreuethorRecõmendatõne	ppͤ nuncio in anglia frater Nicolaus treueth or Recõmendatõne
hũiliReũenciã⁊honoremAntiquitataliq̃dexordium	hũili Reũenciã ⁊ honorem Antiquitat aliq̃d exordium
siueꝑcreationẽutcatholiciseuꝑIunoflagrationesseu	siue ꝑ creationẽ ut catholici seu ꝑ Iuno flagrationes seu
diluuiasicutplatonicinoneodẽeãualloIntercet̃os	diluuia sicut platonici non eodẽ eã uallo Inter cet̃os
aut̃maiorisuetustatisassertoresĩuẽsac̃dotibinsignẽint̃septẽsapientes	aut̃ maioris uetustatis assertores ĩuẽ sac̃dotib insignẽ int̃ septẽ sapientes
SolonẽinstrucmeoSaimurbem	Solonẽ instruc meo Saim urbem
egipciacãocto	egipciacã octo
milibannoꝝtũcsteathenaꝝꝓcessitcondiciomille	milib annoꝝ tũc ste athenaꝝ ꝓcessit condicio mille
ãnissml̃toantiquior	ãnis s ml̃to antiquior
hiisfingit᷑gensegcian᷒	hiis fingit᷑ gens eg cian᷒
inꝓlogoastronomiesuequiipolibrorari᷒inuenit᷑ex	in ꝓlogo astronomie sue qui ipo libro rari᷒ inuenit᷑ ex
ꝑsonasap̃ieꝑassent	ꝑsona sap̃ie ꝑ assent
uiguisseSedhũcantiquitatispositionẽ	uiguisse Sed hũc antiquitatis positionẽ
uelutfabulosisfitaugustin᷒deciuitatedeilibro	uelut fabulosis fit augustin᷒ de ciuitate dei libro
12mononsolũ	12mo non solũ
quiaueritati	quia ueritati
sacrescͥpturedissohystoriisgrecoꝝquiint̃	sacre scͥpture disso hystoriis grecoꝝ qui int̃
mũdisapientes	mũdi sapientes
anteRomanoshabiti	ante Romanos habiti
s̃tclarioresnimẽtadeclarãtdiscrepareꝙͣ	s̃t clariores nimẽta declarãt discrepare ꝙͣ
pl̃imũĩuenitur	pl̃imũ ĩuenitur
Quãdissonãciãdeclarãssancdocetquomͦutliquetex	Quã dissonãciã declarãs sanc docet quomͦ ut liquet ex
quadãepl̃aquã	quadã epl̃a quã
MatrisueOlimpiadiAlexandern	Matri sue Olimpiadi Alexander n
rioꝝRegnoascribũt	rioꝝ Regno ascribũt
egipciiannoꝝ5000ampli᷒cuigrecinõultra1300ait	egipcii annoꝝ 5000 ampli᷒ cui greci nõ ultra 1300 ait
tuqabeod̃	tuq ab eod̃
t̃minosuesumantcõputatõnis	t̃mino sue sumant cõputatõnis
pͥncipiũuidelabexordioregniBENEDICTUSep̃usẜuusẜuorum	pͥncipiũ uidel ab exordio regni B ENEDICTUS ep̃us ẜuus ẜuorum
deiUeñfr̃iEp̃o	dei Ueñ fr̃i Ep̃o
Magaloñsalt̃⁊apl̃icãbñDudumad	Magaloñ salt̃ ⁊ apl̃icã bñ Dudum ad
audientiamnr̃iapl̃atusꝑuenitꝑlate	audientiam nr̃i apl̃atus ꝑuenit ꝑlate
quodꝓeoꝙinCastrode	quod ꝓ eo ꝙ in Castro de
brixiacoMagaloñdioc̃adtuamMagal̃eccam&	brixiaco Magaloñ dioc̃ ad tuam Magal̃ eccam &
dilc̃mfiliũnobilemuirũRaymundumpetriMilitemdñmAgaut	dilc̃m filiũ nobilem uirũ Raymundum petri Militem dñm Agaut
eiusd̃dioc̃cõiter	eiusd̃ dioc̃ cõiter
ꝑtinẽteperquosdamiudic̃secular̃cur̃cõisecce	ꝑtinẽte per quosdam iudic̃ secular̃ cur̃ cõis ecce
acnobil̃dictoꝝcontͣquadam	ac nobil̃ dictoꝝ contͣ quadam
Michaelemgaut͛ieet	Michaelem gaut͛ie et
Emẽgardamdecarnic̃acAgnetẽfabricemulieresutasserebat᷑	Emẽgardam de carnic̃ ac Agnetẽ fabrice mulieres ut asserebat᷑
sortilegas⁊maleficasc̃tus	sortilegas ⁊ maleficas c̃tus
habitusꝓcessusfuerat⁊cõdempnacionissñiaꝓmulgataetexecutioni	habitus ꝓcessus fuerat ⁊ cõdempnacionis sñia ꝓmulgata et executioni
mandatainofficiidilc̃ifiliiInquisitorheretic̃	mandata in officii dilc̃i filii Inquisitor heretic̃
prauitat̃inillispartibauct̃eapl̃icadeputati	prauitat̃ in illis partib auct̃e apl̃ica deputati
utdicebat᷑iudiciũ⁊cõtemptumpereũdemInquisitor	ut dicebat᷑ iudiciũ ⁊ cõtemptum per eũdem Inquisitor
seudemãdatosuocontͣnonullasꝑsonas	seu de mãdato suo contͣ nonullas ꝑsonas
c̃tifuerãtfactiꝓcessusRoc̃tisexcaus̃	c̃ti fuerãt facti ꝓcessus Ro c̃tis ex caus̃
tamdetotoꝓcessusuꝑmiss̃habitoper	tam de toto ꝓcessu suꝑ miss̃ habito per
dc̃osIudic̃essecular̃ꝙͣꝓcessupredc̃opereũdemInquisitor̃	dc̃os Iudic̃es secular̃ ꝙͣ ꝓcessu predc̃o per eũdem Inquisitor̃
ueldesuoAdLuchinum	uel de suo Ad Luchinum
uicecoͥtemmediolanidominucũpiratransmitteretincidenter	uicecoͥtem mediolani dominu cũ pira transmitteret incidenter
egitdelaudib.italie	egit de laudib. italie
ARgolicassifama	ARgolicas si fama
uolansuulgataꝑurbesArborisausonie	uolans uulgata ꝑ urbes Arboris ausonie
quondamdumsplenduitetasAurea,saturno	quondam dum splenduit etas Aurea , saturno
terrisregnantefuiss⁊Ut	terris regnante fuiss⁊ Ut
reoreurysteusnũꝙͣ	reor eurysteus nũꝙͣ
totferrelaboresCogeretalcydem,suaditiapoma	tot ferre labores Cogeret alcydem , sua ditia poma
draconiOrtulushesperidummalecustoditushaberetHocpotius	draconi Ortulus hesperidum male custoditus haberet Hoc potius
mandaretopusnecuinceretauruNatiui	mandaret opus nec uinceret auru Natiui
dulcorisopesFelitius	dulcoris opes Felitius
omniEslatium	omni Es latium
tellurequidemfertilisoraItalieꝙͣfuluaceres	tellure quidem fertilis ora Italie ꝙͣ fulua ceres
uiridisq.mineruaPurpureusꝙͣ	uiridisq. minerua Purpureus ꝙͣ
bachusquãamattu	bachus quã amat tu
frõdeacaprisFloreamellificis	frõdea capris Florea mellificis
apib.pecoriq.	apib. pecoriq.
uicissimPascua	uicissim Pascua
etirriguis	et irriguis
latepulcerrimapratisTuredolensortisuariis	late pulcerrima pratis Tu redolens ortis uariis
scatebrosametallisArborib.q.uirenssiluisumbrosauetustis	scatebrosa metallis Arborib.q. uirens siluis umbrosa uetustis
antereclusumsubNuma	ante reclusum sub Numa
regeetuictaprimũcarthagineHincconuersusadpacem	rege et uicta primũ carthagine Hinc conuersus ad pacem
pronũinomnia	pronũ in omnia
malaetinluxumfluenssaeculumgrauibseuerisq	mala et in luxum fluens saeculum grauib seuerisq
legibusmultiscoercuitObhaectotfactaingentiadictator	legibus multis coercuit Ob haec tot facta ingentia dictator
ꝑpetuusetpaterpatriędictusest	ꝑpetuus et pater patrię dictus est
Tractatumetiaminsenatuanquiacondidissetimꝑiumromulus	Tractatum etiam in senatu an quia condidisset imꝑium romulus
uocaretursedsanctiuser	uocaretur sed sanctius er
reuerentiusuisumestnomenaugustiutscilicetiamdudum	reuerentius uisum est nomen augusti ut scilicet iamdudum
ducolitterrasiponomine	du colit terras ipo nomine
ettituloconsecret᷑LAnneiFloriliberultimusannodñi	et titulo consecret᷑ L Annei Flori liber ultimus anno dñi
1458IIInoñianuar̃Mlĩ	1458 III noñ ianuar̃ Mlĩ
DeolausEGOOMNIOFFICIOAC	Deo laus EGO OMNI OFFICIO AC
POTI᷒pietateergate	POTI᷒ pietate erga te
ceterissatisfacioomnibusmihi	ceteris satisfacio omnibus mihi
ipsenunꝙͣ	ipse nunꝙͣ
satisfacioTantaenimestmagnitudotuorumergamemeritorumut	satisfacio Tanta enim est magnitudo tuorum erga me meritorum ut
quoniamtunisiperfectare	quoniam tu nisi perfecta re
demenon	de me non
conquiestiegoidemintuacausanon	conquiesti ego  idem in tua causa non
officiouitãmihiesseacerbamputemIncausa	officio uitã mihi esse acerbam putem In causa
hęcsuntHamoniusregislegatusapertepecunianosoppugnatRes	hęc sunt Hamonius regis legatus aperte pecunia nos oppugnat Res
agiturpereosdemcompetitoresperquos	agitur per eosdem competitores per quos
cumtuaderasagebaturRegiscausasi	cum tu aderas agebatur Regis causa si
quisuntquiuelintꝗpaucisuntomnesremad	qui sunt qui uelint ꝗ pauci sunt omnes rem ad
pompeiumdeferriuoluntSenatusreligionis	pompeium deferri uolunt Senatus religionis
calũniamnonreligionesedmaleuolentia&illius	calũniam non religione sed maleuolentia & illius
regiaeLargitionisinuidiacõprobatPompeiumet	regiae Largitionis inuidia cõprobat Pompeium et
hortarietorare	hortari et orare
etiamLiberiusaccusareetmonereutmagnaminfamiamfugiat	et iam Liberius accusare et monere ut magnam infamiam fugiat
nondesistimusSedplanenecprecibusnr̃issiquidob	non desistimus Sed plane nec precibus nr̃is si quid ob
commissorumpenitenciameligitisueliniuria	commissorum penitenciam eligitis uel iniuria
amicisuestrisneanicomede	amicis uestris ne a nicomede
inferrisiniteSiceni	inferri sinite Sic eni
faciẽtibusuobisauxilia	faciẽtibus uobis auxilia
contraitalosregemnostrumlaturumpollicemuruelapparentem	contra italos regem nostrum laturum pollicemur uel apparentem
amiciciamsaltemdissoluiteuelromam	amiciciam saltem dissoluite uel romam
adiudiciumcontendamusunaSicpelopidaselocutusestHi	ad iudicium contendamus una Sic pelopidas elocutus est Hi
auteminsolenciisillumloquiarbitrantesmitridatemanicomedeet	autem insolenciis illum loqui arbitrantes mitridatem a nicomede et
capadociaabstiñeimperantsestatimAriobarzanemineamreducturos	capadocia abstiñe imperant se statim Ariobarzanem in eam reducturos
essepelopidaminsuperabexercitucedereiubentnec	esse pelopidam insuper ab exercitu cedere iubent nec
ulteriusadeosreuertinisiinhisquemandata	ulterius ad eos reuerti nisi in his que mandata
essentpermaneret	essent permaneret
rexInhuncmod̃	rex In hunc mod̃
tuleresentenciamet	tulere sentenciam et
discendentiabindepelopidecustodiamadhibuere	discendenti abinde pelopide custodiam adhibuere
nequempiaminitinereꝑuert̃etQuibusperactis	ne quempiam in itinere ꝑuert̃et Quibus peractis
consiliatantibellineutiqexpectantesaut	consilia tanti belli neutiq expectantes aut
utpopulonotafierentetgalatis	ut populo nota fierentet galatis
quiinasiasuntstatim	qui in asia sunt statim
mouentVerumquiapropiusipisexercitusaderatquemlucassius	mouent Verum quia propius ipis exercitus aderat quem lu cassius
asieproconsulretinebatetomnessocioꝝuires	asie proconsul retinebat et omnes socioꝝ uires
ĩunũconuenerantdispartitiscopiis	ĩ unũ conuenerant dispartitis copiis
unusquisqcastraponitCassiusbithinie	unusquisq castra ponit Cassius bithinie
etgalacieinmedioin	et galacie in medio in
annisperinferiorabithiHocpriuilegium	annis per inferiora bithi Hoc priuilegium
adñoppͣnobisetecclesie	a dño ppͣ nobis et ecclesie
nostreconcessumloquitur	nostre concessum loquitur
deom̃ibus	de om̃ibus
terriᷤquas	terriᷤ quas
habeteccl̃a	habet eccl̃a
nr̃aubicumqsintAlexanderepiscopusseruusseruorum	nr̃a ubicumq sint Alexander episcopus seruus seruorum
deidilectisfiliisAndreedecanoeccl̃esanctiauitieiusq	dei dilectis filiis Andree decano eccl̃e sancti auiti eiusq
fratribtampresentibquamfuturiscanonicesustituendis	fratrib tam presentib quam futuris canonice sustituendis
inꝑpetuumQuotiensanobisilludpetiturquod	in ꝑpetuum Quotiens a nobis illud petitur quod
religioniethonestaticondere	religioni et honestati condere
etpetentiumdesideriis	et petentium desideriis
congruuminpertirisuffragium	congruum inpertiri suffragium
Eaꝓpterdilectiindñofilii	Eaꝓpter dilecti in dño filii
uestrisiustispostulationibclementerannuimusetcũcta	uestris iustis postulationib clementer annuimus et cũcta
illũĩansosd̃ilinguaignitasap̃iamꝓmẽsfonsiugit͛	illũĩans os d̃i lingua ignita sap̃iam ꝓmẽs fons iugit͛
sanitatesemanãsQuimareĩmeabl̃ib	sanitates emanãs Qui mare ĩ meabl̃ib
gͤssib᷒sc̃ificasti	gͤssib᷒ sc̃ificasti
Qͥt̃rãp᷑pureãtuocruorefecistiqͥcelos	Qͥ t̃rã p᷑pureã tuo cruore fecisti qͥ celos
cõmeastiuͥĩmedio	cõmeasti uͥ ĩ medio
diuineacieirefulgesĩsplendoreĩmarcessibilisgl̃iesplendes	diuineaciei refulges ĩ splendore ĩmarcessibilis gl̃ie splendes
InexultatõneIocũditatis	In exultatõne Iocũditatis
ĩsaciabilisgaudesh̃theodorusAugustinus	ĩsaciabilis gaudes h̃ theodorus Augustinus
hocnom̃sortitus	hoc nom̃ sortitus
ẽul̃ꝑꝑethimologiãnõisꝓpt̃excellentiãdignitatisqm̃sic̃ĩꝑator	ẽ ul̃ ꝑꝑethimologiã nõis ꝓpt̃ excellentiã dignitatis qm̃ sic̃ ĩꝑator
augustuscellebatõsreges	augustus cellebat õs reges
sicisteexcellit	sic  iste excellit
õsdoctoresẜꝙdicitremigi᷒unde	õs doctores ẜ ꝙ dicit remigi᷒ unde
aliidoctoresꝯꝑant᷑	alii doctores ꝯꝑant᷑
stellisdañxiiQuiadiustĩamerudiuntml̃tossic̃	stellis dañ xii Qui ad iustĩam erudiunt ml̃tos sic̃
stelle⁊	stelle ⁊
c̃hicaut̃ꝯꝑat᷑solisic̃	c̃ hic aut̃ ꝯꝑat᷑ soli sic̃
pĩepl̃aq̃deeocantat᷑qiͣsolrefulgens	p ĩ epl̃a q̃ de eo cantat᷑ qiͣ sol refulgens
siciperefulsit	sic ipe refulsit
intemplod̃iScd̃o	in templo d̃i Scd̃o
p̃pf̃uorẽdilectõisqm̃sic̃m̃sisaugustusualdeferuetestu	p̃p f̃uorẽ dilectõis qm̃ sic̃ m̃sis augustus ualde feruet estu
calorissic⁊	caloris sic ⁊
ipeualde	ipe ualde
ĩcaluitignediuiniamorisuñipeĩ	ĩcaluit igne diuini amoris uñ ipe ĩ
libroꝯfõnũdesedicitSagittaũas	libro ꝯfõnũ de se dicit Sagittaũas
tucormeũcaritatetua⁊c̃It̃ibidẽaliqñ	tu cor meũ caritate tua ⁊ c̃ It̃ ibidẽ aliqñ
ĩtromittisme	ĩtromittis me
ĩaffc̃mml̃tũĩusitatũĩtrorsusnescioadqͣm	ĩ affc̃m ml̃tũ ĩusitatũ ĩtrorsus nescio ad qͣm
dulcedinẽq̃siꝑficiat᷑ĩme	dulcedinẽ q̃ si ꝑficiat᷑ ĩ me
nescioqͥderitꝙuitaistanõ	nescio qͥd erit ꝙ uita ista nõ
eritT̃ciop̃pethymologiamnõisDicit᷑eĩaugustin᷒ab	erit T̃cio p̃p ethymologiam nõis Dicit᷑ eĩ augustin᷒ ab
augeo⁊astimq̃dẽciuitasanaq̃dẽ	augeo ⁊ astimq̃d ẽ ciuitas  ana q̃d ẽ
sursũIndeaug̃qiͣaugenssuꝑnãciuitatẽ	sursũ Inde aug̃ qiͣ augens suꝑnã ciuitatẽ
uñdeeo	uñ de eo
cantat᷑Quiualuitamplificare	cantat᷑ Qui ualuit amplificare
ciuitatẽc̃ul̃utdr̃dinglosario	ciuitatẽ  c̃ ul̃ ut dr̃d in glosario
aug̃dr̃dmagnificusfelixclarusindoctrina	aug̃ dr̃d magnificus felix clarus in doctrina
fuit·H·magnificusĩuita	fuit ·H· magnificus ĩ uita
