iudiciidistrictop̄ceptoteñi.	iudicii districto p̄cepto teñi .
ĩueniunt	ĩ ueniunt
reꝓboꝝdescͥbensꝓph̃adauid.secretoꝝ	reꝓboꝝ descͥbens ꝓph̃a dauid . secretoꝝ
.qͤmpecc̃isexigentib;optiñeñmeret᷑.	. qͤm pecc̃is exigentib ; optiñe ñ meret᷑ .
.terciaportamortis.	. tercia porta mortis .
ꝓrsusadoctͥnasaluatoris.	ꝓrsus a doctͥna saluatoris .
.ūn⁊signisext̃iorib;penitẽtie	. ūn ⁊ signis ext̃iorib ; penitẽtie
sitĩabscondito.⁊pat̃celestisquiuidetĩabsconditoreddetei	sit ĩabscondito .⁊ pat̃ celestis qui uidet ĩabscondito reddet ei
igiturpenatemꝑalis⁊tͣnsitoria	igitur pena temꝑalis ⁊ tͣnsitoria
foliisñpalliat᷑.integra:queꝑpartesñ	foliis ñ palliat᷑ . integra : que ꝑ partes ñ
finemꝑseũans.asuꝑnoremuñatoresalutiset̃necõsequaturp̃mium	finem ꝑseũans . a suꝑno remuñatore salutis et̃ne cõsequatur p̃mium
uoluntatisaffcũ.s;uereornedelicatasauresoffẽdat	uoluntatis affcũ . s ; uereor ne delicatas aures offẽdat
enimadm̃samdiuitis.⁊nuptiisagniꝮmunicatis	enim adm̃sam diuitis .⁊ nuptiis agni Ꝯmunicatis
spiritalem.⁊alibi.Quidatescamium̃tis	spiritalem .⁊ alibi . Qui dat escam ium̃tis
escamcorporisappetiitaculeodiuinitatissuetransfixit.tres	escam corporis appetiit aculeo diuinitatis sue transfixit . tres
auresdiuinepietatis.iuigip̃cumĩstantia	aures diuine pietatis . iuigi p̃cum ĩstantia
necessariauitetemꝑaliᷤintellige:	necessaria uite temꝑaliᷤ intellige :
spargere.corenimduab;uiisĩgrediens.	spargere . cor enim duab ; uiis ĩgrediens .
obscurat᷑.canisuͦqͥĩcustodia	obscurat᷑ . canis uͦ qͥ ĩ custodia
recepta:mun᷒eiabsolutionisimpendat.cumq;	recepta : mun᷒ ei absolutionis impendat . cumq ;
tandus.si	tandus . si
uisumfũitexpedire.caueat	uisum fũit expedire . caueat
etiamdiligent̃.	etiam diligent̃ .
neadexꝮmunicatõnẽcui᷒qͣm.absq;manifesta⁊	ne ad exꝮmunicatõnẽ cui᷒ qͣm . absq ; manifesta ⁊
rõnabilicausaꝓcedat.	rõnabili causa ꝓcedat .
adqͣmsi	ad qͣm si
talit̃forteꝓcesserit:⁊requisit᷒	talit̃ forte ꝓcesserit :⁊ requisit᷒
.humilit̃	. humilit̃
ꝓcessũhui᷒mͦiñcuraũitabsq;gͣuaminereuocare	ꝓcessũ hui᷒mͦi ñ curaũit absq ; gͣuamine reuocare
:grauatus:aput	: grauatus : aput
suꝑioremdeponatdeĩiustaexcõmunicatõneq̃relam.ꝙsi	suꝑiorem deponat de ĩiusta excõmunicatõne q̃relam . ꝙ si
absq;ꝑiculomorepõt	absq ; ꝑiculo more põt
:adexcõicatorem:illumcũ	: ad excõicatorem : illum cũ
suomandato	suo mandato
remittat.infracompetentẽt̃minũabsoluendũ.	remittat . infra competentẽ t̃minũ absoluendũ .
alioqͥnip̃eꝑse.ul̃per	alioqͥn ip̃e ꝑ se . ul̃ per
aliumproutuid̃itexpedire:	alium prout uid̃it expedire :
sufficienticautione	sufficienti cautione
adũsusexcõmunicatorẽdeĩiustaexcõicatõneꝮstit̃it:	adũsus excõmunicatorẽ de ĩiusta excõicatõne Ꝯstit̃it :
excõicatorꝮdẽpnet᷑excõicatoadint̃eẽ:	excõicator Ꝯdẽpnet᷑ excõicato ad int̃ eẽ :
aliasnich̃omin᷒cumculpequalitaspostulaũit:suꝑiorisarbitrio	alias nich̃omin᷒ cum culpe qualitas postulaũit : suꝑioris arbitrio
puniend᷒.cũñleussitculpatantãinfigere	puniend᷒ . cũ ñ leus sit culpa tantã infigere
penaminsonti:nͥforsanerraũitexcausa	penam insonti : nͥ forsan erraũit ex causa
ꝓbabili.maximesilaudabil̃opiniõisexistat.uerũ	ꝓbabili . maxime si laudabil̃ opiniõis existat . uerũ
sicontͣexcõicatõissentñtiãnich̃rationabilefũita	si contͣ excõicatõis sentñtiã nich̃ rationabile fũit a
cõq̃renteꝓbatũ:idem.⁊suꝑĩiusta	cõq̃rente ꝓbatũ : idem .⁊ suꝑ ĩiusta
excõicatõnismolestia.	excõicatõnis molestia .
ꝑpenamadint̃eẽ.ul̃aliã	ꝑ penam adint̃ eẽ . ul̃ aliã
scd̃msuꝑiorisarbitͥum.nͥforsan⁊	scd̃m suꝑioris arbitͥum . nͥ forsan ⁊
ip̃mꝓbabilis	ip̃m ꝓbabilis
errorexcuset.⁊	error excuset .⁊
suꝑeoꝓquo	suꝑ eo ꝓ quo
iustafuitexcõmunicatõeligatus:ꝑcautionẽreceptãsatiffac̃ecõpellat᷑	iusta fuit excõmunicatõe ligatus : ꝑ cautionẽ receptã satiffac̃e cõpellat᷑
.l̃inpͥstinãreducat᷑sententiã	. l̃ inpͥstinã reducat᷑ sententiã
:usq;adsatisfactionẽꝮdignãĩuiolabilit̃obseruandã.si	: usq ; ad satisfactionẽ Ꝯdignã ĩuiolabilit̃ obseruandã . si
uͦiudex	uͦ iudex
suũrecogtioscenserrorẽ.parat᷒sittalẽreuocaresententiã.⁊	suũ recogtioscens errorẽ . parat᷒ sit talẽ reuocare sententiã .⁊
isꝓqͦlata	is ꝓ qͦ lata
fũit.ne	fũit . ne
absq;satisfactionereuocetillãappellet.appll̃atõiñdeferat	absq ; satisfactione reuocet illã appellet . appll̃atõi ñ deferat
inhacparte:nisitalissiterror.de	in hac parte : nisi talis sit error . de
qͦm̃itoualeatdubitari	qͦ m̃ito ualeat dubitari
.⁊tũcsufficienticautionerecepta.qd̃corãeo	.⁊ tũc sufficienti cautione recepta . qd̃ corã eo
adquẽextit̃itappellatum:ul̃delegato	ad quẽ extit̃it appellatum : ul̃ delegato
abip̃o.iuripareatexcõicatũabsoluat.	ab ip̃o . iuri pareat excõicatũ ab soluat .
sicq;penep̃scripteminime	sicq ; pene p̃scripte minime
subiacebit.cauensomninoneuolũtateꝑũsaĩalt̃iusp̃	subiacebit . cauens omnino ne uolũtate ꝑũsa ĩalt̃ius p̃
iudiciũm̃tiaturerrorẽ.sidistͥctioniscanonice	iudiciũ m̃tiatur errorẽ . si distͥctionis canonice
uulteffug̃e	uult effug̃e
disciplinam.Demodorecusandiiudicem	disciplinam . De modo recusandi iudicem
Dumsp̃alisit	Dum sp̃ali sit
ꝓhibitioneꝓuisum.nequisĩaliquẽexcõicatõis	ꝓhibitione ꝓuisum . ne quis ĩ aliquẽ excõicatõis
sententiãnͥꝮpetentiꝮmonitõnep̃missa	sententiã nͥ Ꝯpetenti Ꝯmonitõne p̃missa
.ꝓmulgarep̃sumat:uolentes	. ꝓmulgare p̃sumat : uolentes
etiãꝓuid̃e.	etiã ꝓuid̃e .
neforteꝮmonit᷒frustratorierecusationisl̃	ne forte Ꝯmonit᷒ frustratorie recusationis l̃
appellatõnisobiectu	appellatõnis obiectu
:monentisdeclinarepossitexamen:statuim᷒	: monentis declinare possit examen : statuim᷒
.qd̃siallegauerit.se	. qd̃ si allegauerit . se
iudicẽhr̃esuspectũ.corãeodẽ	iudicẽ hr̃e suspectũ . corã eodẽ
causãsuspicionisiusteassignet.⁊ip̃ecũadũsario.ul̃	causã suspicionis iuste assignet .⁊ ip̃e cũ adũsario . ul̃
siadũsariũforteñ	si adũsariũ forte ñ
h̃t:cumiudicearbitͦscõmunit̃eligat.aut	h̃t : cum iudice arbitͦs cõmunit̃ eligat . aut
siꝮmuniterꝮuenireñpossunt:eligant	si Ꝯmuniter Ꝯuenire ñ possunt : eligant
absq;malitia.ip̃eunũ.⁊	absq ; malitia . ip̃e unũ .⁊
illealium.qͥdesuspicioniscausacognoscant.	ille alium . qͥ de suspicionis causa cognoscant .
Etsineqͥuerĩtĩunãconcordaresententiã	Et si neqͥuerĩt ĩ unã concordare sententiã
:aduocentt̃cium.utquodduoexip̃isdecreũint	: aduocent t̃cium . ut quod duo ex ip̃is decreũint
:roburobtineatfirmitatis.sciantq;se	: robur obtineat firmitatis . sciantq ; se
adidfidelit̃exeq̃ndũ.exĩiunctonoƀinuintute	ad id fidelit̃ exeq̃ndũ . ex ĩiuncto noƀ inuintute
obedientie.subobtestationediuini	obedientie . sub obtestatione diuini
causauõsuspicionis	causa uõ suspicionis
legitima.	legitima .
coramip̃isinfracõpetentẽ	coram ip̃is infra cõpetentẽ
t̃minũñꝓbata:suaiuridcõneiudex	t̃minũ ñ ꝓbata : sua iuridcõne iudex
utatur.at	utatur . at
ip̃aꝓbatalegitime.derecusatorisassensu	ip̃a ꝓbata legitime . de recusatoris assensu
.ꝑsoneydonee	. ꝑsone ydonee
Ꝯmittatnegotiũrecusat᷒.ul̃adsuꝑiorẽtransmittat.uͭ	Ꝯmittat negotiũ recusat᷒ . ul̃ ad suꝑiorẽ transmittat . uͭ
ĩeoip̃eꝓcedat	ĩ eo ip̃e ꝓcedat
.scd̃mꝙfũitꝓcedendũ.porro	. scd̃m ꝙ fũit ꝓcedendũ . porro
exꝮmunicatoadappellatõnisobstacl̃mcõuolante	exꝮmunicato ad appellatõnis obstacl̃m cõuolante
.siei᷒excessuseiudentiareiul̃ip̃iusꝮfessione	. si ei᷒ excessus eiudentia rei ul̃ ip̃ius Ꝯfessione
.l̃alio	. l̃ alio
modolegitimefũitmanifestus:cumappellationisremediũ	modo legitime fũit manifestus : cum appellationis remediũ
ñsitad	ñ sit ad
defensionemĩiquitatis.s;p̃sidium	defensionem ĩiquitatis . s ; p̃sidium
ĩnocentieĩstitutũ:ñẽꝓuocationih᷒i	ĩnocentie ĩstitutũ : ñ ẽ ꝓuocationi h᷒i
deferendũ.	deferendũ .
Excessuqͦq	Excessu qͦq
;dubioexistente.nefriuoleappellationisdiffugio.appelans	; dubio existente . ne friuole appellationis diffugio . appelans
iuidicisꝓcessũimpediat.	iuidicis ꝓcessũ impediat .
corãeodemꝓbabilẽ	corã eodem ꝓbabilẽ
causãappellationisexponat.talemuidelicet.q̃si	causã appellationis exponat . talem uidelicet . q̃ si
foretꝓbata:possetlegitimareputari⁊sitc̃	foret ꝓbata : posset legitima reputari ⁊ si tc̃
habueritadũsarũinfrat̃minumsecl̃mlocoꝝdistantiã⁊tẽporis	habuerit adũsarũ infra t̃minum secl̃m locoꝝ distantiã ⁊ tẽporis
qͣlitatem⁊nat᷑amnegotii.abeodẽiudicemod̃and̃.	qͣlitatem ⁊ nat᷑am negotii . ab eodẽ iudice mod̃and̃ .
appellatõneint̃positaꝓsequat᷑.qͣm	appellatõne int̃posita ꝓsequat᷑ . qͣm
siꝓsequiñcuraũit:	si ꝓ sequi ñ curaũit :
extc̃.ip̃e	ex tc̃ . ip̃e
iudexñ	iudex ñ
obstãteꝓcedat.nulloaũadũsarioꝮparente.	obstãte ꝓcedat . nullo aũ adũsario Ꝯparente .
cumiudexexsuoofficio	cum iudex ex suo officio
ꝓceditappellationiscausacorãsuꝑiore	ꝓcedit appellationis causa corã suꝑiore
ꝓbata:sr̃ior	ꝓbata : sr̃ior
sueiuridc̃onisoffm̃exeqͣtur.	sue iuridc̃onis offm̃ exeqͣtur .
sz⁊siappellansĩei᷒ꝓbationedefec̃it:	sz ⁊ si appellans ĩ ei᷒ ꝓbatione defec̃it :
adeũaqͦip̃m	ad eũ a qͦ ip̃m
malitioseappellasseꝮstit̃it:reũtat᷑.cet̃m	malitiose appellasse Ꝯstit̃it : reũtat᷑ . cet̃m
.hasduasꝮstitutionesp̃missas	. has duas Ꝯstitutiones p̃missas
.nolum᷒adregularesextendiꝮtͣsuasobseruantias	. nolum᷒ ad regulares extendi Ꝯtͣ suas obseruantias
sp̃ales.Depenaexcõicatõnisiniuste	sp̃ales . De pena excõicatõnis in iuste
int̃minatõnediuiniiudicii	in t̃minatõne diuini iudicii
penitusint̃dicim᷒.necausacupiditatisullusaudeatexcõicatõisuincl̃o	penitus int̃dicim᷒ . ne causa cupiditatis ullus audeat excõicatõis uincl̃o
aliꝗ̃ĩnodare.l̃absolũeĩnodatum:inillismaxime	aliꝗ̃ ĩnodare . l̃ absolũe ĩnodatum : in illis maxime
regionib;ĩquib;exꝮsuetudinecũexcõicat᷒	regionib ; ĩ quib ; ex Ꝯsuetudine cũ excõicat᷒
absoluit᷑pecuniariapenamulctant᷑.	absoluit᷑ pecuniaria pena mulctant᷑ .
statuentesuͭcũexcommunicatõissententiã	statuentes uͭ cũ excommunicatõis sententiã
ĩiustãfuisseꝮstit̃it.excõicatoradrestituendãpecuniãsic	ĩiustã fuisse Ꝯstit̃it . excõicator ad restituendã pecuniã sic
extortã.per.cen.ec	extortã . per . cen . ec
.cõpellat᷑.⁊nͥfũit	. cõpellat᷑ .⁊ nͥ fũit
ꝓbabiliexroredecept᷒.tm̃demĩiuriãpassoꝑsoluat	ꝓbabili exrore decept᷒ . tm̃dem ĩiuriã passo ꝑ soluat
.⁊sifortesoluendoñfũit.	.⁊ si forte soluendo ñ fũit .
aĩadũsionealiicastiget᷑.Derestͥcta	aĩadũsione alii castiget᷑ . De restͥcta
ꝓhibitioneondebetrep̃hensibilematͥmoni	ꝓhibitione on debet rep̃hensibile matͥmoni
iudicari.siscd̃muarietatẽtẽpoꝝstatuta	iudicari . si scd̃m uarietatẽ tẽpoꝝ statuta
quoq;uariant᷑	quoq ; uariant᷑
humana.p̃sertimcũurgẽsnecc̃itas.	humana . p̃sertim cũ urgẽs necc̃itas .
l̃euidẽsutilitasid	l̃ euidẽs utilitas id
exposcat.qñip̃ed̃sexhiisq̃	exposcat . qñ ip̃e d̃s ex hiis q̃
ĩuet̃.	ĩuet̃ .
t̃.statuerat:ñ	t̃ . sta tuerat : ñ
nullamutauitĩnouo.	nulla mutauit ĩ nouo .
cũgͦꝓhibitionesdeꝮiugioĩscd̃o⁊tͥcioaffinitatis	cũ gͦ ꝓhibitiones de Ꝯiugio ĩscd̃o ⁊ tͥcio affinitatis
geñe.minimeꝮtͣhendo:⁊desobolesuscepta.ex	geñe . minime Ꝯtͣhendo :⁊ de sobole suscepta . ex
scd̃isnuptiis.cognationiuiri	scd̃is nuptiis . cognationi uiri
ñcopulanda.pͥorisdifficultatẽfreq̃nt̃	ñ copulanda . pͥoris difficultatẽ freq̃nt̃
ĩducant.⁊aliq̃nꝑiculumꝑiantaĩarum.utcessante	ĩducant .⁊ aliq̃n ꝑiculum ꝑiant aĩarum . ut cessante
ꝓhibitione.cesseteffect᷒:Ꝯstitutõessr̃	ꝓhibitione . cesset effect᷒ : Ꝯstitutões sr̃
ḣeditas	ḣ editas
.sacricõꝓbatõecõciliireuocantes:p̃senticõstitutõnedet̃nim᷒.	. sacri cõꝓbatõe cõcilii reuocantes : p̃senti cõstitutõne det̃nim᷒ .
utsiccontͣhentes	ut sic contͣhentes
.decet̃olib̃e	. decet̃o lib̃e
copl̃ent᷑.ꝓhibitioquoq;copulecõiugal̃	copl̃ent᷑ . ꝓhibitio quoq ; copule cõiugal̃
.qͣrtumꝮsanguinitatis⁊affinitatisgradũñexcedat.	. qͣrtum Ꝯsanguinitatis ⁊ affinitatis gradũ ñ excedat .
q̃mĩult̃iorib;gradib	q̃m ĩ ult̃iorib ; gradib
;iãñpot̃absq;grauidispensiohui᷒ꝓhibitio	; iã ñ pot̃ absq ; graui dispensio hui᷒ ꝓhibitio
obseruari:Quat̃nari᷒	obseruari : Qua t̃nari᷒
enimnum̃usbñꝮgruitꝓhibitioni	enim num̃us bñ Ꝯgruit ꝓhibitioni
Ꝯiugiicorporal̃.	Ꝯiugii corporal̃ .
dequodic̃apl̃c.ꝙuirñ	de quo dic̃ apl̃c . ꝙ uir ñ
h̃tpotestatẽsuicorporis.sedmulier	h̃t potestatẽ sui corporis . sed mulier
.neq;mulierh̃tpotestatẽsui	. neq ; mulier h̃t potestatẽ sui
corporis.s;	corporis . s ;
uir.Quia.iiiiͦ.sũthumoreᷤĩ	uir . Quia . iiiiͦ . sũt humoreᷤ ĩ
corpore.ꝙꝮstatexqͣtuor	corpore . ꝙ Ꝯstat ex qͣtuor
elem̃tis.	elem̃tis .
cũergoiamusq;	cũ ergo iam usq ;
adqͣrtũgradũꝓhibitõꝮiugal̃copulesitrestricta	adqͣrtũ gradũ ꝓhibitõ Ꝯiugal̃ copule sit restricta
:eamuolum᷒itaeẽ	: eam uolum᷒ ita eẽ
ꝑpetuã.ñobstantib;Ꝯsultationib;suꝑhoc	ꝑpetuã . ñ obstantib ; Ꝯsultationib ; suꝑ hoc
dudũeditis.uel	dudũ editis . uel
abaliis.	ab aliis .
ul̃anoƀ:ut	ul̃ a noƀ : ut
siquisꝮtraꝓhibitionem	siquis Ꝯtra ꝓhibitionem
hui᷒modip̃sumpseritcopulari:nll̃alonginqͥtatedefendat᷑annoꝝ	hui᷒modi p̃sumpserit copulari : nll̃a longinqͥtate defendat᷑ annoꝝ
.c̃qͥdemdiuturnitastemporis	. c̃ qͥdem diuturnitas temporis
ñminuatpecc̃m.s;augeat.tantoq	ñ minuat pecc̃m . s ; augeat . tantoq
;gͥuiorasĩtcrimina:qͣntodiuti᷒	; gͥuiora sĩt crimina : qͣnto diuti᷒
.infelicẽaĩamtenuerintalligatamdestͥna	. infelicẽ aĩam tenuerint alligatam destͥna
matrimoniaDepenaꝮtͣhentiumclamumĩhibitio	matrimonia De pena Ꝯtͣhentium clamum ĩhibitio
copuleꝮiugal̃sitintribusultimisgradib;reuocata	copule Ꝯiugal̃ sit in tribus ultimis gradib ; reuocata
:eamuolum᷒ĩaliisdistricteseruari.	: eam uolum᷒ ĩ aliis districte seruari .
uñp̃decessorũnr̃oꝝinherendouestigiis.clamdestinaꝮiugiapenit᷒	uñ p̃decessorũ nr̃oꝝ inherendo uestigiis . clamdestina Ꝯiugia penit᷒
inhibemus.	inhibemus .
ꝓhibẽtesetiã.	ꝓhibẽtes etiã .
nequissacerdostalib̃int̃eẽ	ne quis sacerdos talib̃ int̃ eẽ
p̃sumat.qͣre	p̃sumat . qͣre
sp̃alemquoꝝdãlocoꝝꝮsuetudinẽ	sp̃alem quoꝝdã locoꝝ Ꝯsuetudinẽ
.adaliagñal̃rꝓrogando.statuimus	. ad alia gñal̃r ꝓrogando . statuimus
uͭcũmatrimoniafũintꝮtͣhenda:ĩeccl̃iisꝑp̃sbit̃os	uͭ cũ matrimonia fũint Ꝯtͣhenda : ĩ eccl̃iis ꝑ p̃sbit̃os
publiceꝓponat᷑	publice ꝓponat᷑
.cõpetẽtit̃minop̃finito	. cõpetẽti t̃mino p̃finito
.utinfrcaillũ:	. ut infrca illũ :
quiuoluerit⁊ualuerit:legittimũimpedim̃tumopponat.⁊	qui uoluerit ⁊ ualuerit : legittimũ impedim̃tum opponat .⁊
ip̃ip̃sbit̃inich̃omin᷒ĩuestigent	ip̃i p̃sbit̃i nich̃omin᷒ ĩuestigent
utrũaliqd̃impedim̃tũobsistat.cumgͦ	utrũ aliqd̃ impedim̃tũ obsistat . cum gͦ
ꝓbabilisapparueritcõtecta:statuimus	ꝓbabilis apparuerit cõtecta : statuimus
uttalesꝑ	ut tales ꝑ
prelatoseccͣrumab	prelatos eccͣrum ab
obseruantiauet̃isrituscompeseant᷑.utquosxp̃iane	obseruantia uet̃is ritus compeseant᷑ . ut quos xp̃iane
religionilibereuoluntatisarbitͥumobtulit.salutiferecoactionis	religioni libere uoluntatis arbitͥum obtulit . salutifere coactionis
necc̃itasĩeiusobseruationeꝮseruet	necc̃itas ĩ eius obseruatione Ꝯseruet
.cumminusmalũexistatuiamdominiñagnosc̃e.	. cum minus malũ existat uiam domini ñ agnosc̃e .
qͣmagnitã:retroire	qͣm agnitã : retroire
proliberationesc̃eterre.lib̃andum	pro liberatione sc̃e terre . lib̃andum
sc̃amt̃̄ramdemanib᷒impioꝝ:	sc̃am t̃̄ram de manib᷒ impioꝝ :
ardentidesiderioaspirantes:deprudentũuiroꝝquiplene	ardenti desiderio aspirantes : de prudentũ uiroꝝ qui plene
noueruntcͥcumstantiastempoꝝ⁊locoꝝsacͦ	nouerunt cͥcumstantias tempoꝝ ⁊ locoꝝ sacͦ
approbanteꝮsiliodiffininim᷒.utitacrucesignatisep̃parent	approbante Ꝯsilio diffininim᷒ . ut ita cruce signati se p̃parent
:qd̃inkl̃.uiniiseq̃ntis	: qd̃ in kl̃ . uinii seq̃ntis
p᷒ꝓximum.om̃sqͥdisposuer̃t	p᷒ ꝓximum . om̃s qͥ disposuer̃t
tͣnsireꝑmare:cõueniantĩ	tͣnsire ꝑ mare : cõueniant ĩ
regnũsiciliealiisicutopportuerit.⁊	regnũ sicilie alii sicut opportuerit .⁊
decuerit.apud	decuerit . apud
brundusiũ.⁊aliiapudmessanam	brundusiũ .⁊ alii apud messanam
.⁊partesutrobiq;uicinas.	.⁊ partes utrobiq ; uicinas .
ubi⁊nosdisponentedñodisposuim᷒ꝑsonal̃rtc̃	ubi ⁊ nos disponente dño disposuim᷒ ꝑsonal̃r tc̃
adeẽ.qͣtinusconsilio⁊auxilio:ex̃citusxp̃ianus	ad eẽ . qͣtinus consilio ⁊ auxilio : ex̃citus xp̃ianus
salubrit̃ordinet᷑.cũbenedictione	salubrit̃ ordinet᷑ . cũ benedictione
diuina⁊	diuina ⁊
apl̃icaꝓfecturus	apl̃ica ꝓfecturus
.adeundẽquoq;t̃minũsestudeantp̃parare:qui	. adeundẽ quoq ; t̃minũ se studeant p̃parare : qui
ꝓposuerũtꝓficisciꝑt̃ram.significaturi	ꝓposuerũt ꝓficisci ꝑ t̃ram . significaturi
ḣint̃imnob̃.uteis	ḣ int̃im nob̃ . ut eis
adauxilium⁊Ꝯsiliũopportunũ	ad auxilium ⁊ Ꝯsiliũ opportunũ
.legatumde	. legatum de
nr̃olat̃eidoneumconcedam᷒.sac̃dotesaut̃⁊clericiqui	nr̃o lat̃e idoneum concedam᷒ . sac̃dotes aut̃ ⁊ clerici qui
fuerĩtĩex̃cituxp̃ianotamsubditi	fuerĩt ĩ ex̃citu xp̃iano tam subditi
quamp̃lati.or̃oni⁊exhortationidiligent̃insistantdocentes	quam p̃lati . or̃oni ⁊ exhortationi diligent̃ insistant docentes
eosũbo	eos ũbo
pariter⁊exemplo.uttimorẽ⁊amorẽ	pariter ⁊ exemplo . ut timorẽ ⁊ amorẽ
diuinũsemperhabeantañoculos.neqͥddicãtaut	diuinũ semper habeant añ oculos . ne qͥd dicãt aut
faciant.ꝙ	faciant . ꝙ
diuinãmaiestatẽoffendat.Etsi	diuinã maiestatẽ offendat . Et si
aliquandolapsifuerintĩpecc̃mꝑuerampenitentiãmox	aliquando lapsi fuerint ĩ pecc̃m ꝑ ueram penitentiã mox
resurgantgerenteshumilitatẽcordis	resurgant gerentes humilitatẽ cordis
⁊corꝑis.⁊tamĩ	⁊ corꝑis .⁊ tam ĩ
uictuqͣmĩuestitu:mediocritatemseruantes	uictu qͣm ĩ uestitu : mediocritatem seruantes
:dissensiones⁊	: dissensiones ⁊
emulationesom̃inouitando.liuore&rancoreoĩorelegatis.	emulationes om̃ino uitando . liuore & rancore oĩo relegatis .
uͭsicspũalib᷒⁊mat̃iralib;armismunitiadũsus	uͭ sic spũalib᷒ ⁊ mat̃iralib ; armis muniti adũsus
hostesfideisecuriusp̃lient᷑.nͨdesuap̃sum̃tes.	hostes fidei securius p̃lient᷑ . nͨ de sua p̃sum̃tes .
s;dediuinauirtutesꝑanteᷤ.Ip̃isaũt	s ; de diuina uirtute sꝑanteᷤ . Ip̃is aũt
cl̃icisindulgemus.utbeneficiasuaintegreꝑcipiantꝑtͥennium	cl̃icis indulgemus . ut beneficia sua integre ꝑcipiant ꝑ tͥennium
.acsieẽntineccl̃iaresidentes.⁊	. ac si eẽnt in eccl̃ia residentes .⁊
sinecc̃efũit:eaꝑidemtemp᷒pignori	si necc̃e fũit : ea ꝑ idem temp᷒ pignori
ualeantobligare.neaũt	ualeant obligare . ne aũt
ḣsc̃mꝓpositumimpediriul̃tardari	ḣ sc̃m ꝓpositum impediri ul̃ tardari
Ꝯtingatuniũsiseccͣrump̃latisdistrictep̃cipimus	Ꝯtingat uniũsis eccͣrum p̃latis districte p̃cipimus
.utsinguli	. ut singuli
ꝑlocasuaillosqͥsignũcrucisdeposuert̃:	ꝑ loca sua illos qͥ signũ crucis de posuert̃ :
resumere.	resumere .
actamillosqͣmalioscrucesignatoᷤ⁊	ac tam illos qͣm alios cruce signatoᷤ ⁊
quosadhucsignariconting̃it:adreodendũdominouota	quos ad huc signari conting̃it : ad reodendũ domino uota
sua.diligent̃moneant⁊inducant.⁊sinecc̃e	sua . diligent̃ moneant ⁊ inducant .⁊ si necc̃e
fueritꝑexcõicationisĩꝑsonas.⁊int̃dictisententiasint̃riseoꝝ:	fuerit ꝑ excõicationis ĩꝑsonas .⁊ int̃dicti sententias int̃ris eoꝝ :
omnit̃ͥgiũsatione	omni t̃ͥgiũsatione
cessante:compellant.illisdũtaxatexceptis	cessante : compellant . illis dũ taxat exceptis
.qͥb;tale	. qͥb ; tale
ĩpedim̃tumoccurrerit.ut	ĩpedim̃tum occurrerit . ut
scd̃mꝓuidentiamuotũeoꝝm̃itocõmutaridebeatul̃	scd̃m ꝓuidentiam uotũ eoꝝ m̃ito cõmutari debeat ul̃
differri.	differri .
adhecneqͥd	ad hec ne qͥd
innegotioxp̃iih̃sdeꝮtingentib;omittatur	innegotio xp̃i ih̃s de Ꝯtingentib ; omittatur
.uolum᷒⁊mandam᷒.ut	. uolum᷒ ⁊ mandam᷒ . ut
patriarche.	patri arche .
archiep̃i.ep̃i.abbates.⁊alii	archiep̃i . ep̃i . abbates .⁊ alii
qͥcuramobtinentaĩarumstudioseꝓponantꝮmissis	qͥ curam obtinent aĩarum studiose ꝓponant Ꝯmissis
sibippl̃isũbumcrucis.obsecrantes	sibi ppl̃is ũbum crucis . obsecrantes
.ꝑ.p.⁊fi	. ꝑ . p .⁊ fi
.⁊sp.sc̃m	.⁊ sp . sc̃m
unũsolumuerũet̃numdm̃.reges	unũ solum uerũ et̃num dm̃ . reges
Duces.pͥncipes	Duces . pͥncipes
.marchiones.comiteᷤ.⁊barones.	. marchiones . comiteᷤ .⁊ barones .
aliosq;magnates.nͨnonꝮmuniaciutatũuillarũq	aliosq ; magnates . nͨ non Ꝯmunia ciutatũ uillarũq
;⁊oppidũutqͥ	;⁊ oppidũ ut qͥ
ꝑsonal̃r⁊illucñaccesserintĩ	ꝑsonal̃r ⁊ illuc ñ accesserint ĩ
subsidiũt̃resc̃ecõpetentẽꝮferantnumerũbellatoꝝ	subsidiũ t̃re sc̃e cõpetentẽ Ꝯferant numerũ bellatoꝝ
.cumexpensisusq;adtͥenniũnecc̃iis	. cum expensis usq ; ad tͥenniũ necc̃iis
scd̃mꝓpriasfacl̃tatesĩremissionẽpecc̃oꝝsuoꝝ	scd̃m ꝓprias facl̃tates ĩ remissionẽ pecc̃oꝝ suoꝝ
proutĩgeñalib;litt̃isestexp̃ssum.⁊admaiorem	prout ĩ geñalib ; litt̃is est exp̃ssum .⁊ ad maiorem
cautelametiãinferi᷒expͥmet᷑	cautelam etiã inferi᷒ expͥmet᷑
.cui᷒remissionis	. cui᷒ remissionis
uolumuseẽparticipesñ	uolumus eẽ participes ñ
solũeos	solũ eos
qͥadḣnauespropͥasexhibuerint:s;⁊illos	qͥ ad ḣ naues propͥas exhibuerint : s ;⁊ illos
quip̃phocopusstuduerĩtfabricare.renuentib	qui p̃p hoc opus studuerĩt fabricare . renuentib
;:autsiquiforte	;: aut siqui forte
tamĩgratifuerintdominod̃onr̃o	tam ĩgrati fuerint domino d̃o nr̃o
.exparteapl̃icafirmit̃ꝓtestent᷑.utsciant	. ex parte apl̃ica firmit̃ ꝓtestent᷑ . ut sciant
sesuꝑhocĩnouissimodistrictiexaminisdie:	se suꝑ hoc ĩ nouissimo districti examinis die :
coramtrem̃doiudiceresponsuros.	coram trem̃do iudice responsuros .
pͥustñꝮsid̃antesquaconsc̃iaqͣuesecuritatecõparerepotuerĩt	pͥus tñ Ꝯsid̃antes qua consc̃ia qͣue securitate cõparere potuerĩt
coramunigenitodei	coram unigenito dei
filioih̃sxp̃o.cui	filio ih̃s xp̃o . cui
õiadeditpat̃ĩman᷒.	õia dedit pat̃ ĩ man᷒ .
sieiꝓpecc̃orib;crucifixoseruirerenuerintinhoc	si ei ꝓ pecc̃orib ; crucifixo seruire renuerint in hoc
negotio.qͣi	negotio . qͣi
ꝓpͥesibiꝓpͥo.cui᷒muñeuiuũt.	ꝓpͥe sibi ꝓpͥo . cui᷒ muñe uiuũt .
cui᷒bñficiosustentant᷑.qͥnetiamcui᷒sanguine	cui᷒ bñficio sustentant᷑ . qͥn etiam cui᷒ sanguine
sũtredempti.ne	sũt redempti . ne
gͦinhumeros	gͦ in humeros
hominũoneragrauia⁊importabiliaĩponereuideam᷑quedigito	hominũ onera grauia ⁊ importabilia ĩponere uideam᷑ que digito
nr̃omouerenolum᷒:similesillisquidicunt.	nr̃o mouere nolum᷒ : similes illis qui dicunt .
utiq;⁊ñfaciunt.Eccenosde	utiq ;⁊ ñ faciunt . Ecce nos de
hiisq̃ultranecessarias⁊mod̃atasexpensas	hiis q̃ ultra necessarias ⁊ mod̃atas expensas
potuimusreseruare.xxx.milia	potuimus reseruare . xxx . milia
librarũinhocopusconcedim᷒	librarũ in hoc opus concedim᷒
.⁊donam᷒.p̃t̃nauigiũqd̃crucesignatis	.⁊ donam᷒ . p̃t̃ nauigiũ qd̃ cruce signa tis
deurbeatq;uicinispartib;Ꝯferemus.assignaturi	de urbe atq ; uicinis partib ; Ꝯferemus . assignaturi
.nich̃omin᷒adḣop᷒.triamiliamarcharũargenti	. nich̃omin᷒ ad ḣ op᷒ . tria milia marcharũ argenti
.q̃apudnosde	. q̃ apud nos de
qͦzdamfideliũ	qͦzdam fideliũ
elemosinisremanserũt.aliisĩnecc̃itates⁊utilitatesp̃dicteterre	elemosinis remanserũt . aliis ĩ necc̃itates ⁊ utilitates p̃dicte terre
ꝑman᷒felicismemorie.	ꝑ man᷒ felicis memorie .
albertiIerosolimitanipatͥarche.acmagr̃oꝝtempli⁊	alberti Ierosolimitani patͥarche . ac magr̃oꝝ templi ⁊
hospitalisfidelit̃distributis.cupientesautẽalioseccͣrump̃latos	hospitalis fidelit̃ distributis . cupientes autẽ alios eccͣrum p̃latos
nͨnonclericosuniũsos	nͨ non clericos uniũsos
⁊ĩmerito	⁊ ĩ merito
⁊ĩp̃miohr̃eparticipes⁊cõsortes.excõmuni	⁊ ĩ p̃mio hr̃e participes ⁊ cõsortes . ex cõmuni
Ꝯciliiapprobationestatuim᷒	Ꝯcilii approbatione statuim᷒
utõsom̃ioclericitamsubti	ut õs om̃io clerici tam subti
qͣmprelati.	qͣm prelati .
uicesimaeccl̃iasticoꝝꝓuentuumusq;adtͥenniumintegreꝮferãt	uicesima eccl̃iasticoꝝ ꝓuentuum usq ; ad tͥennium integre Ꝯferãt
ĩsubsidiumt̃resc̃e.ꝑmanuseoꝝqͥ	ĩ subsidium t̃re sc̃e . ꝑ manus eoꝝ qͥ
adhocfuerĩtꝓuidentiaapl̃ica	ad hoc fuerĩt ꝓuidentia apl̃ica
ordinati.quib;damdumtaxatreligosisexceptisp̃statione	ordinati . quib ; dam dum taxat religosis exceptis p̃statione
meritoeximendis.Illisq;similit̃.	merito eximendis . Illisq ; similit̃ .
qͥassumpto.l̃assumendocrucissignacl̃o	qͥ assumpto . l̃ assumendo crucis signacl̃o
.suntꝑsonal̃rꝓfecturi.nosaũt⁊	. sunt ꝑsonal̃r ꝓfecturi . nos aũt ⁊
fratresnr̃i.sancteeccl̃ieromane	fratres nr̃i . sancte eccl̃ie romane
cardinales.plenariamdecimamꝑsoluem᷒	cardinales . plenariam decimam ꝑsoluem᷒
.sciantq;seom̃sadhocfideliter	. sciantq ; se om̃s ad hoc fideliter
obseruand̃ꝑ	obseruand̃ ꝑ
excõicatõissententiãobligatos.Itaquod	excõicatõis sententiã obligatos . Ita quod
illiquisuꝑfraudemscient̃	illi qui suꝑ fraudem scient̃
cõmiserint:sentñtiamexcõicationisĩcurrant.sane	cõmiserint : sentñtiam excõicationis ĩcurrant . sane
.qꝛiustoiudiciocelestisimꝑatoris	. qꝛ iusto iudicio celestis imꝑatoris
obsequiisin	obsequiis in
herentes.sp̃alidecet	herentes . sp̃ali decet
p̃rogatiuagaud̃e.	p̃rogatiua gaud̃e .
cũtemp᷒ꝓficiscendiannũ	cũ temp᷒ ꝓficiscendi annũ
excedatĩmodico.crucesignaticollectiᷤ	excedat ĩ modico . cruce signati collectiᷤ
.l̃talliis.aliisq;gͣuaminib	. l̃ talliis . aliisq ; gͣuaminib
;sintĩmunes	; sint ĩmunes
.quoꝝꝑͣs	. quoꝝ ꝑͣs
⁊bona.p᷒crucẽsusceptam:	⁊ bona . p᷒ crucẽ susceptam :
subbeatipetri⁊nr̃aꝓtectionesuscepimus.statuentes	sub beati petri ⁊ nr̃a ꝓtectione suscepimus . statuentes
utsubarchiep̃orũep̃oꝝ.	ut sub archiep̃orũ ep̃oꝝ .
atq;oĩum	atq ; oĩum
p̃latoꝝeccl̃iedefensioneꝮsistant.ꝓpriisnichilomin᷒ꝓtectorib;	p̃latoꝝ eccl̃ie defensione Ꝯsistant . ꝓpriis nichilomin᷒ ꝓtectorib ;
adbocspecial̃rdeputatis.Itauͭbonaeoꝝ.	ad boc special̃r deputatis . Ita uͭ bona eoꝝ .
donͨdeip̃oꝝobitu.certissimereditucognoscatur:	donͨ de ip̃oꝝ obitu . certissime reditu cognoscatur :
ĩtegramaneantacqͥeta.⁊siquisqͣmcontͣp̃sũpserit:	ĩtegra maneant acqͥeta .⁊ si quisqͣm contͣ p̃sũpserit :
cẽ.ecc.Ꝯpescat᷑	cẽ . ecc . Ꝯpescat᷑
.siquiuͦ	. si qui uͦ
ꝓficiscẽtiumilluc	ꝓficiscẽtium illuc
.adprestandasusurasiuram̃toteneant᷑astricti	. ad prestandas usuras iuram̃to teneant᷑ astricti
:creditoreseorum.	: creditores eorum .
uͭremittanteisp̃stitum	uͭ remittant eis p̃stitum
iuram̃tũ.⁊ab	iuram̃tũ .⁊ ab
usurarumexactionedesistant:eademp̃cipimusdistrictione	usurarum exactione desistant : eadem p̃cipimus districtione
compelli.Quidsiquis	compelli . Quid siquis
creditorumeosadsolutionẽcoegerĩtusurarũ:eũadrestitutionẽ	creditorum eos ad solutionẽ coegerĩt usurarũ : eũ ad restitutionẽ
earumsimilicogi	earum simili cogi
aĩadũsionemandam᷒.Iudeosũo	aĩadũsione mandam᷒ . Iudeos ũo
adremittendasusurasꝑscl̃aremcompellip̃cipim᷒potestatem.⁊	ad remittendas usuras ꝑ scl̃arem compelli p̃cipim᷒ potestatem .⁊
donecillasremisserĩt:abuniũsisxp̃ifidelib;	donec illas remisserĩt : ab uniũsis xp̃i fidelib ;
ꝑexcõicatõissententiãeis	ꝑ excõicatõis sententiã eis
om̃inocõmuniodeneget᷑.hiisaũtqͥuideisdebitasoluere	om̃ino cõmunio deneget᷑ . hiis aũt qͥ uideis debita soluere
neqͥuerĩt.ĩp̃sentisicpͥncipessecularesutilidilatione	neqͥuerĩt . ĩ p̃senti sic pͥncipes seculares utili dilatione
prouideant.qd̃postiterarreptũusq̃qͦdeip̃oꝝobitu	prouideant . qd̃ post iter arreptũ usq̃qͦ de ip̃oꝝ obitu
.l̃reditucertissimecognoscat᷑.	. l̃ reditu certissime cogno scat᷑ .
usurarũĩcõmodañĩc᷑ãtꝑfecteꝮscencatactionis.Quodꝑ	usurarũ ĩcõmoda ñ ĩc᷑ãt ꝑfecte Ꝯscencat actionis . Quod ꝑ
pleni᷒declarat᷑.ꝑhocꝙmonsiste.mons	pleni᷒ declarat᷑ . ꝑ hoc ꝙ mons iste . mons
orebdr̃	oreb dr̃
.orebenimadorint̃pretat᷑.Inmontẽ	. oreb enim ador int̃pretat᷑ . In montẽ
itaq;orebascendit	itaq ; oreb ascendit
.quicaritatisardore	. qui caritatis ardore
succensus.p̃rogatiuaꝮũsationiscet̃osañcellit.Inmonte	succensus . p̃rogatiua Ꝯũsationis cet̃os añcellit . In monte
istodñs.ĩflãma	isto dñs . ĩ flãma
ignismoysilegit᷑apparuisse.	ignis moysi legit᷑ apparuisse .
Ꝯstattñrubũ	Ꝯstat tñ rubũ
ĩquodñs	ĩ quo dñs
apparuit:penitusillesũpermansisse	apparuit : penitus ille sũ permansisse
.Inquofc̃odaturintelligi.qꝛigniscaritatis	. In quo fc̃o datur intelligi . qꝛ ignis caritatis
ñꝮburit.	ñ Ꝯburit .
s;illumĩat	s ; illumĩat
.nonꝮsumit.	. non Ꝯsumit .
s;Ꝯseruat.qꝛuirtutesua	s ; Ꝯseruat . qꝛ uirtute sua
forisspinaspecc̃orumexurit.⁊int᷒uiriditatemuirtutũ	foris spinas pecc̃orum exurit .⁊ int᷒ uiri ditatem uirtutũ
illibatãcustodit.ascendam᷒frẽsĩmontẽistũ	illibatã custodit . ascendam᷒ frẽs ĩ montẽ istũ
.⁊abigne	.⁊ ab igne
istocalefieri	isto calefieri
satagam᷒.ñmaneam᷒insegor	satagam᷒ . ñ maneam᷒ insegor
.ciuitateparua	. ciuitate parua
.s;ĩmonte	. s ; ĩ monte
istosaluosnosfaciamus.ꝓfessionienĩnr̃e	isto saluos nos faciamus . ꝓfessioni enĩ nr̃e
cõuenit.utñsolũmandata.	cõuenit . ut ñ solũ mandata .
s;⁊Ꝯsiliadiuinastudeam᷒adimplere.⁊ĩtabernaculo	s ;⁊ Ꝯsilia diuina studeam᷒ adimplere .⁊ ĩ tabernaculo
dñiseruientes.ñ	dñi seruientes . ñ
tm̃ĩsc̃a.s;⁊insc̃ascõꝝ	tm̃ ĩ sc̃a . s ;⁊ in sc̃a scõꝝ
Ꝯtendam᷒introire.	Ꝯtendam᷒ introire .
maneam᷒ĩmonteistocũmoyse.⁊c̃dño	maneam᷒ ĩ monte isto cũ moyse .⁊ c̃ dño
freq̃nt̃colloquam᷑	freq̃nt̃ colloquam᷑
.uttandẽꝑuenireualeam᷒admontẽillũ:qͥ	. ut tandẽ ꝑuenire ualeam᷒ ad montẽ illũ : qͥ
positusẽĩuerticemontiũ.adquẽfluentom̃s	positus ẽ ĩ uertice montiũ . ad quẽ fluent om̃s
gentes.ad	gentes . ad
huncmontẽꝓph̃a	hunc montẽ ꝓph̃a
nosĩuitans	nos ĩuitans
ait.uenite	ait . uenite
ascendam᷒inmontẽdñi.mõsiste.dñsẽ	ascendam᷒ in montẽ dñi . mõs iste . dñs ẽ
ih̃cxp̃c.	ih̃c xp̃c .
monspinguis.monscoagulat᷒.	mons pinguis . mons coagulat᷒ .
cuimontesĩcaseati.ñualẽtcoequari.Ip̃e	cui montes ĩ caseati . ñ ualẽt coequari . Ip̃e
ẽenĩquemunxitd̃soleoleticiep̃particib	ẽ enĩ quem unxit d̃s oleo leticie p̃particib
;suis.qͥgr̄amñadmensurãaccepit	; suis . qͥ gr̄am ñ ad mensurã accepit
.s;eãfidelib;suis.prout	. s ; eã fidelib ; suis . pro ut
cuiq;noũitexpedire:gratuitabonitatedistribuit.	cuiq ; noũit expedire : gratuita bonitate distribuit .
adhuncmontẽ.i.adseip̃m.ꝑduc̃e	ad hunc montẽ . i . adse ip̃m . ꝑduc̃e
nosdignet᷑.dñs	nos dignet᷑ . dñs
nr̃ih̃c	nr̃ ih̃c
xp̃c.qͥ	xp̃c . qͥ
cũpatre⁊sp̃usc̃ouiuit	cũ patre ⁊ sp̃u sc̃o uiuit
⁊regnatꝑom̃iascl̃oꝝscl̃a.amenremuitih̃c	⁊ regnat ꝑ om̃ia scl̃oꝝ scl̃a . amen remuit ih̃c
spũ.⁊turbauitseip̃m.⁊	spũ .⁊ turbauit se ip̃m .⁊
lacrimat᷒est⁊clamauit.lazare	lacrimat᷒ est ⁊ clamauit . lazare
ueniforas.legimusinscͥpturis	ueni foras . legimus in scͥpturis
sacris.⁊utinãscriptumsitindelebilisin	sacris .⁊ utinã scriptum sit in delebilis in
cordib᷒nr̃is.qꝛomnisxp̃i	cordib᷒ nr̃is . qꝛ omnis xp̃i
actio:animefidelisestlectio.siquidem	actio : anime fidelis est lectio . siquidem
ip̃exp̃crectelibricenseturnomine	ip̃e xp̃c recte libri censetur nomine
.eoquodinip̃oformamuitenr̃elegeredebeamus	. eoquod in ip̃o formam uite nr̃e legere debeamus
.dequolibͦ	. de quo libͦ
ꝑezechielemꝓph̃amscͥptumest	ꝑ ezechielem ꝓph̃am scͥptum est
.Expanditcorammelibrum.	. Expandit coram me librum .
qͥscͥptus	qͥ scͥptus
eratintus⁊	erat intus ⁊
foris.Etdñsĩ	foris . Et dñs ĩ
euangl̃ioloquensaddiscipl̃os	euangl̃io loquens ad discipl̃os
.gaudeteinquit.	. gaudete inquit .
quianominaur̃ascͥptast̃inlibrouite.	quia nomina ur̃a scͥpta st̃ in libro uite .
felixanima	felix anima
queĩlibrohoclegereiugiter⁊meditari	que ĩ libro hoc legere iugiter ⁊ meditari
studũit.⁊adexẽplũredẽptorissui.iusticie⁊sc̃itatis	studũit .⁊ ad exẽplũ redẽptoris sui . iusticie ⁊ sc̃itatis
oꝑib;fũitin	oꝑib ; fũit in
formata.freq̃nsenĩhui᷒libri	formata . freq̃ns enĩ hui᷒ libri
lectio.rediredocetadcorhominẽ.⁊culpasagnoscere	lectio . redire docet ad cor hominẽ .⁊ culpas agnoscere
.suspirare	. suspirare
adueniã.	ad ueniã .
morescõponere	mores cõponere
.carnemsubic̃esp̃ui.salutemquerere.	. carnem subic̃e sp̃ui . salutem querere .
uitãĩuenire.Etqͥdem	uitã ĩuenire . Et qͥdem
diũsosinhoclibrodiũsalegentes.ezechielisꝓph̃etestimoniũ	diũsos in hoc libro diũsa legentes . ezechielis ꝓph̃e testimoniũ
cõꝓbat.qui	cõꝓbat . qui
ĩeodemlibrocoramseexpanso	ĩ eodem libro coram se expanso
.lam̃tationes⁊carm̃.⁊ue.	. lam̃tationes ⁊ carm̃ .⁊ ue .
scͥptafuisseꝮmemorat.	scͥpta fuisse Ꝯmemorat .
Expanditinqͥtcorammelibrũ.qͥeratscͥptus	Expandit inqͥt coram me librũ . qͥ erat scͥptus
int᷒⁊foris.⁊scͥptaerantin	int᷒ ⁊ foris .⁊ scͥpta erant in
eo.lam̃tationes	eo . lam̃tationes
.⁊carm̃.⁊ue.triah̃adtriplicemstatũ	.⁊ carm̃ .⁊ ue . tria h̃ ad triplicem statũ
uitep̃sentisñinꝮgruerespiciunt.inquodiũsi	uite p̃sentis ñ inꝮgrue respiciunt . in quo diũsi
diũsisaffectistudiis.ul̃	diũsis affecti studiis . ul̃
abinuioad	ab in uio ad
uiami᷒ticie	uiam i᷒ticie
.ꝑoꝑapenitentiedirigunt᷑.ul̃celestisgr̃e	. ꝑ oꝑa penitentie dirigunt᷑ . ul̃ celestis gr̃e
muñeiustificati.iamnuncĩ	muñe iustificati . iam nunc ĩ
semitisꝑfectionisambulãt.ul̃certelatash᷒	semitis ꝑfectionis ambulãt . ul̃ certe latas h᷒
seculiuiasgradientes.a	seculi uias gradientes . a
rectitudinemãdatoꝝd̃i	rectitudine mãdatoꝝ d̃i
.ꝑtortuososuitiorũ	. ꝑ tortuosos uitiorũ
circuit᷒.magisacmagiselongant᷑	circuit᷒ . magis ac magis elongant᷑
.st̃enimqͥdamquiuitiis⁊	. st̃ enim qͥdam qui uitiis ⁊
scelerib;irretiti.dum	scelerib ; irretiti . dum
recogitantsuppliciaimpiis	recogitant supplicia impiis
⁊pecc̃orib;p̃parata.dum.dumattendũt	⁊ pecc̃orib ; p̃parata . dum . dum attendũt
carc̃emtenebrosũ.fletus	carc̃em tenebrosũ . fletus
⁊stridorẽdentiũ.uermemquiñ	⁊ stridorẽ dentiũ . uermem qui ñ
morit᷑.ignẽqͥñ	morit᷑ . ignẽ qͥ ñ
extĩguit᷑.dumĩquam	extĩguit᷑ . dum ĩquam
attendunth̃om̃ia.m̃teꝮpungũt᷑.	attendunt h̃ om̃ia . m̃te Ꝯpungũt᷑ .
Ꝯfugiũtadlam̃tapenitẽtie.plangũtfortit̃malaq̃	Ꝯfugiũt ad lam̃ta penitẽtie . plangũt fortit̃ mala q̃
Ꝯmisert̃.ethiiinlibroqͥ	Ꝯmisert̃ . et hii in libro qͥ
xp̃cest:lam̃tationesscͥptas	xp̃c est : lam̃tationes scͥptas
inueniunt.sunt	inueniunt . sunt
aliiqͥmagnitudinembeneficioꝝ	alii qͥ magnitudinem beneficioꝝ
deiergase	dei erga se
diligenti᷒intuentes.qd̃uidelicet	diligenti᷒ intuentes . qd̃ uidelicet
.depecc̃iꝑpetrationemerentib;.ñsolũ	. de pecc̃i ꝑpetratione merentib ;. ñ solũ
Ꝯmissamisericordit̃	Ꝯmissa misericordit̃
dimisit.s;⁊	dimisit . s ;⁊
amissalib̃aliterrestaurauit.	amissa lib̃aliter restaurauit .
qd̃dignos	qd̃ dignos
supplicio.sanguineꝓpͥodemorte	supplicio . sanguine ꝓpͥo de morte
redemit.ꝙdeniq;ꝑseũantib	redemit . ꝙ deniq ; ꝑseũantib
;infinẽ:eaqueocul᷒ñuid̃	; in finẽ : ea que ocul᷒ ñ uid̃
.necaurisaudiuit.nec	. nec auris audiuit . nec
incorhom̃isascendunt.reꝓmisit:tales	in cor hom̃is ascendunt . reꝓmisit : tales
inqͣmspecelestiumbonoꝝꝮfortati.	inqͣm spe celestium bonoꝝ Ꝯfortati .
currũthilariteruiammandatoꝝd̃i.⁊utmereant᷑assequiqd̃	currũt hilariter uiam mandatoꝝ d̃i .⁊ ut mereant᷑ assequi qd̃
d̃sreꝓmittit:	d̃s reꝓmittit :
studẽtmodisom̃ib;	studẽt modis om̃ib ;
amareꝙp̃cipit	amare ꝙ p̃cipit
.pregaudiosp̃cĩuocẽlaudis	. pregaudio sp̃c ĩuocẽ laudis
⁊iubilationiserumpũt	⁊ iubilationis erumpũt
.⁊hiiinlibroqͥxp̃c	.⁊ hii in libro qͥ xp̃c
ẽcarmenexaratũĩueniunt.de	ẽ carmen exaratũ ĩueniunt . de
quocarminepsalmistaait.statuitsuprapetrampedes	quo carmine psalmista ait . statuit supra petram pedes
meos.⁊direxitgressusmeos.Etĩmisitĩos	meos .⁊ direxit gressus meos . Et ĩmisit ĩ os
meũcanticũnouũ.carmendeonostro.st̃⁊	meũ canticũ nouũ . carmen deo nostro . st̃ ⁊
aliiqui	alii qui
inꝓfundouitioꝝꝮstituti	in ꝓfundo uitioꝝ Ꝯstituti
.postperpetrata	. post per petrata
mala:ceruicẽmentiserigt̃adnullaspenitentielam̃tationesĩclinant᷑	mala : ceruicẽ mentis erigt̃ ad nullas penitentie lam̃tationes ĩclinant᷑
.nullacelestiũgaudioꝝcorrigunt᷑exspectatione	. nulla celestiũ gaudioꝝ corrigunt᷑ exspectatione
.⁊hiiꝓculdubioĩlibroquixp̃cest:scͥptum	.⁊ hii ꝓculdubio ĩ libro qui xp̃c est : scͥptum
uedãpnationiset̃̄ne.	ue dãpnationis et̃̄ne .
ꝑlamẽtationesigit᷑:penĩa⁊lacͥme	ꝑ lamẽtationes igit᷑ : penĩa ⁊ lacͥme
pecc̃orũ.ꝑcarmen:	pecc̃orũ . ꝑ carmen :
gaudiai᷒toꝝ	gaudia i᷒toꝝ
.ꝑue:supplicia	. ꝑ ue : supplicia
reꝓboꝝꝮuenient̃expͥmunt᷑.tibigͥ	reꝓboꝝ Ꝯuenient̃ expͥmunt᷑ . tibi gͥ
uirbonequiꝑadoptionis	uir bone qui ꝑ adoptionis
sp̃minluce	sp̃m in luce
sereniorisꝮscientieiocũdaris.qui	serenioris Ꝯscientie iocũdaris . qui
repletusfructui᷒ticie.mordacipecc̃oꝝmemoria.ñ	repletus fructu i᷒ticie . mordaci pecc̃oꝝ memoria . ñ
pungeris:tibiĩꝗͣ:carmen	pungeris : tibi ĩꝗͣ : carmen
inhoclibroloquit᷑uerbacõsolationis.	in hoc libro loquit᷑ uerba cõsolationis .
ũbaspirital̃iocũditatisq̃st̃.adepcõ	ũba spirital̃ iocũditatis q̃ st̃ . ad epcõ
gr̃e.feruordeuotionisĩt̃ne.angl̃oꝝꝮsortium.	gr̃e . feruor deuotionis ĩ t̃ne . angl̃oꝝ Ꝯsortium .
gaudiũsinefinemansurũ.utꝓ	gaudiũ sine fine mansurũ . ut ꝓ
huisom̃ib;gr̃asagensdeo:ꝑtẽporalẽbonoꝝ	huis om̃ib ; gr̃as agens deo : ꝑtẽporalẽ bonoꝝ
oꝑumex̄citationẽ.transeasqñq;felicit̃	oꝑum ex̄ citationẽ . transeas qñq ; felicit̃
adfut̃egl̃ieꝑhennitatẽ.tuaũh̃opecc̃or	ad fut̃e gl̃ie ꝑ hennitatẽ . tu aũ h̃o pecc̃or
qͥiampͥdemfedusinisti	qͥ iam pͥdem fedus in isti
cummorte.⁊pactumcũinferno.	cum morte .⁊ pactum cũ inferno .
quicumlazarosepultusiacesĩsepulcrotenebrose	qui cum lazaro sepultus iaces ĩ sepulcro tenebrose
cõscientie.p̃ssuslapidepͣueꝮsuetudinis.ligatusinstitis	cõscientie . p̃ssus lapide pͣue Ꝯsuetudinis . ligatus institis
pecc̃oꝝ.⁊uelatã	pecc̃oꝝ .⁊ uelatã
hñsfaciemsudariopessimo	hñs faciem sudario pessimo
int̃nececitatis.tu	int̃ne cecitatis . tu
inqͣmqͥsicdormis:aduocemredẽptoris	inqͣm qͥ sic dormis : aduocem redẽptoris
saltẽnũcexurrgeamortius	saltẽ nũc exurrge a mortius
.⁊uteuadasuedãpnationiset̃ne:legeinlibro	.⁊ ut euadas ue dãpnationis et̃ne : lege in libro
hoclam̃tationesdoloris	hoc lam̃tationes doloris
⁊penĩe.corpustuumcrucifige	⁊ penĩe . corpus tuum crucifige
cumuiciis⁊Ꝯcupiscentiisei᷒.ut⁊ip̃os	cum uiciis ⁊ Ꝯcupiscentiis ei᷒ . ut ⁊ ip̃os
sensuscorporis.anoxiispostmodumretrahasexcessib;.ne	sensus corporis . a noxiis postmodum retrahas excessib ;. ne
uidl̃c.ocl̃s	uidl̃c . ocl̃s
uideatuanitatẽ	uideat uanitatẽ
.neaurisaudiatiudiciũ	. ne auris audiat iudiciũ
sanguinisul̃detractionẽ.	sanguinis ul̃ detractionẽ .
nonodoratusq̃ratsuauia.	non odoratus q̃rat suauia .
ñgustusdeliciosa:ñdeniq;manusextendat᷑	ñ gustus deliciosa : ñ deniq ; manus extendat᷑
adillicita.certe	ad illicita . certe
sollicitudinẽredẽptoristuicircatediligenti᷒intuearis:iã	sollicitudinẽ redẽptoris tui circa te diligenti᷒ intuearis : iã
decet̃osalutistue	decet̃o salutis tue
negligensacdesidiosuseẽñpot̃is.	negligens ac desidiosus eẽ ñ pot̃is .
quinĩmoreiectacuraꝝ	quin ĩmo reiecta curaꝝ
scl̃ariũcuriositate.totamsollicitudinemtuamĩip̃mꝓicies.	scl̃ariũ curiositate . totam sollicitudinem tuam ĩ ip̃m ꝓicies .
memorsemꝑuerbiilli᷒.	memor semꝑ uerbi illi᷒ .
quobeatuspetrusĩepl̃asuasalubrit̃nos	quo beatus petrus ĩ epl̃a sua salubrit̃ nos
ãmonensait.Omnemsollicitudinẽur̃amꝓicientes	ãmonens ait . Omnem sollicitudinẽ ur̃am ꝓicientes
ineum.q̃mip̃icuraẽde	ineum . q̃m ip̃i cura ẽ de
uob̃.hecaũsollicitudodiuinecaritatis	uob̃ . hec aũ sollicitudo diuine caritatis
⁊compassiõisergamiserũ.⁊uitioꝝfetentiũsordib᷒obuolutũ	⁊ compassiõis erga miserũ .⁊ uitioꝝ fetentiũ sordib᷒ obuolutũ
:inũbisquep̃misimus	: in ũbis que p̃misimus
euident̃expͥmit᷑.	euident̃ expͥmit᷑ .
ubiscͥptumẽ.fremuitih̃c	ubi scͥptum ẽ . fremuit ih̃c
sp̃u.⁊c̃.Inquib;ũbis	sp̃u .⁊ c̃ . In quib ; ũbis
qͣtuornob̃diligenti᷒attendenda	qͣtuor nob̃ diligenti᷒ attendenda
ꝓponũt᷑.queĩsuscitationelazari.ñsñ	ꝓponũt᷑ . que ĩ suscitatione lazari . ñ sñ
c̃ticausamist̃ii.	c̃ti causamist̃ii .
dñsegisseperhibet᷑.fremuitenimsp̃u.turbauitse	dñs egisse perhibet᷑ . fremuit enim sp̃u . turbauit se
ip̃m.lacͥmat᷒est.⁊clamauit	ip̃m . lacͥmat᷒ est .⁊ clamauit
.Queigiturredẽptornr̃insuscitationelazari	. Que igitur redẽptor nr̃ in suscitatione lazari
corporal̃rexhibuit:h̃iniustificationepecc̃oris.ꝑ	corporal̃r exhibuit : h̃ in iustificatione pecc̃oris . ꝑ
uisitationissuegr̃amcotidiespiritalit̃oꝑariñdesisbit	uisitationis sue gr̃am cotidie spiritalit̃ oꝑari ñ desisbit
.fremitenĩsp̃u.dum	. fremit enĩ sp̃u . dum
pecc̃oremꝑillicitadefluentẽ.det̃ret	pecc̃orem ꝑ illicita defluentẽ . det̃ret
et̃nisuppliciiꝮminatione.quasiturbatũseostenditcumin	et̃ni supplicii Ꝯminatione . quasi turbatũ se ostendit cum in
penitentẽutadlam̃tapenitentie	penitentẽ ut ad lam̃ta penitentie
redeat:temporalicõcutitadũsitate.necesseestenĩuͭ	redeat : temporali cõcutit adũsitate . necesse est enĩ uͭ
qͤmp̃miañĩuitant:saltemt̃roreseternedampnationis	qͤm p̃mia ñ ĩuitant : saltem t̃rores eterne dampnationis
.⁊ang᷒tietemporal̃adũsitatis.apecc̃is	.⁊ ang᷒tie temporal̃ adũsitatis . a pecc̃is
retrahant.lacͥmaturaũdumꝑaffectum	retrahant . lacͥmatur aũ dum ꝑ affectum
pat̃nepietatispenitentemsuscipitadueniam	pat̃ne pietatis penitentem suscipit adueniam
.uoceuͦclamosamortuũresuscitat:dumde	. uoce uͦ clamosa mortuũ resuscitat : dum de
ꝓfundauitioꝝuoraginemiscd̃it̃ereptum.	ꝓfunda uitioꝝ uoragine miscd̃it̃ ereptum .
ꝑuirtutẽuereconfessionis:reuocataduitam.nonnemanifeste	ꝑuirtutẽ uere confessionis : reuocat ad uitam . nonne manifeste
Ꝯtrapecc̃oresfrem̃euidet᷑dñs.uͭait	Ꝯtra pecc̃ores frem̃e uidet᷑ dñs . uͭ ait
.mittent᷑intenebrasext̃iores.ibieritfletus	. mittent᷑ in tenebras ext̃iores . ibi erit fletus
⁊stridor	⁊ stridor
dentiũ:⁊alibi.ꝑ	dentiũ :⁊ alibi . ꝑ
ysaiãꝓph̃amdeelectis	ysaiã ꝓph̃am de electis
loquit᷑dicens.Egredient᷑.⁊uideb̃t	loquit᷑ dicens . Egredient᷑ .⁊ uideb̃t
cadaũauͥoꝝ.qͥp̃uaricatisuntĩme	cadaũa uͥoꝝ . qͥ p̃uaricati sunt ĩme
.ũmiseoꝝñmoriet᷑	. ũmis eoꝝ ñ moriet᷑
.⁊igniᷤñextinguet᷑.⁊	.⁊ igniᷤ ñ extinguet᷑ .⁊
eruntusq;adsacietatẽuisionisom̃icarni.h̃c	erunt usq ; ad sacietatẽ uisionis om̃i carni . h̃c
fremitũpreuideratinsp̃uꝓph̃aabacucc̃dicebat	fremitũ preuiderat in sp̃u ꝓph̃a abacuc c̃ dicebat
.InfremituꝮculcabist̃ram.ĩfuroreobstupefaciesgentes	. In fremitu Ꝯculcabis t̃ram . ĩ furore obstupefacies gentes
.InfremituinqͥtꝮculcab̃t̃ram.i.hõies	. Infremitu inqͥt Ꝯculcab̃ t̃ram . i . hõies
t̃renasapiẽtes.penam⁊̃	t̃rena sapiẽtes . penam ⁊ ̃
deiꝮscius.tuuͦinquitduceseosinputeũ	dei Ꝯscius . tu uͦ inquit duces eos inputeũ
int̃itus.Inquib	int̃itus . In quib
;ũbisbreuit̃notat᷑	; ũbis breuit̃ notat᷑
penarũgehennaliumꝑpetuitas.ac̃bitassimuletuarietas.ꝑ	penarũ gehennalium ꝑpetuitas . ac̃bitas simul et uarietas . ꝑ
puteumenĩde	puteum enĩ de
cui᷒profunditatenonpatetegͤssuspenaꝝ	cui᷒ profunditate non patet egͤssus penaꝝ
ꝑpetuitasexpͥmit᷑.ꝑint̃itum:ac̃bitas	ꝑpetuitas expͥmit᷑ . ꝑ int̃itum : ac̃bitas
eaꝝdemdesignatur.ꝑhoc	eaꝝdem designatur . ꝑ hoc
aũqd̃dc̃mẽ.deduces	aũ qd̃ dc̃m ẽ . deduces
eos:torm̃toꝝ	eos : torm̃toꝝ
uarietasq̃uariis	uarietas q̃ uariis
debet᷑pecc̃oꝝgñib;:Ꝯuenient̃intelligit᷑.uñ	debet᷑ pecc̃oꝝ gñib ;: Ꝯuenient̃ intelligit᷑ . uñ
inlibroiobscͥptumẽ.tͣnsibuntde	in libro iob scͥptum ẽ . tͣnsibunt de
aquisniuiũ	aquis niuiũ
adcalorẽnimiũ.nonsolumaũfremuitih̃ussp̃u	ad calorẽ nimiũ . non solum aũ fremuit ih̃us sp̃u
.s;⁊turbauitseip̃mlacmat᷒est.⁊	. s ;⁊ turbauit se ip̃m lacmat᷒ est .⁊
clamauit.sedquid	clamauit . sed quid
estdñeih̃u.	est dñe ih̃u .
quodturbarisintemetip̃oqͥutscͥptumẽ.	quod turbaris in temet ip̃o qͥ ut scͥptum ẽ .
omniacũtranquillitateiudicas.qͥes	omnia cũ tranquillitate iudicas . qͥ es
paxuera.q̃omnẽsensũ	pax uera . q̃ omnẽ sensũ
exuꝑat.	exuꝑat .
quisemperidemip̃e	qui semper idem ip̃e
es.stabilisq;manẽs.dascuncta	es . stabilisq ; manẽs . das cuncta
moũi.uñtibilacͥme.quepenitentiest̃̄indicia	moũi . uñ tibi lacͥme . que penitentie st̃̄ indicia
.qͥpecc̃mñfecisti	. qͥ pecc̃m ñ fecisti
.necestĩuentusdolusinoretuo.qui	. nec est ĩuentus dolus in ore tuo . qui
pat̃nepietatis	pat̃ne pietatis
habundantia:ꝓĩimicismortem	habundantia : ꝓĩimicis mortem
subireñdubitasti.qui	subire ñ dubitasti . qui
procrucifixorib;cuisutñꝑirentorasti.qui	pro crucifixorib ; cuis ut ñ ꝑirent orasti . qui
deniq;ꝓcõciliandistibipeccatorib	deniq ; ꝓ cõciliandis tibi peccatorib
;tantasustinuisti:s;	; tanta sustinuisti : s ;
attenditefr̃s.	attendite fr̃s .
qꝛñsolum	qꝛ ñ solum
q̃cumq;scͥpta	q̃cumq ; scͥpta
.sed⁊q̃cumq	. sed ⁊ q̃cumq
;fc̃asunt	; fc̃a sunt
.adnr̃amdoctͥnamscͥpta⁊	. ad nr̃am doctͥnam scͥpta ⁊
fc̃asunt	fc̃a sunt
.utquiꝑ	. ut qui ꝑ
adoptionisgr̃ammembraxp̃isumus	adoptionis gr̃am membra xp̃i sumus
.totastudeamus	. tota studeamus
imitarideuotione.quodꝓsalutenr̃agestumeẽꝮstat	imitari deuotione . quod ꝓ salute nr̃a gestum eẽ Ꝯstat
ĩcapite.Quodenĩxp̃cnasci.	ĩ capite . Quod enĩ xp̃c nasci .
cͥcũcidi.crucifigi.moriuoluit:nich̃hoꝝ	cͥcũcidi . crucifigi . mori uoluit : nich̃ hoꝝ
p̃pse.s;om̃ia	p̃p se . s ; om̃ia
p̃pelectossustinuit.neq	p̃p electos sustinuit . neq
;enĩ.ĩpecc̃onatus.neca	; enĩ . ĩ pecc̃onatus . nec a
pecc̃ocͥcũcisus.nͨꝓpecc̃osuo.s;	pecc̃o cͥcũcisus . nͨ ꝓ pecc̃o suo . s ;
p̃pdelicta	p̃p delicta
nr̃amortuusest	nr̃a mortuus est
.pauloapl̃oattestante	. paulo apl̃o attestante
quiait.	qui ait .
xp̃cmortuusẽp̃pdelictanr̃a⁊resurrexitꝓpt̃iusticationẽ	xp̃c mortuus ẽ p̃p delicta nr̃a ⁊ resurrexit ꝓpt̃ iusticationẽ
nr̃am.sic⁊propt̃	nr̃am . sic ⁊ propt̃
nos.ñaũp̃pse.fremuitsp̃u.	nos . ñ aũ p̃p se . fremuit sp̃u .
turbauitseip̃m.lacͥmatusest.⁊clamauit.fremuit	turbauit se ip̃m . lacͥmatus est .⁊ clamauit . fremuit
inqͣmsp̃u.utsalutarẽꝮtrauitiafremitumĩ	inqͣm sp̃u . ut salutarẽ Ꝯtra uitia fremitum ĩ
cordib;nr̃issuscitaret.turbauitsemetip̃m	cordib ; nr̃is suscitaret . turbauit semet ip̃m
:utqͣntumdeꝑpetratismalisturbari.⁊doleredebeamus	: ut qͣntum deꝑpetratis malis turbari .⁊ dolere debeamus
:innotesc̃et.lacͥmatusest.	: in notesc̃et . lacͥmatus est .
utnosꝓuocaretadlacͥmasdeuoteꝮpunctionis.clamauit	ut nos ꝓuocaret ad lacͥmas deuote Ꝯpunctionis . clamauit
aũ:uͭcordeꝮtritosinuitaretadremediũ	aũ : uͭ corde Ꝯtritos inuitaret ad remediũ
salutifereꝮfessionis.tuncenĩxp̃cĩnobis	salutifere Ꝯfessionis . tunc enĩ xp̃c ĩ nobis
clamoreñincongrue	clamore ñ incongrue
dr̃.cumnosutin	dr̃ . cum nos ut in
Ꝯfessionepecc̃oꝝclamem᷒	Ꝯfessione pecc̃oꝝ clamem᷒
.salubrit̃exhortat᷑	. salubrit̃ exhortat᷑
.Illeigiturutil̃rclamat	. Ille igitur util̃r clamat
qͥruptopudoris⁊ũecũdie	qͥ rupto pudoris ⁊ ũecũdie
silentio:pecc̃oꝝsuoꝝuulña.ĩꝮfessione	silentio : pecc̃oꝝ suoꝝ uulña . ĩ Ꝯfessione
detegit⁊manifestat.Ethocestꝙ	de tegit ⁊ manifestat . Et hoc est ꝙ
aitdominus.lazareueniforas	ait dominus . lazare ueni foras
.perlazarumquifetens⁊qͣtriduanusinsepulcrolatuit	. perlazarum qui fetens ⁊ qͣ triduanus in sepulcro latuit
.pecc̃oremquẽlibetñĩmerito	. pecc̃orem quẽlibet ñ ĩ merito
accipim᷒.quip̃ssus	accipim᷒ . qui p̃ssus
molepraueꝮsuetudinis	mole praue Ꝯsuetudinis
.sublatebͥstenebroseꝮscientiese	. sublatebͥs tenebrose Ꝯscientie se
abscondit.Quidumscelerũsuoꝝĩmanitatet̃ritus	abscondit . Qui dum scelerũ suoꝝ ĩmanitate t̃ritus
.ꝮscientiefeditateꝮfusus.ne	. Ꝯscientie feditate Ꝯfusus . ne
uiassuasdominomanifestet	uias suas domino manifestet
.noxiopudoreuincit᷑:	. noxio pudore uincit᷑ :
uelutĩcarcereligatus⁊inclusus.ne	uelut ĩ carcere ligatus ⁊ inclusus . ne
forasprodireualeat	foras prodire ualeat
ꝓhibet᷑	ꝓ hibet᷑
.Dequoin	. De quo in
libroiob.bñ	libro iob . bñ
scͥptumest.si	scͥptum est . si
incluseritdshoĩem:nullusestquiaꝑiat.	incluserit ds hoĩem : nullus est qui aꝑiat .
certepecc̃orquilibetĩeoꝙmaleoꝑat᷑.Ꝯscientie	certe pecc̃or quilibet ĩ eo ꝙ male oꝑat᷑ . Ꝯscientie
suecarcerem	sue carcerem
sibifacit.neeuadendilocũĩueniat	sibi facit . ne euadendi locũ ĩueniat
Includitaũdeus	Includit aũ deus
hominẽ.dũĩclusononaꝑit.ꝑgr̃e	hominẽ . dũ ĩcluso non aꝑit . ꝑ gr̃e
spũalisifusionẽ.utigitursic	spũalis ifusionẽ . ut igitur sic
inclususliberexireualeat.uteducaturuinctusdedomo	inclusus liber exire ualeat . ut educatur uinctus de domo
carceris.sedensintenebris.⁊umbramortis	carceris . sedens in tenebris .⁊ umbra mortis
:necesseẽ	: necesse ẽ
utelauisdauidxp̃cscilicet	ut elauis dauid xp̃c scilicet
.quiclaudit⁊nemoaꝑit.aꝑit⁊nemo	. qui claudit ⁊ nemo aꝑit . aꝑit ⁊ nemo
claudit.solutispecc̃oꝝuinculis.fractisuitioꝝ	claudit . solutis pecc̃oꝝ uinculis . fractis uitioꝝ
seris:liberauoce	seris : libera uoce
clamet⁊dicat.lazareueniforas.porta	clamet ⁊ dicat . lazare ueni foras . porta
aũꝑqͣmreoadituseuadendi	aũ ꝑ qͣm reo aditus euadendi
conceditur.Ꝯfessiopecc̃oꝝest.q̃diuhabitantib	conceditur . Ꝯfessio pecc̃oꝝ est . q̃ diu habitantib
;ĩregioneumbremortis.demũlucem	; ĩ regione umbre mortis . demũ lucem
gr̃esp̃ualis	gr̃e sp̃ualis
infundit.⁊ereptos	infundit .⁊ ereptos
auetustaseruitutepecc̃i:in	a uetusta seruitute pecc̃i : in
lib̃tatemsp̃s.⁊uitenouitatemrestituit.portah̃fratres	lib̃tatem sp̃s .⁊ uite nouitatem restituit . porta h̃ fratres
.portasalutis	. porta salutis
est⁊iusticie.adeo	est ⁊ iusticie . adeo
utquilibetdenaufragio	ut quilibet denaufragio
mundihui᷒euaderecupiens.necessehabeattransire	mundi hui᷒ euadere cupiens . necesse habeat transire
ꝑeam.utcumpsalmistapossitdic̃e	ꝑ eam . ut cum psalmista possit dic̃e
.aꝑitemͥportãiusticie.⁊ĩgressus	. aꝑite mͥ portã iusticie .⁊ ĩgressus
ĩeam.confitebordño	ĩ eam . confitebor dño
.h̃portadñi.	. h̃ porta dñi .
i᷒tiĩtrabuntmeam.necesse	i᷒ti ĩtrabunt meam . necesse
ẽinqͣmutꝑ	ẽ inqͣm ut ꝑ
portamsalutisaddeumredeat	portam salutis ad deum redeat
.quiꝑportasmortisegressus:inregionedissmilitudinis	. qui ꝑ portas mortis egressus : in regione dissmilitudinis
.abeolongius	. ab eo longius
aberraũat.st̃autẽtresportemortis.	ab erraũat . st̃ autẽ tres porte mortis .
ꝑquasfilii	ꝑ quas filii
hui᷒scl̃i	hui᷒ scl̃i
adamorẽmundihui᷒ingrediunt᷑.qͣsstudiisom̃ib;	ad amorẽ mundi hui᷒ ingrediunt᷑ . qͣs studiis om̃ib ;
declinaresataguntqͥdeductiꝑportasiusticie:	declinare satagunt qͥ deducti ꝑ portas iusticie :
adpatͥamclaritatiseterne	ad patͥam claritatis eterne
:celestisgr̃e	: celestis gr̃e
muñeꝑducunt᷑.Etestpͥmaportamortis:carnalis	muñe ꝑducunt᷑ . Et est pͥma porta mortis : carnalis
Ꝯcuꝑiscentiemom̃taneauoluptas.scd̃a:rerumtranseuntiũĩ	Ꝯcuꝑiscentie mom̃tanea uoluptas . scd̃a : rerum transeuntiũ ĩ
mod̃atacupiditas.tercia:gl̃escl̃aris	mod̃ata cupiditas . tercia : gl̃e scl̃aris
uanasublimitas.	uana sublimitas .
hasportasmortisinepistolasuabeatusioh̃es	has portas mortis in epistola sua beatus ioh̃es
euident̃expͥmit.	euident̃ expͥmit .
uͥait.Om̃e	uͥ ait . Om̃e
qd̃ẽinmundoautest	qd̃ ẽ in mundo aut est
Ꝯcupiscẽtiacarnis.	Ꝯcupiscẽtia carnis .
autꝮcupiscentiaoculoꝝ.	aut Ꝯcupiscentia oculoꝝ .
ul̃suꝑbiauite.concupiscentiaenĩcarnis.refert᷑ad	ul̃ suꝑbia uite . concupiscentia enĩ carnis . refert᷑ ad
uoluptatẽ.concupiscentiaocl̃oꝝ:	uoluptatẽ . concupiscentia ocl̃oꝝ :
admundanã	ad mundanã
cupiditatem.suꝑbiauite:adgl̃esecularis.sublimitatẽ	cupiditatem . suꝑbia uite : ad gl̃e secularis . sublimitatẽ
.Etqͥdemꝑportam	. Et qͥdem ꝑ portam
carnalisꝮcupiscentie	carnalis Ꝯcupiscentie
qd̃sinegraui	qd̃ sine graui
meroredicendũñest.ingrediunt᷑innumeri.	merore dicendũ ñ est . ingrediunt᷑ in numeri .
eoqd̃patensintroitus.⁊spatiosauia	eo qd̃ patens introitus .⁊ spatiosa uia
sitq̃ducitadeam.qd̃	sit q̃ ducit ad eam . qd̃
nimiꝝcertissime	nimiꝝ certissime
ꝓbanthii	ꝓbant hii
.quitimoredeipostposito	. qui timore dei post posito
.cubilib;uacant⁊ĩ	. cubilib ; uacant ⁊ ĩ
pudicitiis.⁊carnissuedesideriasequentesul̃	pudicitiis .⁊ carnis sue desideria sequentes ul̃
utium̃ta	ut ium̃ta
cõputruer̃tĩstercorib;suis.quiĩcarneseminant	cõputruer̃t ĩ stercorib ; suis . qui ĩ carne seminant
.⁊decarnemetũtcorruptionẽ.iocisdelectãtur⁊	.⁊ de carne metũt corruptionẽ . iocis delectãtur ⁊
nisib;.⁊ext̃iorinitorecorporis:int̃ioris	nisib ;.⁊ ext̃iori nitore corporis : int̃ioris
hominisdeformantpulcritudinem.	hominis de formant pulcritudinem .
certeqͣmdetestabilissitcarnalisconcupiscentieuoluptas.exeonimirũ	certe qͣm detestabilis sit carnalis concupiscentie uoluptas . exeo nimirũ
colligitur.	colligitur .
ꝙappetitusei᷒:	ꝙ appetitus ei᷒ :
anxietatis⁊uecordie.actus:Ꝯfusioniᷤ	anxietatis ⁊ uecordie . actus : Ꝯfusioniᷤ
⁊ignominie.exitus:penitudinis⁊uerecundieplenuseẽ	⁊ ignominie . exitus : penitudinis ⁊ uerecundie plenus eẽ
dinoscit᷑.undescl̃arisillefertur	dinoscit᷑ . unde scl̃aris ille fertur
dixissephilosoph᷒uilisresluxuria.deuiliũ	dixisse philosoph᷒ uilis res luxuria . de uiliũ
membroꝝ.descendẽsoꝑatione.cuiusnecesseẽ	membroꝝ . descendẽs oꝑatione . cuius necesse ẽ
utinfinepeniteas.	ut in fine peniteas .
porroꝑportam	porro ꝑ portam
mundanecupiditatisingrediunt᷑.hiiquilucrisinhiantes	mundane cupiditatis ingrediunt᷑ . hii qui lucris in hiantes
illicitis.q̃stumpietatẽexistimant.inquib	illi citis . q̃stum pietatẽ existimant . inquib
;amordiuitiarũ	; amor diuitiarũ
insaciabilis.aĩammiseramdesid̃iocruciat	insaciabilis . aĩam miseram desid̃io cruciat
.s;usunequaqͣmrefrig̃at.	. s ; usu nequaqͣm refrig̃at .
ꝙenimcũlabore	ꝙ enim cũ labore
adquiritur.cum	adquiritur . cum
timorepossidet᷑.⁊ꝙhiislonge	timore possidet᷑ .⁊ ꝙ hiis longe
infelicius:tandẽ	in felicius : tandẽ
cumdoloremiserabilit̃᷑amittit᷑.uñ	cum dolore miserabilit̃᷑ amittit᷑ . uñ
qͥdamspũd̃i	qͥdam spũ d̃i
plenus.deamatorib;h᷒mundi.satiselegant̃	plenus . de amatorib ; h᷒ mundi . satis elegant̃
ait.Querũt	ait . Querũt
utadqͥrant.	ut ad qͥrant .
adqͥrunt.	ad qͥrunt .
utꝑdant.	ut ꝑdant .
ꝑdũtutdoleant.Etpaulusapl̃s.	ꝑdũt ut doleant . Et paulus apl̃s .
Quiuolũt	Qui uolũt
ĩquitdiuitesfieri.incidũtĩtẽptationes	ĩquit diuites fieri . incidũt ĩ tẽptationes
.⁊inlaq̃umdiaboli.⁊indessd̃iaml̃tainutilia	.⁊ in laq̃um diaboli .⁊ in dessd̃ia ml̃ta inutilia
⁊nociua.	⁊ nociua .
q̃mergũt	q̃ mergũt
hoĩemĩint̃itum⁊ꝑditionẽ.suꝑquẽ	hoĩem ĩ int̃itum ⁊ ꝑditionẽ . suꝑ quẽ
locumsicaitexpositor.nichiltamasꝑũ.nich̃	locum sic ait expositor . nichil tam asꝑũ . nich̃
tamꝑnitiosũ.	tam ꝑnitiosũ .
quamsiuireccl̃iasticus.maximesublimẽtenenslocũ	quam si uir eccl̃iasticus . maxime sublimẽ tenens locũ
.diuitiishui᷒seculistudeat.	. diuitiis hui᷒ seculi studeat .
tal̃enĩñsolũ	tal̃ enĩ ñ solũ
se.s;⁊cet̃os:ꝑ	se . s ;⁊ cet̃os : ꝑ
formãꝮtͣriam	formã Ꝯtͣriam
ꝑicl̃osubicit.⁊ĩruinamp̃cipitat	ꝑicl̃o subicit .⁊ ĩ ruinam p̃cipitat
ẽsublimitasgl̃escl̃aris.que	ẽ sublimitas gl̃e scl̃aris . que
reueraꝮiunctaẽ	reuera Ꝯiuncta ẽ
porte.qͣmdescͥpsim᷒noĩemũdanecupiditatis	porte . qͣm descͥpsim᷒ noĩe mũdane cupiditatis
.fitenĩplerũq	. fit enĩ plerũq
;.utꝑhabundantiã	;. ut ꝑhabundantiã
diuitiarũ.pateatascensusadculmen	diuitiarũ . pateat ascensus ad culmen
scl̃ariumdignitatũ.	scl̃arium dignitatũ .
uñpaulusĩpotentib;h᷒	uñ paulus ĩ potentib ; h᷒
mundimorbumdiuitiarũ.i.suꝑbiã	mundi morbum diuitiarũ . i . suꝑbiã
uolensrepͥmere:thimotheo	uolens repͥmere : thimotheo
scͥbensait.	scͥbens ait .
p̃cipediuitib;h᷒scl̃i.ñ	p̃cipe diuitib ; h᷒ scl̃i . ñ
sublimesaꝑe.neq;	sublime saꝑe . neq ;
sperareĩ	sperare ĩ
incertodiuitiarũ.	incerto diuitiarũ .
s;indeouiuo.qͥ	s ; in deo uiuo . qͥ
dat.nob̃habundant̃	dat . nob̃ habundant̃
om̃iaadfruendũ.Inhacportasedemsibistatuer̃t.qui	om̃ia adfruendũ . Inhac porta sedem sibi statuer̃t . qui
dignitateseccl̃iasticaslicetindignicecanimisambitione.ĩpudent̃usurpãt⁊	dignitates eccl̃iasticas licet indigni cecanimis ambitione . ĩpudent̃ usurpãt ⁊
rapiũt.deqͥb;dñsꝑysaiamꝓph̃amꝮq̃ritur	rapiũt . de qͥb ; dñs ꝑ ysaiam ꝓph̃am Ꝯq̃ritur
dicens.Ip̃i	dicens . Ip̃i
regnauert̃.⁊ñexme.pͥncipesexcitert̃.⁊	regnauert̃ .⁊ ñ ex me . pͥncipes excitert̃ .⁊
ñcognoui.	ñ cognoui .
talesenimpreeẽnesciunt.subeẽnonsustinẽt	tales enim pre eẽ nesciunt . sub eẽ non sustinẽt
.⁊ꝓdesseñsatagunt.elongari	.⁊ ꝓdesse ñ satagunt . elongari
quadic̃.	qua dic̃ .
Quimaiorẽur̃m.eritminist̃uest̃	Qui maior ẽ ur̃m . erit minist̃ uest̃
.ubiplaneminist̃iũsubiectionisdominusĩdicit	. ubi plane minist̃iũ subiectionis dominus ĩdicit
.s;ambitionẽdñationispenitusint̃dicit	. s ; ambitionẽ dñationis penitus int̃dicit
.⁊qd̃ũbop̃cipit:	.⁊ qd̃ ũbo p̃cipit :
exemploroborat.Egoinqͥtĩmediour̃msum	exemplo roborat . Ego inqͥt ĩ medio ur̃m sum
.tãqͣmqͥministrat.Quiautem	. tãqͣm qͥ ministrat . Qui autem
mundihui᷒uenant᷑gl̃am.ĩfauorispopl̃arisaura	mundi hui᷒ uenant᷑ gl̃am . ĩ fauoris popl̃aris aura
sectandadelectantur.insplendoreuestiũ.ĩ	sectanda delectantur . in splendore uestiũ . ĩ
ciboꝝgl̃ant᷑	ciboꝝ gl̃ant᷑
uoluptate.amantpͥmosrecubitusincenis	uoluptate . amant pͥmos recubitus in cenis
.⁊pͥmascathedrasĩsynagogis.salutationesĩforo	.⁊ pͥmas cathedras ĩ synagogis . salutationes ĩ foro
.⁊uocariabhoĩb;rabicũtam̃dñsĩ	.⁊ uocari ab hoĩb ; rabi cũ tam̃ dñs ĩ
euangl̃iodicat.neuoceminimagistͥ	euangl̃io dicat . neuocemini magistͥ
.qꝛmagist̃uesterunusẽxp̃c.hee	. qꝛ magist̃ uester unus ẽ xp̃c . hee
st̃portemortisquasenum̃auim᷒	st̃ porte mortis quas enum̃auim᷒
.porteinferi.ꝑquasfiliihus᷒seculi	. porte inferi . ꝑ quas filii hus᷒ seculi
gradientes.ruuntinp̃cipiciũ.quib	gradientes . ruunt in p̃cipiciũ . quib
;portesalutisopponũt᷑.	; porte salutis opponũt᷑ .
ꝑquasnecesse	ꝑ quas necesse
estutintroeat.quiĩoffensopede	est ut introeat . qui ĩ offenso pede
tend̃eꝮtenditaddm̃.Et	tend̃e Ꝯtendit ad dm̃ . Et
estpͥmaportasalutis	est pͥma porta salutis
.deuotacordiscompũctio.	. deuota cordis compũctio .
scd̃a:uera⁊humilisorisconfessio.	scd̃a : uera ⁊ humilis oris confessio .
tercia:Ꝯdignaoꝑissatisfactio	tercia : Ꝯdigna oꝑis satisfactio
.Dehiis	. De hiis
portispsalmistaait.Introiteportasei᷒ĩconfessione.	portis psalmista ait . Introite portas ei᷒ ĩ confessione .
atͥaei᷒inhymnisꝮfiteminiilli.hee	atͥa ei᷒ in hymnis Ꝯfitemini illi . hee
st̃porteparadisi.dequib	st̃ porte paradisi . de quib
;hiisdieb;canim᷒.paradisiportasaꝑuit	; hiis dieb ; canim᷒ . paradisi portas aꝑuit
nob̃ieiuniitemp᷒.hasportaspetrus	nob̃ ieiunii temp᷒ . has portas petrus
ĩtroierat.dũpostĩmanitatẽ	ĩtroierat . dũ post ĩmanitatẽ
culpe.misericordit̃respectusẽa	culpe . misericordit̃ respectus ẽ a
dño.⁊egressusforas.fleuitamare	dño .⁊ egressus foras . fleuit amare
.Inegressu	. In egressu
enĩnotaturconfessio.ĩfletuamaro:	enĩ notatur confessio . ĩ fletu amaro :
cordiscõpunctio.qd̃aũĩeosecutasitꝮdigna	cordis cõpunctio . qd̃ aũ ĩeo secuta sit Ꝯdigna
satisfactiooꝑis:	satisfactio oꝑis :
exeonimirũcolligitur.quodpost	ex eo nimirũ colligitur . quod post
tamgrauis	tam grauis
lapsusp̃cipiciũ:adtanterediiteminentiam	lapsus p̃cipiciũ : ad tante rediit eminentiam
sc̃itatis.pulsemusdilectissimifr̃esadportasistas	sc̃itatis . pulsemus dilectissimi fr̃es ad portas istas
.⁊aꝑient᷑nob̃.aꝑtaestnob̃siuolumusuia	.⁊ aꝑient᷑ nob̃ . aꝑta est nob̃ si uolumus uia
penitentie.qꝛsicutaitbeatusbeatusioh̃esapl̃s.	penitentie . qꝛ sicut ait beatus beatus ioh̃es apl̃s .
siꝮfiteam᷑pecc̃anr̃a.fidelis⁊iustus	si Ꝯfiteam᷑ pecc̃a nr̃a . fidelis ⁊ iustus
ẽdominus	ẽ dominus
.utremittatnob̃pecc̃anr̃a.⁊emundetnosab	. ut remittat nob̃ pecc̃a nr̃a .⁊ emundet nos ab
om̃iĩiquitate.Itaq;fratresdirigam᷒	om̃i ĩiquitate . Itaq ; fratres dirigam᷒
oꝑanr̃aad	oꝑa nr̃a ad
exemplar.ꝙ	exemplar . ꝙ
nob̃ĩmontemonstratũẽ	nob̃ ĩ monte monstratũ ẽ
.uͭuidl̃cunusqͥsq;	. uͭ uidl̃c unusqͥsq ;
nr̃mfrematspũ.turbetse	nr̃m fremat spũ . turbet se
ipsum.lacrimet᷑.⁊clamet.frematĩꝗͣ	ipsum . lacrimet᷑ .⁊ clamet . fremat ĩ ꝗͣ
inse.fremat	in se . fremat
⁊Ꝯtrase	⁊ Ꝯtra se
.Insequidẽ:perint̃ioremcordisamaritudinẽ.	. In se quidẽ : per int̃iorem cordis amaritudinẽ .
Ꝯtrase.ꝑext̃iorem	Ꝯtra se . ꝑ ext̃iorem
corꝑisaffuctionẽ.utdicerepossitcũpsalmista.afflictus	corꝑis affuctionẽ . ut dicere possit cũ psalmista . afflictus
sum&humiliatus	sum & humiliatus
sũnimis.rugiebãagemitu	sũ nimis . rugiebã a gemitu
cordismei	cordis mei
.turbetetiamseipsumꝑdolorẽ	. turbet etiam se ipsum ꝑ dolorẽ
.lacͥmeturꝑpietatẽ.clametꝑor̃onem	. lacͥmetur ꝑ pietatẽ . clamet ꝑ or̃onem
.Exaudistiinquituocedep̃cationismee.	. Exaudisti inquit uoce dep̃cationis mee .
dũclamarẽadte	dũ clamarẽ ad te
.clamet.aũ.⁊dicatanimesue	. clamet . aũ .⁊ dicat anime sue
.lazareueniforas.lazarus	. lazare ueni foras . lazarus
int̃pretat᷑adiutus	int̃pretat᷑ adiutus
.ꝑlazarumgͥquelibetfidelis	. ꝑ lazarum gͥ quelibet fidelis
animaꝮuenient̃	anima Ꝯuenient̃
accipit᷑.q̃potissimũilliusindigetadiutorio:	accipit᷑ . q̃ potissimũ illius indiget adiutorio :
quideseip̃o	qui de se ip̃o
dic̃sinemenich̃	dic̃ sine me nich̃
potestisfac̃e.Etdequopsalmistaait:adiutor	potestis fac̃e . Et de quo psalmista ait : adiutor
ĩoportimitatib;	ĩ oportimitatib ;
intribulatione.sperent	in tribulatione . sperent
inteqͥnouerunt	in te qͥ nouerunt
te.Quamfidelis	te . Quam fidelis
qͣmnecessari᷒sitad	qͣm necessari᷒ sit ad
iutoriste	iutor iste
.manifestedeclarat	. manifeste declarat
eccl̃ia.	eccl̃ia .
q̃ꝑsingulas	q̃ ꝑsingulas
horasdeuotisip̃mp̃cib;ĩuocans.d̃s	horas deuotis ip̃m p̃cib ; ĩuocans . d̃s
inqͥtĩadiutoriũmeũĩtende.dñeadadiuuand̃	inqͥt ĩ adiutoriũ meũ ĩtende . dñe ad adiuuand̃
mefestina.hecigit᷑fidelisaĩa.	me festina . hec igit᷑ fidelis aĩa .
qͥꝑlatarũsignificataest.uocante	qͥ ꝑlatarũ significata est . uocante
dño.forasuenit.dum	dño . foras uenit . dum
a.mortepecc̃iresuscitata.inlucebonoꝝ	a . morte pecc̃i resuscitata . in luce bonoꝝ
oꝑmambulat.⁊cooꝑante	oꝑm ambulat .⁊ cooꝑante
gr̃adeuirtuteĩ	gr̃a de uirtute ĩ
uirtutẽꝓficit.Queetiãadtantamregis	uirtutẽ ꝓficit . Que etiã ad tantam regis
et̃nifamiliriatẽdignanteradmitit᷑.utĩꝮuiuioei᷒	et̃ni familiriatẽ dignanter admitit᷑ . ut ĩꝮuiuio ei᷒
plenodeliciisom̃ib;.recumberedignareꝑiat᷑	pleno deliciis om̃ib ;. recumbere digna reꝑiat᷑
.sicenimscͥptumestĩioh̃iseuangl̃io.ante	. sic enim scͥptum est ĩ ioh̃is euangl̃io . ante
qͥnq;dies	qͥnq ; dies
pasche.uenitih̃cbethaniã.ubilazarus	pasche . uenit ih̃c bethaniã . ubi lazarus
fũatmortuus.feceruntaũeicenamibi	fũat mortuus . fecerunt aũ ei cenam ibi
.lazarusuͦunuserat	. lazarus uͦ unus erat
exdiscumbentib;c̃eo.hanccenãfr̃es	ex discumbentib ; c̃ eo . hanc cenã fr̃es
et̃namsacietatediuineuisionisaccipimus.dequacenaĩ	et̃nam sacietate diuine uisionis accipimus . de qua cena ĩ
apocalipsiscͥptũẽ.Beati	apocalipsi scͥptũ ẽ . Beati
quiadcenamnuptiaꝝagni	qui ad cenam nuptiaꝝ agni
uocatist̃.sponsusetiamĩ	uocati st̃ . sponsus etiam ĩ
canticis:hui᷒ceneconuiuas	canticis : hui᷒ cene conuiuas
alloquẽs:⁊adepulandũgratulant̃	alloquẽs :⁊ ad epulandũ gratulant̃
inuitans:aitcomediteamici.⁊bibite.⁊ĩebͥamini	inuitans : ait comedite amici .⁊ bibite .⁊ ĩebͥamini
km̃i.Inquib;ũbis	km̃i . In quib ; ũbis
notand̃est.qꝛ	notand̃ est . qꝛ
quicomeduntamici.quiuͦbibunt	qui comedunt amici . qui uͦ bibunt
⁊inebriabunt᷑:ꝑhibent᷑eẽ	⁊ inebriabunt᷑ : ꝑhibent᷑ eẽ
km̃i.sc̃ienĩin	km̃i . sc̃i enĩ in
p̃sentiuitacomedunt.dumsuperne	p̃senti uita comedunt . dum superne
Ꝯtemplationisdulcedinẽ	Ꝯtemplationis dulcedinẽ
pregustantes:suauiuirtutũdelectationesereficiunt.Inet̃na	pregustantes : suaui uirtutũ delectatione se reficiunt . In et̃na
aũbeatitudinebibt̃⁊ĩebͥant᷑.dumtranslatiingl̃am	aũ beatitudine bibt̃ ⁊ ĩebͥant᷑ . dum translati in gl̃am
:perfectadiuinecognitionis	: perfecta diuine cognitionis
plenitudine.⁊int̃niamoris	plenitudine .⁊ int̃ni amoris
iocunditateꝑfruunt᷑.Dehiisinpsalmoscͥptum	iocunditate ꝑfruunt᷑ . De hiis in psalmo scͥptum
est.Inebͥabũt᷑	est . Inebͥabũt᷑
abubertatedomus	ab ubertate domus
tue.⁊torrenteuoluptatistuepotabiseos.hui᷒	tue .⁊ torrente uoluptatis tue potabis eos . hui᷒
torrentiᷤuoluptate.nosinet̃noꝮuiuio.	torrentiᷤ uoluptate . nos in et̃no Ꝯuiuio .
nonsolumpotare.s;⁊ĩebriaredignetursponsus	non solum potare . s ;⁊ ĩebriare dignetur sponsus
eccl̃iedñsnr̃ih̃cxp̃c.	eccl̃ie dñs nr̃ ih̃c xp̃c .
utabfortamorteĩuictoriam.	ut abforta morte ĩ uictoriam .
ineoquiuitanr̃aest.	in eo qui uita nr̃a est .
sinefinefeliciteruiũemeream᷑	sine fine feliciter uiũe meream᷑
.prestanteeodem	. prestante eodem
dñonr̃oih̃uxp̃o.cui᷒	dño nr̃o ih̃u xp̃o . cui᷒
regnum⁊ĩꝑiumꝑmanetinseculascl̃orum.amen	regnum ⁊ ĩꝑium ꝑmanet in secula scl̃orum . amen
sermoĩquadͣgesimaQui	sermo ĩquadͣgesima Qui
xp̃isunt:	xp̃i sunt :
carnẽsuãcrucifixert̃cum	carnẽ suã crucifixert̃ cum
uitiis⁊Ꝯcupiscentiis.si	uitiis ⁊ Ꝯcupiscentiis . si
ml̃tiplicesuitep̃sentismiserias.qͥb;miser	ml̃ tiplices uite p̃sentis miserias . qͥb ; miser
homoculpisexigentib;ĩcessant̃affligit᷑.	homo culpis exigentib ; ĩcessant̃ affligit᷑ .
diligenti᷒attendam᷒.	diligenti᷒ attendam᷒ .
incolat᷒nr̃iprolongationẽ	incolat᷒ nr̃i prolongationẽ
.cumpsalmistañĩm̃itodeflerepossumus.licet	. cum psalmista ñ ĩ m̃ito deflere possumus . licet
enimtesteꝓph̃abreues	enim teste ꝓph̃a breues
sic̃dieshõis	sic̃ dies hõis
.ĩhoctñeoꝝlongitudoñinꝮuenient̃atteudit᷑	. ĩ hoc tñ eoꝝ longitudo ñ inꝮuenient̃ atteudit᷑
:eoqd̃multͥisrepleant᷑miseriis.siqͥdemculpam	: eo qd̃ multͥis repleant᷑ miseriis . siqͥdem culpam
secumtrahit.	secum trahit .
uni᷒cui᷒q;	uni᷒ cui᷒q ;
Ꝯceptio.penã:natiuitas.uita:	Ꝯceptio . penã : natiuitas . uita :
labores⁊	labores ⁊
erũpnasfinis	erũpnas finis
uͦ:dolores	uͦ : dolores
⁊miserias.Estenĩsic̃luceclarius	⁊ miserias . Est enĩ sic̃ luce clarius
Ꝯstat.culpabil̃humane	Ꝯstat . culpabil̃ humane
Ꝯditionisingressus.penalishumaneꝮũsationisprogressus.miserabilis	Ꝯditionis ingressus . penalis humane Ꝯũsationis progressus . miserabilis
uͦhumane	uͦ humane
resolutionisegressus.hancmortal̃	resolutionis egressus . hanc mortal̃
uitemiseriã.beatusiob	uite miseriã . beatus iob
int̃iorim̃tisocl̃osubtiliusintuens:plangitdicens	int̃iori m̃tis ocl̃o subtilius intuens : plangit dicens
.Quareñĩuuluamortuussum.egressusexutero	. Quare ñ ĩ uulua mortuus sum . egressus exutero
ñstatĩꝑii:curexceptusgenibus	ñ statĩ ꝑii : cur exceptus genibus
:curlactatusub̃ib	: cur lactatus ub̃ib
;:pereatdies	;: pereat dies
ĩqͣnat᷒sum	ĩ qͣ nat᷒ sum
.⁊noxinquadictum	.⁊ nox in qua dictum
ẽ.conceptusesthomo.	ẽ . conceptus est homo .
hinc⁊salomon	hinc ⁊ salomon
ait.cunctidieshominis	ait . cuncti dies hominis
laborib;⁊	laborib ;⁊
erumpnisplenist̃.	erumpnis pleni st̃ .
necꝑnoctem	nec ꝑ noctem
menterequiescit.Etineccl̃iasticoscͥptumest.Occupatio	mente requiescit . Et in eccl̃iastico scͥptum est . Occupatio
magnacreataestom̃ib	magna creata est om̃ib
;hominib;.⁊	; hominib ;.⁊
iugumgrauesuꝑ	iugum graue suꝑ
filiosadam.adieexitusdeuentrematriseoꝝ	filios adam . a die exitus de uentre matris eoꝝ
.usq;in	. usq ; in
diemsepultureinmatrẽom̃ium.Intͥb;	diem sepulture in matrẽ om̃ium . In tͥb ;
aũstatushumanimiseriap̃cipueuidet᷑Ꝯsistere.uidelicet	aũ status humani miseria p̃cipue uidet᷑ Ꝯsistere . uidelicet
.ignorantia.Ꝯcupiscentia.⁊inpotentia	. ignorantia . Ꝯcupiscentia .⁊ inpotentia
.Ignorantiaĩquãboni.	. Ignorantia ĩquã boni .
Ꝯcupiscentiamali.⁊ĩ	Ꝯcupiscentia mali .⁊ ĩ
potentiapecc̃oresistendi.suntpleriq;quiscl̃arib;	potentia pecc̃o resistendi . sunt pleriq ; qui scl̃arib ;
affectidesideriis.ñsolũbona	affecti desideriis . ñ solũ bona
q̃intelligt̃.ineffectuꝓsequidedignant᷑.uerumetiam	q̃ intelligt̃ . in effectu ꝓsequi dedignant᷑ . uerum etiam
supinaquadam⁊uelutaffectatam̃tis	supina quadam ⁊ uelut affectata m̃tis
ignorantia.penitusexcecati:noluntintelligereutbñ	ignorantia . penitus excecati : nolunt intelligere ut bñ
operent᷑.Dequib;inps̃oscͥptumẽ	operent᷑ . De quib ; in ps̃o scͥptum ẽ
.nesciert̃neq;intellexert̃.in	. ne sciert̃ neq ; intellexert̃ . in
tenebrisambulant.Etalibi.Obscurent᷑ocl̃ieoꝝne	tenebris ambulant . Et alibi . Obscurent᷑ ocl̃i eoꝝ ne
uideant.⁊dorsumeoꝝsemꝑĩcurua.Iustũ	uideant .⁊ dorsum eoꝝ semꝑ ĩ curua . Iustũ
quippeẽutquoꝝm̃tes.queꝑoculosrecte	quippe ẽ ut quoꝝ m̃tes . que ꝑ oculos recte
sig̃catesunt:ignorantie	sig̃cate sunt : ignorantie
tenebrisobscurant᷑.eoꝝdorsumadportandapecc̃oꝝonera:ꝑ	tenebris obscurant᷑ . eoꝝ dorsum adportanda pecc̃oꝝ onera : ꝑ
consensuminiquitatisincuruet᷑.porroꝮcupiscẽtia	consensum iniquitatis incuruet᷑ . porro Ꝯcupiscẽtia
mali.statushumanimiseriammiserabilit̃accumulat	mali . status humani miseriam miserabilit̃ accumulat
.patetenĩ.	. patet enĩ .
quiapronist̃	quia proni st̃
admalũsensushominis.ꝓcliuis	ad malũ sensus hominis . ꝓcliuis
estinuitiũcorruptam̃tisaffectio.	est in uitiũ corrupta m̃tis affectio .
q̃extirpatauitemundicia	q̃ extirpata uite mundicia
.miserãaĩamcarnalib;illecebrisillaquͤando	. miserã aĩam carnalib ; illecebris illa quͤando
coĩqͥnat.⁊qͣmceloredd̃edebueratꝑ	coĩqͥnat .⁊ qͣm celo redd̃e debuerat ꝑ
innocẽtiã⁊uite	innocẽtiã ⁊ uite
puritatẽ.incestant̃gehẽnep̃parat:ꝑmultimodãuitioꝝ	puritatẽ . incestant̃ gehẽne p̃parat : ꝑ multimodã uitioꝝ
corruptionẽ.Inpotentia	corruptionẽ . In potentia
uͦresistendipecc̃o:ad	uͦ resistendi pecc̃o : ad
plenammiserieꝮsũmationẽ:peccatisexigentib	plenam miserie Ꝯsũmationẽ : peccatis ex igentib
;inflictaesthomini.	; inflicta est homini .
roborespirital̃gr̃e	robore spirital̃ gr̃e
destituto.Quidenim	destituto . Quid enim
miserabiliusquamsicuulñari.utultͣñsitsanitas	miserabilius quam sic uulñari . ut ultͣ ñ sit sanitas
.sicincidereinlaqueum.utlib̃atõniloc᷒	. sic incidere in laqueum . ut lib̃atõni loc᷒
iamñpateat.sicp̃cipiciumincurrere:utadicere	iam ñ pateat . sic p̃cipicium incurrere : ut adicere
ñpossitꝑsemiser	ñ possit ꝑ se miser
homodeinceps.utresurgat:Ethocqͥdemmanifestum	homo deinceps . ut resurgat : Et hoc qͥdem manifestum
ẽiustod̃iiudiciofieri.utquemadmodũtestat᷑	ẽ iusto d̃i iudicio fieri . ut quem admodũ testat᷑
apl̃c.qͥ	apl̃c . qͥ
facitpecc̃m	facit pecc̃m
:seruussitpecc̃i.necapeccato	: seruus sit pecc̃i . nec a peccato
secontinerepropriauirtuteualeatetiãcumuoluerit:qui	se continere propria uirtute ualeat etiã cum uoluerit : qui
uiciiscarnalib;inherendo:donumꝮtinentiegratisoblatũ	uiciis carnalib ; in herendo : donum Ꝯtinentie gratis oblatũ
:ul̃utingratus	: ul̃ ut ingratus
abiecit.	abiecit .
uerũqd̃humanefragilitatisoptiñeñualetĩpotentia.salubrit̃	uerũ qd̃ humane fragilitatis optiñe ñ ualet ĩpotentia . salubrit̃
ꝓuid̃ecurauit.sñqua	ꝓuid̃e curauit . sñ qua
uirtusomnisinfirmaẽ	uirtus omnis infirma ẽ
:adiutͥxgr̃a.tripliciigit᷑miserie.	: adiutͥx gr̃a . triplici igit᷑ miserie .
triplexmiscd̃ieremedium.mediatͥxistacelestisopposuit.	triplex miscd̃ie remedium . mediatͥx ista celestis opposuit .
uidelicet.ignorantieboni	uidelicet . ignorantie boni
.intellectũũitatis	. intellectũ ũitatis
.concupiscentiemali:amoremuirtutis.	. concupiscentie mali : amorem uirtutis .
ĩpotentieuͦpecc̃o	ĩ potentie uͦ pecc̃o
resistendi:uirtutẽdiuineprotectionis.necc̃menimfuitut	resistendi : uirtutẽ diuine protectionis . necc̃m enim fuit ut
lumenũitatis:ignorantie	lumen ũitatis : ignorantie
tenebraseffugaret.affectusuirtutis:impetus	tenebras effugaret . affectus uirtutis : impetus
carnalisꝮcupiscentierepͥmeret.ĩpotentiãuͦresistendi	carnalis Ꝯcupiscentie repͥmeret . ĩ potentiã uͦ resistendi
pecc̃o:potentia	pecc̃o : potentia
diuineꝓtectionisroboraret.hocestquoda	diuine ꝓtectionis roboraret . hoc est quod a
sp̃usc̃o	sp̃u sc̃o
qui.cordafideliũ	qui . corda fideliũ
suadocetillustratione:⁊	sua docet illustratione :⁊
ĩomnẽueritateminducit:in	ĩ omnẽ ueritatem inducit : in
orationepetimus.dicentes:accendelum̃sensib;	oratione petimus . dicentes : accende lum̃ sensib ;
ĩfundeamoremcordib;.	ĩ funde amorem cordib ;.
ĩfirmanr̃icorporis:uirtutefirmansperpetĩ.recogita	ĩ firma nr̃i corporis : uirtute firmans perpetĩ . recogita
gͥmiserhomoĩ	gͥ miser homo ĩ
amaritudinecordis	amaritudine cordis
:ĩcolatustuimiseriam	: ĩcolatus tui miseriam
.⁊qꝛmiserenditemp᷒aduenit:diuinãdeuotusinplora	.⁊ qꝛ miserendi temp᷒ aduenit : diuinã deuotus inplora
mĩam.carnẽtuamcrebramaceratione	mĩam . carnẽ tuam crebra maceratione
castigans:sp̃uisubice.⁊necõcupiscentie	castigans : sp̃ui subice .⁊ ne cõcupiscentie
eiusintedñent᷑.	eius in te dñent᷑ .
p̃timore	p̃ timore
districtiiudicii.clauiseã	districti iudicii . clauis eã
penitentieꝮfige.Ip̃aest	penitentie Ꝯfige . Ip̃a est
enimq̃adũsussp̃mcõcupiscit	enim q̃ adũsus sp̃m cõcupiscit
.ip̃arationinonobtemꝑans	. ip̃a rationi non obtemꝑans
.s;sensualitaticonsentiens	. s ; sensualitati consentiens
:ĩcescant̃	: ĩ cescant̃
illicitasuggerit	illicita suggerit
.castigainqͣmcarnẽtuã.⁊concupiscentiaseius	. castiga inqͣm carnẽ tuã .⁊ concupiscentias eius
intemortifica.	in te mortifica .
Qͥenimxp̃ist̃:carnemsuã	Qͥ enim xp̃i st̃ : carnem suã
crucifixeruntcumuitiis⁊Ꝯcupiscentiis	crucifixerunt cum uitiis ⁊ Ꝯcupiscentiis
.triplicẽsicutlegitur	. triplicẽ sicut legitur
ineuͣngl̃io:crucemlegim᷒	in euͣngl̃io : crucem legim᷒
.uidelicet	. uidelicet
.crucem	. crucem
xp̃i.crucẽ	xp̃i . crucẽ
latronispenitentis.&crucem	latronis penitentis .& crucem
latronisinsultantis.certecrux	latronis insultantis . certe crux
xp̃i.cruxĩnocentis	xp̃i . crux ĩnocentis
est.cruxlatronispenitentis.uoluntaria	est . crux latronis penitentis . uoluntaria
ẽafflictiopecc̃oris.ĩmanitatẽscelerumuehem̃tisp̃c	ẽ afflictio pecc̃oris . ĩmanitatẽ scelerum uehem̃ti sp̃c
contͥtionedeflentis.	contͥtione deflentis .
cruxlatronisĩsultantis:penaꝑhennisestscelerati	crux latronis ĩ sultantis : pena ꝑhennis est scelerati
.inpeccandidesideriofinalit̃ꝑseũantis	. in peccandi desiderio finalit̃ ꝑseũantis
.suntñnulliqͥuitia	. sunt ñ nulli qͥ uitia
penitusdetestãtes.sũmam	penitus detestãtes . sũmam
sectandisuirtutib;ĩpenduntoꝑam.uisibiliadespiciunt.	sectandis uirtutib ; ĩ pendunt oꝑam . uisibilia despiciunt .
inuisibilib;	inuisibilib ;
totamentisdeuotione	tota mentis deuotione
iugiterintendunt.	iugiter intendunt .
nullamordacis	nulla mordacis
cõscientiememoriacompungũt᷑.⁊tñ	cõscientie memoria compungũt᷑ .⁊ tñ
tantaafflictionepenitentieseatterunt.	tanta afflictione penitentie se atterunt .
acsipeccĩs	ac si peccĩs
angustent᷑.Etutexpressiusloquarꝙsencio	angustent᷑ . Et ut ex pressius loquar ꝙ sencio
.freq̃ntiusaccidit.⁊familiarib;int̃	. freq̃ntius accidit .⁊ familiarib ; int̃
nosexemplissepi᷒	nos exemplis sepi᷒
exꝑimur.	exꝑimur .
uthiiquiꝑfectiorisin	ut hii qui ꝑfectioris in
nocentiep̃rogatuua:inexorabilescorpoꝝsuorumꝑsecutores	nocentie p̃rogatuua : in exorabiles corpoꝝ suorum ꝑsecutores
effecti:subarciori	effecti : sub arciori
seuiteregl̃arisaust̃itatecoartent.	se uite regl̃aris aust̃itate coartent .
uidereseosiugiliis.	uideres eos iugiliis .
ieiuniis.⁊or̃onib;.tãtasp̃c	ieiuniis .⁊ or̃onib ;. tãta sp̃c
alacͥtateꝑseũant̃insist̃e.utterminospossibilitatẽq;naturetranscendere	alacͥtate ꝑseũant̃ insist̃e . ut terminos possibilitatẽq ; nature transcendere
uideant᷑.	uideant᷑ .
illatisdelectariꝮtumeliis.temꝑalib	illatis delectari Ꝯtumeliis . temꝑalib
;angustiisdilatari.nonenĩignorant	; angustiis dilatari . non enĩ ignorant
qꝛartaest	qꝛ arta est
uiaqueducit	uia que ducit
aduitam.⁊quiꝑfc̃ouestigiocrucifixũuolũint	ad uitam .⁊ qui ꝑfc̃o uestigio crucifixũ uolũint
imitari:	imitari :
necesseesteos	necesse est eos
spretamundi	spreta mundi
huiusgl̃a	huius gl̃a
.cumuitiis⁊concupiscentiiscrucifigi.talesreueracrucem	. cum uitiis ⁊ concupiscentiis crucifigi . tales reuera crucem
xp̃i.crucẽĩnocentie	xp̃i . crucẽ ĩnocentie
baiulant.qui⁊	baiulant . qui ⁊
om̃imodaꝮscientiepuritateinteri᷒	om̃i moda Ꝯscientie puritate interi᷒
delectant᷑⁊tñadaugm̃tump̃mii.ext̃ius:	delectant᷑ ⁊ tñ ad augm̃tum p̃mii . ext̃ius :
armispenitẽtietotoferuoresp̃c	armis penitẽtie toto feruore sp̃c
accingunt᷑.huiccruciquamĩnocentiseẽdiximus	accingunt᷑ . huic cruci quam ĩnocentis eẽ diximus
.ioh̃esprecursordñicusin	. ioh̃es precursor dñicus in
separabilit̃affixusfũat.quilicetp̃p	separabilit̃ affixus fũat . qui licet p̃p
eminentiãsc̃itatis.angl̃icoꝓmissus	eminentiã sc̃itatis . angl̃ico ꝓmissus
eẽtoracl̃o.conceptusmiracl̃o	eẽt oracl̃o . conceptus miracl̃o
.sc̃ificatusĩ	. sc̃ificatus ĩ
utero:tñutpecc̃orib;formãpenitentiep̃scriberet.	utero : tñ ut pecc̃orib ; formã penitentie p̃scriberet .
corp᷒ĩnocentissimũuirtute	corp᷒ ĩnocentissimũ uirtute
singularisabstinentie.sicattenuauit.quasiscelerummultoꝝconscius	singularis abstinentie . sic attenuauit . quasi scelerum multoꝝ conscius
.reummortiset̃ne	. reum mortis et̃ne
seiudicaret.	se iudicaret .
quip̃cet̃issc̃isuiteꝑhennisp̃miodignusexstitit	qui p̃ cet̃is sc̃is uite ꝑhennis p̃mio dignus exstitit
.sic⁊sc̃imartires	. sic ⁊ sc̃i martires
corporasuap̃pdm̃uariissuppliciisexponentes.ad	corpora sua p̃p dm̃ uariis suppliciis exponentes . ad
exemplũredemptorissui.queñrapuerantex	exemplũ redemptoris sui . que ñ rapuerant ex
soluerunt.⁊ꝑinnocentiamꝑuenientesadpalmammartyrii.accepert̃	soluerunt .⁊ ꝑ innocentiam ꝑuenientes ad palmam martyrii . accepert̃
coronamuite.quãreꝓmisitdeusdiligentib;	coronam uite . quã reꝓmisit deus diligentib ;
se.constatautemcrux	se . constat autem crux
istaexduob	ista exduob
;lignis.aptesibi	; lignis . apte sibi
ĩuicemcompositis.q̃sunthumilitas.⁊patientia.	ĩuicem compositis . q̃ sunt humilitas .⁊ patientia .
necc̃eestenĩ.	necc̃e est enĩ .
utquidonocelestisgratie	ut qui dono celestis gratie
ĩnocentemseauiciis	ĩnocentem se auiciis
intelligit.⁊tamenadaugm̃tump̃mii.	intelligit .⁊ tamen ad augm̃tum p̃mii .
corp᷒suũpenitentielegib	corp᷒ suũ penitentie legib
;astringit:humilitatẽseruetincorde	; astringit : humilitatẽ seruet in corde
⁊patientiamteneatinoꝑe.neforteperlaudem	⁊ patientiam teneat in oꝑe . ne forte perlaudem
bonoꝝoꝑumque	bonoꝝ oꝑum que
forislucẽt.adĩanemrapiat᷑gl̃am.	foris lucẽt . ad ĩanem rapiat᷑ gl̃am .
ul̃siin	ul̃ si in
afflictionepenitentiepatientiamñseruaũit:fructumpenitentienõconsequens	afflictione penitentie patientiam ñ seruaũit : fructum penitentie nõ consequens
.sentiatꝓ	. sentiat ꝓ
remuñatiõeuindictam.porro	remuñatiõe uindictam . porro
crucẽpenitẽtisbaiulant.quipecc̃a	crucẽ penitẽtis baiulant . qui pecc̃a
p̃teritalacͥmisredim̃tes.annossuos	p̃terita lacͥmis redim̃tes . annos suos
ĩamaritudineaĩesuepecogiant.&membra	ĩ amaritudine aĩe sue pecogiant .& membra
queinstinctudiabolicesuggestionisexhibuerantseruire	que instinctu diabolice suggestionis exhibuerant seruire
ĩmũdicie⁊	ĩmũdicie ⁊
iniqͥtati.adĩiqͥtatem:nc̃oꝑantegr̃a	iniqͥtati . ad ĩiqͥtatem : nc̃ oꝑante gr̃a
diuineinspirationis:exhibentseruireiusticieinsc̃ificationẽ.	diuine inspirationis : exhibent seruire iusticie insc̃ificationẽ .
horumpenitentieñsolumhomines.	horum penitentie ñ solum homines .
s;⁊angl̃iꝮgratulant᷑	s ;⁊ angl̃i Ꝯgratulant᷑
.gaudentenĩ	. gaudent enĩ
angl̃idepenitentia⁊	angl̃i de penitentia ⁊
Ꝯũsionepecc̃oꝝ.sicut.scͥptumẽ.gaudiũ	Ꝯũsione pecc̃oꝝ . sicut . scͥptum ẽ . gaudiũ
ẽangl̃isd̃isuꝑunopecc̃orepenitentiãagente	ẽ angl̃is d̃i suꝑ uno pecc̃ore penitentiã agente
.plurimũdelectant᷑.utpoteusucilicii.ꝓfundis	. plurimũ delectant᷑ . ut pote usu cilicii . ꝓfundis
suspiriis.deuotis	suspiriis . deuotis
or̃onib᷒.crebragenuũflexione.⁊cet̃isbonorũoꝑm	or̃onib᷒ . crebra genuũ flexione .⁊ cet̃is bonorũ oꝑm
ex̄ciciis.quib;peccat̃xaĩa:creatorisuo	ex̄ciciis . quib ; peccat̃x aĩa : creatori suo
aquoꝑĩiqͥtatemrecesserat.Ꝯiũgitur.⁊ip̃iuslargiente	a quo ꝑ ĩiqͥtatem recesserat . Ꝯiũgitur .⁊ ip̃ius largiente
clem̃tia.qͥom̃shõies	clem̃tia . qͥ om̃s hõies
uultsaluosfieri:suꝑnoꝝciuiũcetib	uult saluos fieri : suꝑnoꝝ ciui ũcetib
;sociat᷑.Queaũmaior	; sociat᷑ . Que aũ maior
gaudioꝝpotest	gaudioꝝ potest
eẽmat̃ia.	eẽ mat̃ia .
quãcumredemptorbenignisam᷒pecc̃oremletiferouitioꝝsoporedep̃ssum.	quã cum redemptor benignisam᷒ pecc̃orem letifero uitioꝝ sopore dep̃ssum .
manupat̃nesollicitudinisexcitandoꝮcutit.utadũtatpecc̃orũ	manu pat̃ne sollicitudinis excitando Ꝯcutit . ut adũtat pecc̃orũ
suoꝝuulña.utdoloremuulnerũsuoꝝsentiat	suoꝝ uulña . ut dolorem uulnerũ suoꝝ sentiat
.quẽpriuspreduritiacordisñ	. quẽ prius preduritia cordis ñ
attendebat.t̃rẽdo	attendebat . t̃rẽdo
deniq;deducitadportasinferi.p̃oculisstatuens	deniq ; deducit ad portas inferi . p̃oculis statuens
supplicia.impiis⁊	supplicia . impiis ⁊
pecc̃orib;p̃pacata.	pecc̃orib ; p̃pacata .
s;net̃roriste.reumbaratro	s ; ne t̃ror iste . reum baratro
desꝑationisabsorbeat:piusꝮsolatormedelãuulñib;	desꝑationis absorbeat : pius Ꝯsolator medelã uulñib ;
adibens.speremissionis	adibens . spe remissionis
⁊indulgentie.corpenitentisexhilarando	⁊ indulgentie . cor penitentis exhilarando
Ꝯfortat᷑:Etnotandũqd̃cruxpenitentisintͥb	Ꝯfortat᷑ : Et notandũ qd̃ crux penitentis in tͥb
;precipueꝮsistit.uidelicet.ĩcarniscastigatione.	; precipue Ꝯsistit . uidelicet . ĩ carnis castigatione .
ĩcordiscõpunctione.⁊ĩiuriaꝝremissione.carniscastigatio	ĩ cordis cõpunctione .⁊ ĩiuriaꝝ remissione . carnis castigatio
admod̃penitentinecessariaẽ.oportetenim	ad mod̃ penitenti necessaria ẽ . oportet enim
utũepenitens	ut ũe penitens
tantoalicitis	tanto alicitis
studeatabstinere.	studeat abstinere .
qͣntoseillicitameminitꝮmisisse.	qͣnto se illicita meminit Ꝯmisisse .
necpardebeteẽfructuspenitentieillius.qui	nec par debet eẽ fructus penitentie illius . qui
abannispueritieseruauitĩnocentiam.⁊illius	ab annis pueritie seruauit ĩnocentiam .⁊ illius
qͥsoluto	qͥ soluto
pudiciciefreno	pudicicie freno
:ꝑmulta	: ꝑ multa
uitioꝝinqͥnam̃ta	uitioꝝ inqͥnam̃ta
maculauituitã.grataaũ	maculauit uitã . grata aũ
eritd̃ocorꝑiscastigatio	erit d̃o corꝑis castigatio
.siocculta	. si occulta
.sidiscreta	. si discreta
.sideniq;p̃latiiudiciofũitapprobata	. si deniq ; p̃lati iudicio fũit approbata
.Occulta	. Occulta
:utnesciatsinistra.p̃pd̃msecorꝑal̃raffligentis	: ut nesciat sinistra . p̃p d̃m se corꝑal̃r affligentis
.qͥdfaciatdext̃a	. qͥd faciat dext̃a
ei᷒.utbonũopusei᷒	ei᷒ . ut bonũ opus ei᷒
.sitetiãdiscretacarniscastigatio.utpenitenssic	. sit etiã discreta carnis castigatio . ut penitens sic
uoluptatẽcarnisrepͥmat.uttam̃necessitatẽcorporeefragilitatisattendat	uoluptatẽ carnis repͥmat . ut tam̃ necessitatẽ corporee fragilitatis attendat
.nesiforteualidenimis	. ne si forte ualide nimis
hostissubicit᷑:ciuisnecessari᷒occidat᷑.fortitudocorporis	hostis subicit᷑ : ciuis necessari᷒ occidat᷑ . fortitudo corporis
dominocustodiendaẽ.iuxta	domino custodienda ẽ . iuxta
psalmistãqͥdicit.	psalmistã qͥ dicit .
fortitudinẽmeãadtecustodiã.ut⁊	fortitudinẽ meã ad te custodiã . ut ⁊
abstinentiaillicitũcarnisrefrenet	abstinentia illici tũ carnis refrenet
appetitũ.⁊discretiocorpusĩ	appetitũ .⁊ discretio corpus ĩ
columeseruet	colume seruet
adcreatoriᷤobseqͥum	ad creatoriᷤ obseqͥum
.neq;enimsicutscͥptumẽ.ĩ	. neq ; enim sicut scͥptum ẽ . ĩ
abstinendoueledendoconsistiti᷒ticias;ĩ	abstinendo uel edendo consistit i᷒ticia s ; ĩ
eqͣnimitatetolerandiĩopiam.⁊ĩtemꝑantia	eqͣnimitate tolerandi ĩopiam .⁊ ĩtemꝑantia
.ñsecorrũpendiꝑhabundantiã.uidim᷒	. ñ se corrũpendi ꝑ habundantiã . uidim᷒
plerosq;ĩdiscretisieiuniis.	plerosq ; ĩdiscretis ieiuniis .
suꝑsticiosauigiliarũanticipatione.sicdebilitasse	suꝑsticiosa uigiliarũ anticipatione . sic debilitasse
uirescorporis:uttoto	uires corporis : ut toto
uitesuetemꝑe.ñsñfratrumscandalo.	uite sue temꝑe . ñ sñ fratrum scandalo .
ñsñꝮscĩedetͥmento.	ñ sñ Ꝯscĩe detͥmento .
p̃pĩfirmitatisnecessitatẽ.cibis	p̃p ĩfirmitatis necessitatẽ . cibis
delicatiorib;uti	delicatiorib ; uti
cog̃ent᷑.Iõq	cog̃ent᷑ . Iõ q
;abstinentiasubditi	; abstinentia subditi
:p̃lati	: p̃lati
iudicio.sic̃p̃dixim᷒debetapprobari.celestis	iudicio . sic̃ p̃ dixim᷒ debet approbari . celestis
enĩmagist̃mun᷒illudgratiusacceptabit.ꝙsubditus	enĩ magist̃ mun᷒ illud gratius acceptabit . ꝙ subditus
ñarbitrioꝓpͥe	ñ arbitrio ꝓpͥe
uoluntatiss;	uoluntatis s ;
imꝑiop̃sidentis:obtulerit	imꝑio p̃sidentis : obtulerit
.cordisetiam	. cordis etiam
cõpunctiosuot̃narioꝮsecrataẽ.	cõpunctio suo t̃nario Ꝯsecrata ẽ .
h̃tenĩlacͥmarũꝓfusionẽ.orisꝮfessionẽ.⁊	h̃t enĩ lacͥmarũ ꝓfusionẽ . oris Ꝯfessionẽ .⁊
oꝑiscorrectionẽ.necessariũꝓrsusestutoculi	oꝑis correctionẽ . necessariũ ꝓrsus est ut oculi
hucusq;	huc usq ;
pleniꝮcupiscentiis	pleni Ꝯcupiscentiis
:et̃nũfletũlacrimistẽporalib;	: et̃nũ fletũ lacrimis tẽporalib ;
p̃ueniãt.⁊quiꝑillicita:noxiacuriositateꝮsueueranteuagari	p̃ueniãt .⁊ qui ꝑillicita : noxia curiositate Ꝯsueuerant euagari
:nc̃auanitatererũtẽporaliũsepenitusaũtant	: nc̃ a uanitate rerũ tẽporaliũ se penitus aũtant
.necplangerecessetocl̃s.quodilliciteconcupiuit	. nec plangere cesset ocl̃s . quod illicite concupiuit
anim᷒.sordesenimanime:	anim᷒ . sordes enim anime :
lacͥmecompũctionisabluunt.⁊	lacͥme compũctionis abluunt .⁊
inhabundantiaꝓfluentes.ignem	in habundantia ꝓfluentes . ignem
gehenne.impiis⁊peccatorib	gehenne . impiis ⁊ peccatorib
;deputatũ	; deputatũ
:uelutimpetustorrentis:extingunt.Oris	: uelut impetus torrentis : extingunt . Oris
autemconfessiocompũctionicordisĩdubitatũgerittestimoniũ.	autem confessio compũctioni cordis ĩ dubitatũ gerit testimoniũ .
InpuraenĩꝮfessione:ꝑfecteꝮtͥtiõnisꝑpenderesolemus	In pura enĩ Ꝯfessione : ꝑfecte Ꝯtͥtiõnis ꝑpendere solemus
effectum.hecinqͣmconfessiosp̃ualiumẽmedicinauulnerũ	effectum . hec inqͣm confessio sp̃ualium ẽ medicina uulnerũ
.sñquañestsalusanimarũ.	. sñ qua ñ est salus animarũ .
sicutenĩ	sicut enĩ
ĩeccl̃iastescͥptumest.Quiabsconditscelerasua:	ĩ eccl̃iaste scͥptum est . Qui abscondit scelera sua :
ñdiriget᷑.quiaũꝮfessus	ñ diriget᷑ . qui aũ Ꝯfessus
fuerit⁊	fuerit ⁊
dimiseritea:ueniãꝮsequet᷑.s	dimiserit ea : ueniã Ꝯsequet᷑ . s
;attendendũ.qꝛqͣtuorst̃q̃uirtutẽuereꝮfessionis	; attendendũ . qꝛ qͣtuor st̃ q̃ uirtutẽ uere Ꝯfessionis
eneruant⁊inpediunt.uidelicet.pudor	eneruant ⁊ inpediunt . uidelicet . pudor
.⁊timor.spes	.⁊ timor . spes
.⁊desꝑatõ.	.⁊ desꝑatõ .
pudor:uirtutẽuereꝮfessionisĩpedit.dumpecc̃oꝝ	pudor : uirtutẽ uere Ꝯfessionis ĩpedit . dum pecc̃oꝝ
scel̃asuagrauia	scel̃a sua grauia
⁊ignominiosaeẽconsiderans.inseip̃oconfunditur	⁊ ignominiosa eẽ considerans . in se ip̃o confunditur
.⁊p̃confusionesp̃c:	.⁊ p̃ confusione sp̃c :
eaconfiterierubescit.talib;dicitapl̃c.	ea confiteri erubescit . talib ; dicit apl̃c .
Quẽfructumergohabuististunc.in	Quẽ fructum ergo habuistis tunc . in
quib;nuncerubescitis:antiquoetiam	quib ; nunc erubescitis : antiquo etiam
⁊usitatoꝓuerbiodicisolet.qꝛpecc̃a	⁊ usitato ꝓuerbio dici solet . qꝛ pecc̃a
uet̃a.nouampariuntꝮfusionẽ.ñ	uet̃a . nouam pariunt Ꝯfusionẽ . ñ
illaminqͣmꝮfusionem.dequascͥptumest.	illam inqͣm Ꝯfusionem . de qua scͥptum est .
estꝮfusio	est Ꝯfusio
adducensgl̃am.s;	ad ducens gl̃am . s ;
illamde	illam de
quadicit᷑.estconfusio	qua dicit᷑ . est confusio
adducens	ad ducens
.pecc̃m.	. pecc̃m .
talisenimꝮfusiopecc̃madducit.ñad	talis enim Ꝯfusio pecc̃m adducit . ñ ad
imit.qꝛqd̃ꝑostensionẽdelere	imit . qꝛ qd̃ ꝑostensionẽ delere
debuerat:ꝑoccultationẽ	debuerat : ꝑ occultationẽ
.magisaugm̃tat.audiatquesoqui	. magis augm̃tat . audiat queso qui
sicconfundit᷑.⁊	sic confundit᷑ .⁊
diligent̃attendatũbumilludbeatiiob.memoriadignum	diligent̃ attendat ũbum illud beati iob . memoria dignum
.⁊adh᷒modiꝮfusionẽpenit᷒	.⁊ ad h᷒modi Ꝯfusionẽ penit᷒
elimandã:sũmenecessariũ.sicutinquitnubesꝮsumit᷑⁊	elimandã : sũme necessariũ . sicut inquit nubes Ꝯsumit᷑ ⁊
ꝑtransit:sicqui	ꝑ transit : sic qui
descenditad̃iferosñascendet.nec	descendit a d̃i feros ñ ascendet . nec
reuertet᷑ultra	reuertet᷑ ultra
indomum	in domum
suam.neq;	suam . neq ;
cognosceteum.ampliuslocuseius.Quap̃p⁊	cognoscet eum . amplius locus eius . Qua p̃p ⁊
egononpartamorimeo.loqͣrĩ	ego non partam ori meo . loqͣr ĩ
tribulatõnesp̃cmei.confabulaborcum	tribulatõne sp̃c mei . confabulabor cum
amarituadineanime	amarituadine anime
meẽ.suꝑh̃clocumsicaitbeatusgregorius.	meẽ . suꝑ h̃c locum sic ait beatus gregorius .
Orisuoparcit.quiꝮfit̃imalumꝙfeciterubescit	Ori suo parcit . qui Ꝯfit̃i malum ꝙ fecit erubescit
.Inlaboremuͦosmittit	. In laborem uͦ os mittit
:quiadconfessionẽosaꝑit.timoretiamĩordinatus	: qui ad confessionẽ os aꝑit . timor etiam ĩordinatus
.uirtutemꝮfessioniseuacuat.dũ	. uirtutem Ꝯfessionis euacuat . dũ
peccatorꝓpriefragilitatimetuens.onussatisfactionisꝓpeccatissuis	peccator ꝓprie fragilitati metuens . onus satisfactionis ꝓ peccatis suis
subireformidat.Dehuiusmodiinlibroiobscͥptũ	subire formidat . De huiusmodi in libro iob scͥptũ
est.Qui	est . Qui
timentpruinam.irruetsr̃eosnix	timent pruinam . irruet sr̃ eos nix
.scitis	. scitis
quianixruitdesuꝑiorib	quia nix ruit de suꝑiorib
;.pruinauͦcongelescitinferius.ꝑpruinamp	;. pruina uͦ congelescit inferius . ꝑ pruinam p
.oꝑniuem	. o ꝑ niuem
uͦdesignatur	uͦ designatur
et̃na.uñ	et̃na . uñ
ineodemlibroiobdereꝓbisscͥptumẽ.transibunt	in eodem libro iob de reꝓbis scͥptum ẽ . transibunt
abaquisniuiumadcalorem	ab aquis niui um ad calorem
nimium.Etinꝓuerbiis.demuliereforti	nimium . Et in ꝓuerbiis . de muliere forti
.uideliceteccl̃ia.dicit᷑.nontimebitdomui	. uidelicet eccl̃ia . dicit᷑ . non timebit domui
sueafrigorib	sue a frigorib
;niuis.Om̃senim	; niuis . Om̃s enim
domesticieius	domestici eius
uestitist̃	uestiti st̃
duplicib;.rectegͦdc̃mest	duplicib ;. recte gͦ dc̃m est
.Quitimentpruinãirruetsuꝑeos	. Qui timent pruinã irruet suꝑ eos
nix.qꝛqͥpenamtẽporalemꝓsatisfactione	nix . qꝛ qͥ penam tẽporalem ꝓsatisfactione
pecc̃oꝝsubiremetuunt:ĩfuturodistrictumd̃i	pecc̃oꝝ subire metuunt : ĩ futuro districtum d̃i
iudiciũexcipient	iudiciũ excipient
.qd̃euadereñualebũt.hincetiãsalomõ	. qd̃ euadere ñ ualebũt . hinc etiã salomõ
ait.Quiobseruatuentos:ñseminat	ait . Qui obseruat uentos : ñ seminat
.hocestqͥpenitentietemporal̃	. hoc est qͥ penitentie temporal̃
laboremsubirerefugit	laborem subire refugit
:fructusbonoꝝoꝑuminfut̃auita	: fructus bonoꝝ oꝑum in fut̃a uita
ꝑcipiendos:	ꝑcipiendos :
ĩp̃senti	ĩ p̃senti
nõmultiplicat.similit̃.	nõ multiplicat . similit̃ .
spesuirtutemꝮfessionisminuit	spes uirtutem Ꝯfessionis minuit
.dumpecc̃orcõmodumtẽporaleconsequidesiderans.	. dum pecc̃or cõmodum tẽporale consequi desiderans .
illiᷤpenitusoccultatur.aquib	illiᷤ penitus occultatur . a quib
;effectumreiconcupite	; effectum rei concupite
latent̃obtiñenititurnesi	latent̃ obtiñe nititur ne si
fortepecc̃mqd̃latet:ĩꝮfessionedetegat:a	forte pecc̃m qd̃ latet : ĩ Ꝯfessione detegat : a
fructuspeiconcepteuacuusomnino	fructu spei concepte uacuus omnino
remaneat.	remaneat .
qꝛqd̃adipiscidesideratꝑstudium	qꝛ qd̃ adipisci desiderat ꝑ studium
cupiditatis:nonestdignusassequi.meritoiniqͥtatislatentis	cupiditatis : non est dignus assequi . merito iniqͥtatis latentis
.DesꝑatioetiamiurtutiꝮfessionisobiuat.	. Desꝑatio etiam iurtuti Ꝯfessionis obiuat .
dumpecc̃orscelerũsuoꝝ	dum pecc̃or scelerũ suoꝝ
multitudinẽ.	multitudinẽ .
magnitudinẽ.dut᷑nitatemconsid̃ans:de	magnitudinẽ . dut᷑nitatem consid̃ans : de
ip̃isapudd̃mueniã	ip̃is apud d̃m ueniã
seconsequiposse	se consequi posse
desꝑat.Quorũsimilitudinemgessitcaynillemaledictuscum	desꝑat . Quorũ similitudinem gessit cayn ille maledictus cum
ait.maiorestinqͥtasmeaqͣmutueniãmerear	ait . maior est inqͥtas mea qͣm ut ueniã merear
.Etdetalib	. Et de talib
;alibiscͥptũest	; alibi scͥptũ est
.Ipiuscũ	. Ipius cũ
inꝓfundumueñit:cõtempnit.contemptusenimdesꝑationemgenerat	in ꝓfundum ueñit : cõtempnit . contemptus enim desꝑationem generat
.desꝑatio	. desꝑatio
aũ:spemquauiuimus.⁊adcelestiasubleuam᷑:	aũ : spem qua uiuimus .⁊ ad celestia subleuam᷑ :
penit᷒eliminat	penit᷒ eliminat
.Exclusisigituhisquatuorqueconfessioniseuacuant	. Exclusis igitu his quatuor que confessionis euacuant
meritũ.iiiiͦ.	meritũ . iiiiͦ .
aliadiligenti᷒attendam᷒x.q̃inꝮfitentib;ꝑfectionis	alia diligenti᷒ attendam᷒ x . q̃ in Ꝯfitentib ; ꝑfectionis
oꝑanturaugm̃tũ	oꝑantur augm̃tũ
.ꝑfectaautẽeritconfessio:	. ꝑfecta autẽ erit confessio :
sinuda.siintegra.	si nuda . si integra .
sifidelissit⁊	si fidelis sit ⁊
ordinata.	ordinata .
nudaestconfessioqueũborũ	nuda est confessio que ũborũ
diuiditur.	diuiditur .
stultumestenimutscͥpturaait.	stultum est enim ut scͥptura ait .
dimidiamsꝑareueniam.ĩmoĩconfessionediuid̃e	dimidiam sꝑare ueniam . ĩmo ĩ confessione diuid̃e
peccata:semꝑestcarereuenia.fidelisautem	peccata : semꝑ est carere uenia . fidelis autem
eritconfessio.siisquiconfitet᷑.piam	erit confessio . si is qui confitet᷑ . piam
deremissione	de remissione
pecc̃oꝝfiduciamconcipiat	pecc̃oꝝ fiduciam concipiat
.ordinata:siprelatosuo.	. ordinata : si prelato suo .
ñalii.	ñ alii .
culpassuashumiliterexponendo	culpas suas humiliter exponendo
deplangat.Illiusenĩestadhibereremedium	deplangat . Illius enĩ est adhibere remedium
.quiincura	. qui incura
suscep̃egrotum.OrisꝮfessionemsequituroꝑiscorrectio.que	suscep̃ egrotum . Oris Ꝯfessionem sequitur oꝑis correctio . que
inobseruationemãdatoꝝd̃iconsistit⁊ꝑseũantia	in obseruatione mãdatoꝝ d̃i consistit ⁊ ꝑseũantia
.uͭpeccatorcreatorisuo	. uͭ peccator creatori suo
reconciliaridesiderans:declinetamalo	reconciliari desiderans : declinet a malo
.⁊faciatbonũ.⁊inbonoopereusq;in	.⁊ faciat bonũ .⁊ in bono opere usq ; in
.Quienim	. Qui enim
ꝑseuerauerit	ꝑseuera uerit
usq;infinem	usq ; in finem
:hicsaluuserit.cruxetiampenitentis	: hic saluus erit . crux etiam penitentis
.sic̃p̃dixim᷒Ꝯsilitĩiniuriarũremissione.	. sic̃ p̃dixim᷒ Ꝯsilit ĩ iniuriarũ remissione .
scitisqꝛirrogateiniurieintus	scitis qꝛ irrogate iniurie intus
animumcruciant.foris	animum cruciant . foris
manũad	manũ ad
uindictãꝓuocant.uñquiin	uindictã ꝓuocant . uñ qui in
sepeccanitib;excordedimittit.crucem	se peccanitib ; ex corde dimittit . crucem
ꝓpͥeuoluntati	ꝓpͥe uoluntati
:uindictamꝓĩiuriisillatisexpetenti:	: uindictam ꝓ ĩiuriis illatis ex petenti :
qͦdammodouiolent̃imponit.ad	qͦdam modo uiolent̃ imponit . ad
hanccrucemsaluatornosĩuitatdumpecc̃ores	hanc crucem saluator nos ĩuitat dum pecc̃ores
ip̃mĩiniqͥtatib;suisincessant̃exac̃bantes.ñsolum	ip̃m ĩ iniqͥtatib ; suis incessant̃ exac̃bantes . ñ solum
patient̃sustinet.s;etiampenitentib;:ueniãremissionis	patient̃ sustinet . s ; etiam penitentib ;: ueniã remissionis
.clem̃tiasuepietatisindulget.cuius	. clem̃tia sue pietatis indulget . cuius
indulgentietriplicemgr̃am	indulgentie triplicem gr̃am
.totadeuotione	. tota deuotione
recolendam.diligentissime	recolendam . diligentissime
debem᷒attend̃e.sicenimplenariammisericors	debem᷒ attend̃e . sic enim plenariam misericors
⁊miseratordñspenitentib;largiturindulgentiam.	⁊ miserator dñs penitentib ; largitur indulgentiam .
utdeincepsnec	ut deinceps nec
dampnetulciscendo.necꝮfundatĩꝓꝑandonecminusdiligat	dampnet ulciscendo . nec Ꝯfundat ĩꝓꝑando nec minus diligat
.inputando	. inputando
.audianthocq̃soclaustrales.⁊ardentiusunitaristudeant.	. audiant hoc q̃so claustrales .⁊ ardentius unitari studeant .
suntenimqͥdamqui	sunt enim qͥdam qui
siqualibet	si qualibet
occasionelesifuerint:donant	occasione lesi fuerint : donant
fortassisĩniuriam	fortassis ĩniuriam
:s;ꝙomnino	: s ; ꝙ omnino
remisisseuisist̃:freq̃ntiusinꝓꝑareñuerent᷑	remisisse uisi st̃ : freq̃ntius inꝓꝑare ñ uerent᷑
.sunt⁊aliiqͥ⁊sipostacceptasiniurias	. sunt ⁊ alii qͥ ⁊ si post acceptas iniurias
sileant.rancorẽtam̃incessant̃urentẽseruantĩ	sileant . rancorẽ tam̃ incessant̃ urentẽ seruant ĩ
animomanetaltam̃terepositũ.siquiddictuml̃fc̃m	animo manet alta m̃te repositũ . siquid dictum l̃ fc̃m
fũit.uñip̃is	fũit . uñ ip̃is
offẽsiõismat̃̄ia.	offẽsiõis mat̃̄ia .
scandalioccasiop̃stita	scandali occasio p̃stita
uideat᷑.adeout	uideat᷑ . ad eo ut
graueseisetiamaduidendũ.quizelo	graues eis etiam ad uidendũ . qui zelo
religionis⁊	religionis ⁊
discipline:excessus	discipline : excessus
eorumcorrectionedignos.ul̃	eorum correctione dignos . ul̃
lenirep̃hensionenotauerint.contrahoᷤbeneineccl̃iastico	leni rep̃hensione notauerint . contra hoᷤ bene in eccl̃iastico
scͥptumest.homo	scͥptum est . homo
hominiseruatiram.⁊a	homini seruat iram .⁊ a
deoqueritmedelam:longeabhiisest	deo querit medelam : longe ab hiis est
diuinemiserationis	diuine miserationis
benignissimalib̃alitaᷤquesicindulget	benignissima lib̃alitaᷤ que sic indulget
plenarie:utpecc̃oreᷤs;penitentes.	plenarie : ut pecc̃oreᷤ s ; penitentes .
ñsolũareatup̃uaricationisclem̃terabsoluat.s;⁊	ñ solũ a reatu p̃uaricationis clem̃ter absoluat . s ;⁊
habundantioredilectioniscumulo.ingr̃amdulcissimefamiliaritatisadmittat.	habundantiore dilectionis cumulo . in gr̃am dulcissime familiaritatis admittat .
probathocpetrusapl̃sconsciussecretoꝝdei.	probat hoc petrus apl̃s conscius secretoꝝ dei .
cuiposttͥnamnegationem:Ꝯmissaestuniũsaliseccl̃iecustodia	cui post tͥnam negationem : Ꝯmissa est uniũsalis eccl̃ie custodia
.ꝓbatḣidem	. ꝓbat ḣ idem
famosissimapeccatrixinquasic̃scͥptumẽ.	famosissima peccatrix in qua sic̃ scͥptum ẽ .
postqͣmhabundauitpecc̃m:suꝑhabundauit⁊gr̃a.crucem	postqͣm habundauit pecc̃m : suꝑ habundauit ⁊ gr̃a . crucem
latronisinsultantis.penãꝑhennẽ	latronis insultantis . penã ꝑhennẽ
pecc̃oriseẽdiximus.finalit̃ĩmaloꝑseuerantis.	pecc̃oris eẽ diximus . finalit̃ ĩ malo ꝑseuerantis .
EtheccruxquatuorinsebrachiaꝮtinet	Et hec crux quatuor in se brachia Ꝯtinet
.uidelicetũmẽꝮscĩe	. uidelicet ũmẽ Ꝯscĩe
.horroremgehenne.tenebrarũ	. horrorem gehenne . tenebrarũ
caliginẽ.penaꝝ	caliginẽ . penaꝝ
acerbitatẽ.Deuermeconscĩescͥptumestineuͣngl̃io	acerbitatẽ . De uerme conscĩe scͥptum est in euͣngl̃io
.simul⁊ĩysaia.uermiseoꝝ	. simul ⁊ ĩ ysaia . uermis eoꝝ
nonmoriet᷑	non moriet᷑
.Quodlicetplanumsitadlitt̃am:tñ	. Quod licet planum sit adlitt̃am : tñ
adaccusatõnemremordentisꝮscĩe:recteretorq̃tur.qͣntũad	ad accusatõnem remordentis Ꝯscĩe : recte retorq̃tur . qͣntũ ad
spiritalemĩtelligentiã.De	spiritalem ĩtelligentiã . De
horroregehenneinlibroiobscͥptum.ubi	horrore gehenne in libro iob scͥptum . ubi
umbramortis.⁊nullusordo.s;sempit̃nus	umbra mortis .⁊ nullus ordo . s ; sempit̃nus
.horrorinhabitans.tenebrarũcaliginẽ.	. horror inhabitans . tenebrarũ caliginẽ .
sermoexpͥmiteuͣgl̃ic᷒.ubi	sermo expͥmit euͣgl̃ic᷒ . ubi
dicit.mittent᷑	dicit . mittent᷑
intenebrasext̃iores.penarũacerbitatẽ:ubisubiungit	in tenebras ext̃iores . penarũ acerbitatẽ : ubi subiungit
.Ibieritfletus⁊stridordentium.caueam᷒	. Ibi erit fletus ⁊ stridor dentium . caueam᷒
dilectissimifratres	dilectissimi fratres
nehuiccruci	ne huic cruci
peccatisnr̃isexigentib	peccatis nr̃is exigentib
;et̃nalit̃affigam᷑carnales	; et̃nalit̃ affigam᷑ carnales
concupiscentiasuolũtariacastigationecohibentes.temporalit̃potiusmacerem᷑.qͣm	concupiscentias uolũtaria castigatione cohibentes . temporalit̃ potius macerem᷑ . qͣm
suppliciisdeputemur	suppliciis deputemur
et̃nis.⁊sicrucemxp̃i.crucem	et̃nis .⁊ si crucem xp̃i . crucem
ĩnocentie.utpote	ĩnocentie . ut pote
rei⁊nocenteᷤbaiulare	rei ⁊ nocenteᷤ baiulare
ñpossumus:saltẽcrucempenĩe.q̃nosab	ñ possumus : saltẽ crucem penĩe . q̃ nos ab
et̃nocruciatulib̃et:dieb;istisp̃cipue.nob̃	et̃no cruciatu lib̃et : dieb ; istis p̃cipue . nob̃
assumamus.Qui	assumamus . Qui
enĩxp̃ist̃.carnẽsuãcrucifixerunt	enĩ xp̃i st̃ . carnẽ suã crucifixe runt
.cũuiciis⁊	. cũ uiciis ⁊
concupiscentiis.Obseruandũ	concupiscentiis . Obseruandũ
nob̃est	nob̃ est
.utxp̃i	. ut xp̃i
sumus.⁊carnẽnr̃amcũuicĩs⁊	sumus .⁊ carnẽ nr̃am cũ uicĩs ⁊
Ꝯcupiscẽtiiscͧcifigamus.multienĩcarnẽ	Ꝯcupiscẽtiis cͧcifigamus . multi enĩ carnẽ
suãcrucifigunt.⁊t̃nxp̃iñst̃.	suã crucifigunt .⁊ t̃n xp̃i ñ st̃ .
utpoteex	ut pote ex
oꝑib;suisq̃rectauident᷑:humanamstudiosiusappetunt	oꝑib ; suis q̃ recta uident᷑ : humanam studiosius appetunt
gl̃am.s;tanqͣmfatueuirgines	gl̃am . s ; tanqͣm fatue uirgines
obeumĩuasisñhabentes	ob eum ĩ uasis ñ habentes
:uacuamuirtutib;hñtꝮscĩam.lucentquidem	: uacuam uirtutib ; hñt Ꝯscĩam . lucent quidem
.s;ñardent.	. s ; ñ ardent .
quiꝑlucẽbonoꝝoꝑum:forissimulantuite	qui ꝑ lucẽ bonoꝝ oꝑum : foris simulant uite
ꝑfectionem.s;intusignecaritatisnõ	ꝑfectionem . s ; intus igne caritatis nõ
accendunt᷑adsalutem.utigiturfructuosasitcarnisnr̃e	accendunt᷑ ad salutem . ut igitur fructuosa sit carnis nr̃e
mortifioatõext̃ioriꝮũsationiꝮcordet	mortifioatõ ext̃iori Ꝯũsationi Ꝯcordet
interiormentisĩtentio.utsicoꝑanr̃aluceant	interior mentis ĩtentio . ut sic oꝑa nr̃a luceant
coramhom̃ib;:	coram hom̃ib ;:
qͣtinus⁊illiꝑ	qͣtinus ⁊ illi ꝑ
omniaplaceam᷒.quicordiũ	omnia placeam᷒ . qui cordiũ
scrutatorẽintim᷒.Ih̃c	scrutator ẽ intim᷒ . Ih̃c
xp̃cdñs	xp̃c dñs
nr̃.cui᷒	nr̃ . cui᷒
regnũ⁊imꝑium.ꝑmane,inseculaseculorum	regnũ ⁊ imꝑium . ꝑmane , in secula seculorum
.amensmoIngenerali	. amen smo In generali
capituloEgosumpastorbon᷒.quipascoouesmeas	capitulo Ego sum pastor bon᷒ . qui pasco oues meas
.⁊ꝓouib;meisponoaĩammeã	.⁊ ꝓ ouib ; meis pono aĩam meã
.necessariumfueratfr̃es⁊patresdilectissimi.utdiei	. necessarium fuerat fr̃es ⁊ patres dilectissimi . ut diei
p̃sentisexhortationẽ.lingue.torrenti.⁊fecundo	p̃sentis exhortationẽ . lingue . torrenti .⁊ fecundo
pectoriꝮmisissẽ.decui᷒plenitudinenosom̃s	pectori Ꝯmisissẽ . de cui᷒ plenitudine nos om̃s
accipientes.⁊sacrescͥpt᷑e	accipientes .⁊ sacre scͥpt᷑e
dulcedinem.palatocordisdegustantes.ũbisdiuinisquasiqͥb᷒dã	dulcedinem . palato cordis degustantes . ũbis diuinis quasi qͥb᷒dã
carbonib;uastatoriis.adamorẽp̃ceptoꝝdei	carbonib ; uastatoriis . ad amorẽ p̃ceptoꝝ dei
.uehementi᷒accenderem᷑.ne	. uehementi᷒ accenderem᷑ . ne
tamencaritatiur̃euideat᷑iniuriosũ.	tamen caritati ur̃e uideat᷑ iniuriosũ .
siscd̃umoremdiei.uerbũdeiñ	si scd̃u morem diei . uerbũ dei ñ
ꝓcedat:aliqͥddicere.licet	ꝓcedat : aliqͥd dicere . licet
p̃sumptuosusaudebo.⁊intab̃naculodñi.ñqd̃	p̃sumptuosus audebo .⁊ in tab̃naculo dñi . ñ qd̃
uolo.s;	uolo . s ;
ꝙualeo.	ꝙ ualeo .
deuotusofferam.inhocmaximeloquendisumensfiduciam.	deuotus offeram . in hoc maxime loquendi sumens fiduciam .
qꝛdeusmunus	qꝛ deus munus
qͣntumlibetparuũñrespuit.ꝙoblatumfũitbone	qͣntumlibet paruũ ñ respuit . ꝙ oblatum fũit bone
sermorusticior.⁊qͥnouafrequent̃auditis:uet̃a.⁊	sermo rusticior .⁊ qͥ noua frequent̃ auditis : uet̃a .⁊
siueradespiciatis.sedetis	si uera despiciatis . sedetis
.⁊icircoquasiꝮuiuedelicatiq̃q;min᷒sapida.	.⁊ icirco quasi Ꝯuiue delicati q̃q ; min᷒ sapida .
min᷒p̃parata:nõĩmeritofastiditis	min᷒ p̃parata : nõ ĩ merito fastiditis
.s;rursus	. s ; rursus
attendoꝙint̃cibos	attendo ꝙ int̃cibos
delicatiores.groᷤsioraq̃q;	delicatiores . groᷤsiora q̃q ;
ñnũqͣmdulci᷒sapiunt.⁊human᷒	ñ nũqͣm dulci᷒ sapiunt .⁊ human᷒
anim᷒gratauicissitudinesequandoq	anim᷒ grata uicissitudine se quandoq
;Ꝯmunib;applicat.uͭadpenetͣndamsubtilium	; Ꝯmunib ; applicat . uͭ ad penetͣndam subtilium
ꝓfunditatẽ.ardenti᷒	ꝓfunditatẽ . ardenti᷒
p᷒modũrecurrat.scioquidempr̃eskm̃i.plureᷤ	p᷒modũ recurrat . scio quidem pr̃es km̃i . plureᷤ
eẽinter	eẽ inter
uosuerbi	uos uerbi
diuinidispensatoresydoneos.quilegemdiuinamdigito	diuini dispensatores ydoneos . qui legem diuinam digito
deiincordib;eorumscriptam.ñsolum	dei in cordib ; eorum scriptam . ñ solum
insermonefreq̃nt̃annuntiant.s;etiamefficacit̃	in sermone freq̃nt̃ annuntiant . s ; etiam efficacit̃
inoꝑedemonstarnt.qꝛtam̃fratũꝓfectib;ex	in oꝑe demonstarnt . qꝛ tam̃ fratũ ꝓfectib ; ex
ĩiuncto	ĩ iuncto
teneorofficiodeseruire.	teneor officio deseruire .
ñabreiudico.adedificationẽsimpliciũ.saltemꝮmunia	ñ abre iudico . ad edificationẽ simpliciũ . saltem Ꝯmunia
.⁊quasiom̃ib	.⁊ quasi om̃ib
;notaꝓpoñe	; nota ꝓpoñe
.Insufficentiã	. Insufficentiã
itaq;meamuobisñ	itaq ; meam uobis ñ
incognitã:penesuosexcusans.	incognitã : penes uos excusans .
ueniamdep̃sentionepostulo.quialinguãcui	ueniam de p̃sentione postulo . quia linguã cui
silentiumscientiedefectusimponit⁊imperat.frat̃necaritatis	silentium scientie defectus imponit ⁊ imperat . frat̃ne caritatis
affectusadloquendumresoluit⁊Ꝯfortat.Egosumpastor	affectus ad loquendum resoluit ⁊ Ꝯfortat . Ego sum pastor
bon᷒.⁊c̃.Inũbisistisfratrestͥa	bon᷒ .⁊ c̃ . In ũbis istis fratres tͥa
pͥmoꝮsid̃andanob̃occ᷑runt.bonitasredẽptorisnr̃i:cum	pͥmo Ꝯsid̃anda nob̃ occ᷑runt . bonitas redẽptoris nr̃i : cum
dicitur.Egosumpastorbonus.sollicitudo⁊affectus	dicitur . Ego sum pastor bonus . sollicitudo ⁊ affectus
eiuserganoᷤ:cumaddit᷑:qui	eius erga noᷤ : cum addit᷑ : qui
pascoouesmeas.bonitatis⁊	pasco oues meas . bonitatis ⁊
sollicitudinisei᷒dem.	sollicitudinis ei᷒dem .
ĩenarrabiliseffc̃s.	ĩenarrabilis effc̃s .
cumadextremũꝮcludit᷑.⁊	cum ad extremũ Ꝯcludit᷑ .⁊
ꝓouib;meisponoaĩammeã.Et	ꝓouib ; meis pono aĩam meã . Et
pͥmoqͥdemadbontatisip̃ius	pͥmo qͥdem ad bontatis ip̃ius
habundantiã.m̃tisocuos	habundantiã . m̃tis ocuos
retorq̃amus:⁊ĩueniemusꝓculdubio.	retorq̃amus :⁊ ĩueniemus ꝓculdubio .
multiplicesboneficioꝝei᷒Ꝯsolationes.quib;quasiqͥb᷒dam	multiplices boneficioꝝ ei᷒ Ꝯsolationes . quib ; quasi qͥb᷒dam
stimulisĩamorẽ	stimulis ĩamorẽ
ip̃i᷒totom̃tisaffecturapͥamur.Intͥb	ip̃i᷒ toto m̃tis affectu rapͥamur . Intͥb
;aũp̃cipuebonitatẽdiuinãpossumusattend̃e:uidelicetĩ	; aũ p̃cipue bonitatẽ diuinã possumus attend̃e : uidelicet ĩ
homĩscreatione	homĩs creatione
.ĩip̃iusrecreatio:⁊	. ĩ ip̃ius recreatio :⁊
ĩei᷒demgl̃ificatione.Increationequidem	ĩ ei᷒dem gl̃ificatione . In creatione quidem
.qꝛp̃pbonitatẽ	. qꝛ p̃p bonitatẽ
diuinãcreatusesthomo.	diuinã creatus est homo .
sicuttestaturbeatusaug᷒.inlibrodedoctͥna	sicut testatur beatus aug᷒ . in libro de doctͥna
xp̃iana.ubiait:qꝛdeus	xp̃iana . ubi ait : qꝛ deus
bon᷒est.	bon᷒ est .
nossumus.⁊ĩ	nos sumus .⁊ ĩ
qͣntumsum᷒:bonisum᷒.	qͣntum sum᷒ : boni sum᷒ .
Ecceqꝛcreat᷒esthõ.ꝓpt̃	Ecce qꝛ creat᷒ est hõ . ꝓpt̃
bonitatẽdiuinã	bonitatẽ diuinã
:creatusestetiamp̃putilitatẽsuam.	: creatus est etiam p̃p utilitatẽ suam .
utileẽenimhominiseruired̃o:utpostmodũ	utile ẽ enim homini seruire d̃o : ut postmodũ
fruat᷑eo.deo	fruat᷑ eo . deo
enĩseruire:regareẽ:⁊sicordinauit	enĩ seruire : regare ẽ :⁊ sic ordinauit
diuinamod̃atio.	diuina mod̃atio .
utomniaquep̃phoĩemfc̃ast̃.⁊subip̃o	ut omnia que p̃p hoĩem fc̃a st̃ .⁊ sub ip̃o
existuntusib;eiusdeseruiant.utip̃eordinelegitimo	existunt usib ; eius deseruiant . ut ip̃e ordine legitimo
.suosuꝑiori.i.d̃odebitũexibeatfamulatũ	. suo suꝑiori . i . d̃o debitũ exibeat famulatũ
.Inrecreationeaũ	. In recreatione aũ
hom̃is:maiorẽcumulũdiuinebonitatisp᷒sumusattendere	hom̃is : maiorẽ cumulũ diuine bonitatis p᷒sumus attendere
.Quantaenĩdignatio.utfili᷒d̃iañ	. Quanta enĩ dignatio . ut fili᷒ d̃i añ
secula.fc̃shom̃isfili᷒infine	secula . fc̃s hom̃is fili᷒ in fine
seculoꝝ.defectusnr̃e	seculoꝝ . defectus nr̃e
carniᷤsintsusciꝑet.⁊	carniᷤ sint susciꝑet .⁊
humanigenerismiseriemisericordit̃Ꝯpatiens.hoĩem	humani generis miserie misericordit̃ Ꝯpatiens . hoĩem
ꝑditũad	ꝑditũ ad
regnacelestiareuocaret	regna celestia reuocaret
:oquamdiuesĩmicd̃ia.qͣmmunific᷒ĩ	: o quam diues ĩ micd̃ia . qͣm munific᷒ ĩ
gr̃a.redẽptor	gr̃a . redẽptor
noster.qͥde	noster . qͥ de
sinupatris	sinu patris
descendens.ouemꝑditamꝓpͥishumerisadgregẽreportauit:⁊	descendens . ouem ꝑditam ꝓpͥis humeris ad gregẽ reportauit :⁊
pͥmep̃uaricationis	pͥme p̃uaricationis
reatumdiluens.seip̃mꝓnob̃p̃ciumredemptionisoptulit	reatum diluens . se ip̃m ꝓ nob̃ p̃cium redemptionis optulit
.Inhoĩsuͦglorificatione:	. In hoĩs uͦ glorificatione :
multomagiselucetdiuine	multo magis elucet diuine
respectusmiscd̃ie.Queenĩmaiorgr̃a.	respectus miscd̃ie . Que enĩ maior gr̃a .
quamutdestructacaptiuitate	quam ut destructa captiuitate
.seruus	. seruus
intretĩgaudiũdñisui.⁊hereditatẽꝮsequat᷑	intret ĩ gaudiũ dñi sui .⁊ hereditatẽ Ꝯsequat᷑
.quedecet̃oñpossitauferri	. que de cet̃o ñ possit auferri
:hocestꝙip̃edominusait.pat̃	: hoc est ꝙ ip̃e dominus ait . pat̃
uoloutubisum:illicsit⁊ministermeus	uolo ut ubi sum : illic sit ⁊ minister meus
.Etalibi.pat̃.quos	. Et alibi . pat̃ . quos
dedistimͥ:uoloutubiegosum⁊	dedisti mͥ : uolo ut ubi ego sum ⁊
illisint	illi sint
mecũutuideant	mecũ ut uideant
claritatẽmeãqͣmdidistimͥ	claritatẽ meã qͣm didisti mͥ
.quiadilexistime.añꝮtitutionẽseculi.In	. quia dilexisti me . añ Ꝯtitutionẽ seculi . In
hacautemgl͛ificatione.tͥa	hac autem gl͛ificatione . tͥa
quilibetelectorumdiuinomuñeconsequit᷑:quib;ab	quilibet electorum diuino muñe consequit᷑ : quib ; ab
sortamorteĩuictoriam:	sorta morte ĩ uictoriam :
sñt̃minofeliciterꝑfruet᷑.	sñ t̃mino feliciter ꝑfruet᷑ .
pͥmũest	pͥmũ est
et̃nasacietas	et̃na sacietas
ind̃iꝮtemplatione.scd̃m:int̃naiocunditasin	in d̃i Ꝯtemplatione . scd̃m : int̃na iocunditas in
Ꝯscientiepuritate.t̃cium:iocundaunitas.insc̃orum	Ꝯscientie puritate . t̃cium : iocunda unitas . in sc̃orum
societate.Et	societate . Et
h̃quidemdebonitateredẽptorisnr̃isuccincteꝑcurrentes:	h̃ quidem de bonitate redẽptoris nr̃i succincte ꝑcurrentes :
nc̃adsollicitudinẽ⁊affectumip̃iuserganosꝮsiderationisoculos	nc̃ ad sollicitudinẽ ⁊ affectum ip̃ius erga nos Ꝯsiderationis oculos
accollamus.Egosuminquitpastorbonus:	accollamus . Ego sum inquit pastor bonus :
quipascooues	qui pasco oues
meas.pascitdominusoues	meas . pascit dominus oues
suas.i.fidelespopulosmultiplicit̃.siqͥdempascit	suas . i . fideles populos multiplicit̃ . siqͥdem pascit
tẽporaliũsubministratione:	tẽporaliũ subministratione :
pascitdiuiniũbieruditione.pascitetiamsacͣmentoꝝ	pascit diuini ũbi eruditione . pascit etiam sacͣmen toꝝ
participatione:adextremum	participatione : ad extremum
pascitet̃na	pascit et̃na
suediuinitatisuisione	sue diuinitatis uisione
.pascittẽꝑaliũsubministͣtione:	. pascit tẽꝑaliũ subministͣtione :
sicuthabetis	sicut habetis
inpsalmo.Qui	in psalmo . Qui
custoditueritatemĩsecl̃m	custodit ueritatem ĩ secl̃m
.facitiudiciũ	. facit iudiciũ
ĩiuriampatientib;:	ĩiuriam patientib ;:
datescamesurientib;.escam	dat escam esurientib ;. escam
uidelicettamcorporalẽqͣm	uidelicet tam corporalẽ qͣm
ip̃oꝝ:⁊	ip̃oꝝ :⁊
pulliscoruoꝝĩuocantib;	pullis coruoꝝ ĩuocantib ;
eũ.pascitdiuiniuerbieruditione	eũ . pascit diuini uerbi eruditione
:sic̃inalio	: sic̃ in alio
psalmoscͥptumest.Dñsregitme.⁊nich̃mͥ	psalmo scͥptum est . Dñs regit me .⁊ nich̃ mͥ
deerit.ĩlocopascue.hocest	deerit . ĩ loco pascue . hoc est
intelligentiadiuinisermonis.	intelligentia diuini sermonis .
ibimecollocauit	ibi me collocauit
.pascitetiam	. pascit etiam
sacͣmentoꝝparticipatione:⁊p̃cipue	sacͣmentoꝝ participatione :⁊ p̃cipue
sacͣcorporis⁊sanguinissuiꝮmunione.ũnip̃e.	sacͣ corporis ⁊ sanguinis sui Ꝯmunione . ũn ip̃e .
Egosumpanisuiuusqͥdecelodescendi.	Ego sum panis uiuus qͥ decelo descendi .
siquismanducaũitexhocpane:	si quis manducaũit ex hoc pane :
uiuetinet̃num.ad	uiuet in et̃num . ad
extremumpascit.et̃nasuediuinitatisuisione.	extremum pascit . et̃na sue diuinitatis uisione .
uñbeat᷒.g̃g.	uñ beat᷒ . g̃g .
aitpascua	ait pascua
electorumst̃	e lectorum st̃
:uult᷒presensdei.qͥdum	: uult᷒ presens dei . qͥ dum
sñdefectuꝮspicitursinefinemenscibouitesaciatur.	sñ defectu Ꝯspicitur sine fine mens cibo uite saciatur .
sequit᷑.⁊ꝓouib;meisponoaĩammeã	sequit᷑ .⁊ ꝓouib ; meis pono aĩam meã
.Eccediuinebonitatiseffectusĩenarrabilis.maiorẽenĩ	. Ecce diuine bonitatis effectus ĩenarrabilis . maiorẽ enĩ
caritatẽnemoh̃t:qͣmutaĩam	caritatẽ nemo h̃t : qͣm ut aĩam
suamponatqͥsꝓamicissuis.	suam ponat qͥs ꝓ amicis suis .
xp̃cuͦlargiorecaritatishabundantia.etiãꝓĩimicis.	xp̃c uͦ largiore caritatis habundantia . etiã ꝓ ĩimicis .
crucissuppliciũꝑtulit:⁊uitalimortis	crucis suppliciũ ꝑtulit :⁊ uitali mortis
ĩꝑiumdestruens.serpentẽcallidũquiineo	ĩꝑium destruens . serpentẽ callidũ qui in eo
aũrationabilescausasp᷒sumusassignare	aũ rationabiles causas p᷒sumus assignare
.qͣreredemptornr̃ꝓsalutehumanigñis.	. qͣre redemptor nr̃ ꝓ salute humani gñis .
calicemgustaueritpassionis:cumtñtestantescͥptura.	calicem gustauerit passionis : cum tñ testante scͥptura .
aliusmodusredẽptionis	alius modus redẽp tionis
nr̃e.ei	nr̃e . ei
utpoteom̃ipotenti:fũitpossibilis.pͥmacausa	ut pote om̃ipotenti : fũit possibilis . pͥma causa
fuit.hu	fuit . hu
humanigenerismiseria:	humani generis miseria :
deqͣĩpsalmodr̃.ꝓpt̃miseriam	de qͣ ĩ psalmo dr̃ . ꝓpt̃ miseriam
ĩopum.⁊gemitumpauꝑum:nc̃exurgam	ĩ opum .⁊ gemitum pauꝑum : nc̃ exurgam
.i.manifestabor	. i . manifestabor
.dic̃dñs.	. dic̃ dñs .
ponãinsalutari.ḣest	ponã in sa lutari . ḣ est
inxp̃o.salutemgenerishumani:⁊fiducialit̃agamin	in xp̃o . salutem generis humani :⁊ fiducialit̃ agam in
eo.scd̃a	eo . scd̃a
causafuit.filialisꝗͣpr̃iexhibuit	causa fuit . filialis ꝗͣ pr̃i exhibuit
obedientia:dequadicit	obedientia : de qua dicit
apl̃us.xp̃cfc̃sestobediensdeopatriusq;	apl̃us . xp̃c fc̃s est obediens deo patri usq ;
admortem:mortemautẽcrucis.Et	ad mortem : mortem autẽ crucis . Et
ip̃efili᷒ad	ip̃e fili᷒ ad
patrem.clarificauiteinqͥt	patrem . clarificaui te inqͥt
supert̃ram:opusꝮsũmaui	super t̃ram : opus Ꝯsũmaui
:qd̃dedisti	: qd̃ dedisti
mͥutfaciam.terciacausafuit:singularis	mͥ ut faciam . tercia causa fuit : singularis
dehosteuictoria.consonũenim	de hoste uictoria . consonũ enim
eratequitatidiuine.⁊	erat equitati diuine .⁊
suꝑnedispositioni:utsapĩaq̃	suꝑne dispositioni : ut sapĩa q̃
attingitafineusq;	attingit a fine usq ;
adfinemfortiter.⁊disponit	ad finem fortiter .⁊ disponit
om̃iasuauit̃:hostisantiquimalitiã.non	om̃ia suauit̃ : hostis antiqui malitiã . non
potentia.	potentia .
s;iusticiadeuinceret.&om̃inoꝮueniensfuit.uͭ	s ; iusticia deuinceret .& om̃ino Ꝯueniens fuit . uͭ
qͥinlignouicerat	qͥ in ligno uicerat
:inlignoquoq;uictus.⁊	: in ligno quoq ; uictus .⁊
inlaq̃umquemparaueratp̃cipitatus:instrum̃tosuefraudisint̃iret	in laq̃um quem parauerat p̃cipitatus : instrum̃to sue fraudis int̃iret
.neq;enimlexequiorulla	. neq ; enim lex equior ulla
.qͣmnecis	. qͣm necis
artificemarteꝑiresua.In	artificem arte ꝑire sua . In
supernosĩconflictutemptationũpositos.	super nos ĩ conflictu temptationũ positos .
dñssuauictoriaaduincendũroborauit:uͭexemploip̃ius	dñs sua uictoria ad uincendũ roborauit : uͭ exemplo ip̃ius
.patirntiãintͥbulatiõib᷒amplectens:cumꝓbatifuerimus.	. patirntiã intͥbulatiõib᷒ amplectens : cum ꝓbati fuerimus .
coronãuiteꝑcipiamus.	coronã uite ꝑcipiamus .
nuncitaq;	nunc itaq ;
qͥcumq;	qͥ cumq ;
pastorẽanimarũ.	pastor ẽ animarũ .
uideantutfaciatom̃ia	uideant ut faciat om̃ia
iuxtaexemplar.	iuxta exemplar .
ꝙeiĩmontemonstratũest	ꝙ ei ĩ monte monstratũ est
.uideat	. uideat
inqͣmnesitmercennari᷒.quilupoueniẽtedimittitoues	inqͣm ne sit mercennari᷒ . qui lupo ueniẽte dimittit oues
⁊fugit:	⁊ fugit :
s;ueripastoris	s ; ueri pastoris
fungensofficio	fungens officio
.curamdebitãsusceptisinpendatouib;.ut	. curam debitã susceptis inpendat ouib ;. ut
⁊ip̃ecũdominodicerepossit.Egosum	⁊ ip̃e cũ domino dicere possit . Ego sum
pastorbon᷒.utaũbonuspastor	pastor bon᷒ . ut aũ bonus pastor
meritoquiseẽ	merito quis eẽ
iudicetur:qͣtuorĩ	iudicetur : qͣtuor ĩ
eonecessarioreqͥrunt᷑.	eo necessario reqͥrunt᷑ .
Ꝯũsatiosc̃a:fama	Ꝯũsatio sc̃a : fama
integͣ.	integͣ .
auctoritas.⁊scientia	auctoritas .⁊ scientia
.conũsatiosc̃a	. conũsatio sc̃a
p̃latomaximenecessaria	p̃lato maxime necessaria
est:utqui	est : ut qui
aliossuscepitĩcuraregiminis	alios suscepit ĩcura regiminis
.eosprecederestudeatexemploꝑfecteoꝑationis.neiuxta	. eos precedere studeat exemplo ꝑfecte oꝑationis . ne iuxta
ũbumapl̃idominet᷑ingrege.s;	ũbum apl̃i dominet᷑ in grege . s ;
forma.fiatgregis.⁊exanimo.nedeniq	forma . fiat gregis .⁊ ex animo . ne deniq
;magnusinoculissuis.occasionesusceptepotestatis	; magnus in oculis suis . occasione suscepte potestatis
:ĩtumoremuertat᷑elationis.hocẽqd̃	: ĩ tumorem uertat᷑ elationis . hoc ẽ qd̃
ĩeccl̃iasticoscͥptumest.rec̃toremte	ĩ eccl̃iastico scͥptum est . rec̃torem te
Ꝯstituerunt:noliextolli.s;estoin	Ꝯstituerunt : noli ex tolli . s ; esto in
illis.quasi	illis . quasi
unusexip̃is.prelatusitaq	unus ex ip̃is . prelatus itaq
;gregisuoꝑom̃iasestudeatꝮformare:ut	; gregi suo ꝑ om̃ia se studeat Ꝯformare : ut
exemplũreligionisprebensom̃ib;.	exemplũ religionis prebens om̃ib ;.
sitcũfr̃ib;assiduusĩclaustroad	sit cũ fr̃ib ; assiduus ĩ claustro ad
lectionẽ.ĩoratorio	lectionẽ . ĩ oratorio
ador̃onem:inrefectorioadcibosꝮmunes.ĩdormitorio	ad or̃onem : inrefectorio ad cibos Ꝯmunes . ĩ dormitorio
adlectuliduriciam⁊asꝑitatem	ad lectuli duriciam ⁊ asꝑitatem
:ĩcapitl̃oad	: ĩ capitl̃o ad
culparũcorrectionẽ.⁊utbreuit̃Ꝯcludam.	culparũ correctionẽ .⁊ ut breuit̃ Ꝯcludam .
om̃iaquesubditoᷤuolueritobseruare:ip̃e	om̃ia que subditoᷤ uoluerit obseruare : ip̃e
pͥmusp̃om̃ib;studeatadimplere	pͥmus p̃ om̃ib ; studeat adimplere
.famaetiamp̃latop̃cipuenecessaria	. fama etiam p̃lato p̃cipue necessaria
ẽ.utxp̃ibonusodorsitĩ	ẽ . ut xp̃i bonus odor sit ĩ
om̃iloco	om̃i loco
.⁊ĩodoremunguentoꝝip̃i᷒.i.	.⁊ ĩ odorem unguentoꝝ ip̃i᷒ . i .
bonoꝝoꝑmcurrãt.quisalutiꝓximoꝝꝮgaudentes.inalienis	bonoꝝ oꝑm currãt . qui saluti ꝓximoꝝ Ꝯgaudentes . inalienis
uirtutib;delectant᷑	uirtutib ; delectant᷑
:⁊isqͥexadũsoest	:⁊ is qͥ ex adũso est
.ñhabens	. ñ habens
quidiustep᷒sitobicere:dentib	quid iuste p᷒sit obicere : dentib
;suisfremens⁊tabescens.meritoꝮfundat᷑.uñ	; suis fremens ⁊ tabescens . merito Ꝯfundat᷑ . uñ
beatuspetrusĩ	beatus petrus ĩ
epl̃acanonicaait.cũom̃imodestia⁊	epl̃a canonica ait . cũ om̃i modestia ⁊
timoreꝮscĩamhabentesbonam	timore Ꝯscĩam habentes bonam
:utĩeoꝙdetͣhuntdeuobis.Ꝯfundant᷑	: ut ĩ eo ꝙ detͣhunt de uobis . Ꝯfundant᷑
.quicalũpniant᷑bonamur̃am	. qui calũpniant᷑ bonam ur̃am
ĩxp̃oꝮũsationemauctoritasquoq;⁊scientia:grataquadã	ĩ xp̃o Ꝯũsationem auctoritas quoq ;⁊ scientia : grata quadã
societate.	societate .
inprelatodebentꝮcurrere:auctoritas:ut	in prelato debent Ꝯcurrere : auctoritas : ut
seueradistrictioneculpas	seuera districtione culpas
delinq̃ntiũcorrigat	delinq̃ntiũ corrigat
.scĩa:utlancediscretionis.excessusgrauores	. scĩa : ut lance discretionis . excessus grauores
aleuiorib;discernat	a leuiorib ; discernat
.utiudicarenoũitint̃lepram⁊lepram:⁊qui	. ut iudicare noũit int̃ lepram ⁊ lepram :⁊ qui
medic᷒fc̃sestanimarũ	medic᷒ fc̃s est animarũ
:Ꝯgruasciat	: Ꝯgrua sciat
apponereremediamorbissingl̃orum.	apponere remedia morbis singl̃orum .
legitis.quiainarchadomini.uͥgaerat	legitis . quia in archa domini . uͥga erat
cumtabulis	cum tabulis
testam̃ti.certearchadñi.mensẽsp̃ualis	testam̃ti . certe archa dñi . mens ẽ sp̃ualis
p̃lati.sititaq;	p̃lati . sit itaq ;
ĩarchaista	ĩ archa ista
.uͥga.i	. uͥga . i
.auctoritascorrectionis	. auctoritas correctionis
.cũtabulis	. cũ tabulis
testam̃iti:i	testam̃iti : i
.cũsc̃ia	. cũ sc̃ia
diuinelegis	diuine legis
:utprelatusꝮtrauitiadelinq̃ntium.	: ut prelatus Ꝯtra uitia delinq̃ntium .
zeloiusticiesit	zelo iusticie sit
erect᷒.⁊ꝑsc̃iamscͥpt᷑arum	erect᷒ .⁊ ꝑ sc̃iam scͥpt᷑arum
.ĩpenemoderationenichilominus	. ĩ pene moderatione nichilominus
inueniat᷑discretus.nonautẽsolũmodoboñ	in ueniat᷑ discretus . non autẽ solũ modo boñ
inse.s;⁊sollicitumĩgrege	in se . s ;⁊ sollicitum ĩ grege
p̃latumeẽꝮuenit	p̃latum eẽ Ꝯuenit
:nescilicet.timoreul̃gm̃	: ne scilicet . timore ul̃ gm̃
culpassubditoꝝ	culpas subditoꝝ
tacendodissimulet.siquidemquitacet	tacendo dissimulet . siquidem qui tacet
.Ꝯsentire	. Ꝯsentire
uidet᷑:s;potiuszelo	uidet᷑ : s ; potius zelo
phineesaccensus.alegeordinis	phinees accensus . alege ordinis
exorbitantes:seuereĩcrepationispugionetͣnsũberet.	ex orbitantes : seuere ĩ crepationis pugione tͣnsũberet .
alioqͥnmeritopastoris	alioqͥn merito pastoris
nom̃amittit:quitemporale	nom̃ amittit : qui temporale
lucrurmpotius	lucrurm potius
quamsalutemdesideransaĩarum:gregemsibicreditũ	quam salutem desiderans aĩarum : gregem sibi creditũ
ñcustodit.uñꝑezechielem	ñ custodit . uñ ꝑ ezechielem
ꝓph̃amdñsait.uepastorib;	ꝓph̃am dñs ait . ue pastorib ;
quipascuntsemetip̃os:lac	qui pascunt semet ip̃os : lac
Ꝯmedebatis⁊lanisoꝑiebamini.ꝙpingue	Ꝯmedebatis ⁊ lanis oꝑiebamini . ꝙ pingue
eratoccidebatis⁊gregemmeumñpascebatis.legitur	erat occidebatis ⁊ gregem meum ñ pascebatis . legitur
.qͥanato	. qͥa nato
ĩbethleemdomino:pastoreserantinregioneeadem:	ĩ bethleem domino : pastores erant in regione eadem :
uigilantes⁊uigiliasnoctiscustodientessupergregemsuum.sic	uigilantes ⁊ uigilias noctis custodientes super gregem suum . sic
rectoresaĩarũĩ	rectores aĩarũ ĩ
nocte.i.	nocte . i .
ĩtenebrishui᷒uite.supergregemsuumuigilant	ĩ tenebris hui᷒ uite . super gregem suum uigilant
:cumsb̃ditis	: cum sb̃ditis
suoscelestib;scͥpt᷑arumpascuisdiligent̃	suos celestib ; scͥpt᷑arum pascuis diligent̃
enutriunt.⁊contrainsidiasĩmundoꝝsp̃uum.	enutriunt .⁊ contra insidias ĩmundoꝝ sp̃uum .
uidelicetlupoꝝ	uidelicet lupoꝝ
spiritaliũ:ꝑuigili	spiritaliũ : ꝑ uigili
sollertiaseruareꝮtendunt.prudensitaq;pastoruigilet	sollertia seruare Ꝯtendunt . prudens itaq ; pastor uigilet
sibi:uigilet⁊gregi.uigiletetiam	sibi : uigilet ⁊ gregi . uigilet etiam
d̃o.tamqͣmpatͥfamilias	d̃o . tamqͣm patͥfamilias
gregemsibiꝮmittenti.uigilet	gregem sibi Ꝯmittenti . uigilet
sibi:ut	sibi : ut
omiaoꝑasuasollicitacircumspectionedisponat⁊ordinet.uigilet	omia oꝑa sua sollicita circumspectione disponat ⁊ ordinet . uigilet
gregi:utmorebonidispensatoris.ũbumuite	gregi : ut more boni dispensatoris . ũbum uite
subditissuisĩtemporesubministret.uigiletetiamdeo:	subditis suis ĩtem pore subministret . uigilet etiam deo :
uttamꝓsuis	ut tam ꝓ suis
qͣmꝓsuoꝝexcessib;.	qͣm ꝓ suoꝝ excessib ;.
sollicitareñcesset.hoc	sollicitare ñ cesset . hoc
estquoddñsait.ineuͣngl̃io.uidete	est quod dñs ait . in euͣngl̃io . uidete
.uigilate⁊orate.uidete	. uigilate ⁊ orate . uidete
uobis:uigilatesubditis.⁊orate.nescilicet.	uobis : uigilate subditis .⁊ orate . ne scilicet .
ĩtemptatione	ĩ temptatione
deficiatis.Etattendite.	deficiatis . Et attendite .
qꝛsaluatornr̃uerusaĩarũmedicus.nonsolum	qꝛ saluator nr̃ uerus aĩarũ medicus . non solum
uigiliasnobisĩiungit.s;⁊eas	uigilias nobis ĩiungit . s ;⁊ eas
aptissimeor̃oniꝮiungitdicens.uigilate⁊orate:qꝛ	aptissime or̃oni Ꝯiungit dicens . uigilate ⁊ orate : qꝛ
nullumtempus	nullum tempus
orationimagisꝮgruit.quamcummensinstantiauigiliarũ	orationi magis Ꝯgruit . quam cum mens instantia uigiliarũ
.astrepituseculi⁊	. astrepitu seculi ⁊
anoxiiscogitationib;fũitabstracta	a noxiis cogitationib ; fũit abstracta
.⁊addesid̃iumpatrie	.⁊ ad desid̃ium patrie
celestis.ꝑstudiũdiuineꝮtẽplationis.fuerit	celestis . ꝑ studiũ diuine Ꝯtẽplationis . fuerit
eleuata.Debetautempastor	eleuata . Debet autem pastor
uigilanssuꝑgregemsuũ.tͥahr̃eãminicl̃a:baculũ	uigilans suꝑ gregem suũ . tͥa hr̃e ãminicl̃a : baculũ
.canem.⁊fistulam.Inbaculo	. canem .⁊ fistulam . In baculo
quep̃latussubditissuisꝮuenienter	que p̃latus subditis suis Ꝯuenienter
debetministrare	debet ministrare
.nedefectureifamiliaris.pͥueturanimus	. ne defectu rei familiaris . pͥuetur animus
fructusacremeditationis.s;tantoliberi᷒diuineꝮtẽplationi	fructu sacre meditationis . s ; tanto liberi᷒ diuine Ꝯtẽplationi
uacareualeat:qͣntominus	uacare ualeat : qͣnto minus
adext̃ioresoccupationes⁊solucitudines	ad ext̃iores occupationes ⁊ solucitudines
seinclinat.propͥumestenim.	se inclinat . propͥum est enim .
ꝑfecticlaustralis.cummariasedereadpedesdomini	ꝑfecti claustralis . cum maria sedere ad pedes domini
.⁊diuinisaurẽp̃bereꝮfiliis:mundih᷒strepit᷒declinare	.⁊ diuinis aurẽ p̃bere Ꝯfiliis : mundi h᷒ strepit᷒ declinare
.mentẽꝑdiũsañ	. mentẽ ꝑ diũsa ñ
nonhabebitrequiem	non habebit requiem
:necocul᷒	: nec ocul᷒
pured̃mintueriꝑmritit᷑.qͥpulũeterreniactus	pure d̃m intueri ꝑmritit᷑ . qͥ pulũe terreni actus
gregisestneceseari᷒	gregis est neceseari᷒
.ip̃eestsermodiuinus.	. ip̃e est sermo diuinus .
quicontraluporummorsusp̃statsecuritatẽ	qui contra luporum morsus p̃stat securitatẽ
:cumꝮtratẽptationũinsult᷒.resistendiministratfortitudinẽ.	: cum Ꝯtra tẽptationũ insult᷒ . resistendi ministrat fortitudinẽ .
h̃taũcanistͥa	h̃t aũ canis tͥa
inse.siqͥdemlatrat:mordet.⁊lĩguamedicinali	in se . siqͥdem latrat : mordet .⁊ lĩgua medicinali
uulñasanat	uulña sanat
.sicdiuinussermo	. sic diuinus sermo
latrat:cumqͣsiclamando	latrat : cum qͣsi clamando
.et̃nasuppliciapecc̃orib	. et̃na supplicia pecc̃orib
;suꝑuenturadenuntiat.uñscͥptumest.	; suꝑuentura denuntiat . uñ scͥptum est .
clamanecesses:quasituba	clama ne cesses : quasi tuba
exaltauocemtuam	exalta uocem tuam
.⁊annuntiappl̃omeopeccata	.⁊ annuntia ppl̃o meo peccata
eoꝝ:⁊domuiiude.	eoꝝ :⁊ domui iude .
sceleraip̃oꝝ.latratetiã	scelera ip̃oꝝ . latrat etiã
.cumꝑũsah̃eticoꝝdogmata.ueritatisassertione.potenter	. cum ꝑũsa h̃eticoꝝ dogmata . ueritatis assertione . potenter
euacuat:⁊ĩuiolatã	euacuat :⁊ ĩ uiolatã
fidĩcatholicefirmitatẽsc̃oꝝpatrũtestimoniis	fidĩ catholice firmitatẽ sc̃oꝝ patrũ testimoniis
corroborat:ūn⁊ip̃ipatres	corroborat : ūn ⁊ ip̃i patres
sc̃i.rectecanesappellatisunt	sc̃i . recte canes appellati sunt
:qꝛcontrahereticoꝝ	: qꝛ contra hereticoꝝ
ꝑfidiam.ualidissimosutitadicamꝓdominolatratusdedert̃	ꝑfidiam . ualidissimos ut ita dicam ꝓ domino latratus dedert̃
.mordetetiamsermodiuinus	. mordet etiam sermo diuinus
.cumuitiarep̃hendit	. cum uitia rep̃hendit
.⁊salutaricastigatiõe.moresreformat⁊instruit	.⁊ salutari castigatiõe . mores reformat ⁊ instruit
:sanataũuulñatactulingue	: sanat aũ uulña tactu lingue
medicinalis:cumcordeꝮtͥtos.	medicinalis : cum corde Ꝯtͥtos .
reficitsp̃ualisdulcedineꝮsolationis.fistulaq̃gregẽpascentẽdemulcet	reficit sp̃ualis dulcedine Ꝯsolationis . fistula q̃ gregẽ pascentẽ demulcet
.estet̃neuiteꝓmiᷤsio	. est et̃ne uite ꝓmiᷤsio
.quecorda	. que corda
fideliũ.int̃nadelectationerefouet:	fideliũ . int̃na delectatione refouet :
queqͥdemnc̃ĩspetenetur.s;postmodũ	que qͥdem nc̃ ĩ spe tenetur . s ; postmodũ
inre:sñ	in re : sñ
finepossidebitur:qñdeusexitom̃iaĩomnib;.	fine possidebitur : qñ deus exit om̃ia ĩ omnib ;.
cũsublatatoti᷒ignorantiecaligine.ꝑfectecognoscem᷒.sicut	cũ sublata toti᷒ ignorantie caligine . ꝑfecte cognoscem᷒ . sicut
⁊cognitisum᷒.uñip̃edominusait.h̃	⁊ cogniti sum᷒ . uñ ip̃e dominus ait . h̃
estuitaet̃nauͭ	est uita et̃na uͭ
cognoscãttesolũuerũd̃m:⁊ꝗ̃misisti	cognoscãt te solũ uerũ d̃m :⁊ ꝗ̃ misisti
ih̃mxp̃m.Iãñcsermoru	ih̃m xp̃m . Iã ñc sermoru
finẽĩponẽtes	finẽ ĩponẽtes
.extͤmãclausulãp̃missi	. extͤmã clausulã p̃missi
capitulibreuit̃ĩtueam᷑.	capituli breuit̃ ĩtueam᷑ .
uͥdr̃.⁊ꝓouib;meis	uͥ dr̃ .⁊ ꝓ ouib ; meis
ponoanimãmeam.Oquamterri	pono animã meam . O quam terri
bileũbum.⁊p̃lato	bile ũbum .⁊ p̃lato
cuilibetaĩarumcuramsuscipienti:	cuilibet aĩarum curam suscipienti :
modisom̃ib;	modis om̃ib ;
attendendũ:utseip̃m	at tendendũ : ut se ip̃m
Ꝯsiderans.uideatsiformamꝑfectionis.queĩcapite	Ꝯsiderans . uideat si formam ꝑfectionis . que ĩ capite
nr̃op̃cessit.ꝓmodulosuo	nr̃o p̃cessit . ꝓ modulo suo
ĩqͣntumualetimitetur.siĩminentegregi	ĩ qͣntum ualet imitetur . si ĩminente gregi
