SainzTiebauzfu	Sainz Tiebauz fu
nezenl'eveschédeTroies;sesperesotnon	nez en l ' evesché de Troies ; ses peres ot non
Ernousetsa	Ernous et sa
mere,Gileetfurentfrançoisetfurentmoltnoblegent	mere , Gile et furent françois et furent molt noble gent
etdegrantlynaige	et de grant lynaige
.ilfunorrizaProvins.SainzTiebauzlievesques	. il fu norriz a Provins . Sainz Tiebauz li evesques
deViennefuoncless'	de Vienne fu oncles s '
aiole.EtporluifuilapelezTiebaut.CilsainzTiebauzdeVienneparloitsouventalameredameGilequimerefu	aiole . Et por lui fu il apelez Tiebaut . Cil sainz Tiebauz de Vienne parloit souvent a la mere dame Gile qui mere fu
cestuiThiebautetaucunefoizlidit:«Aiesjoieetleesceenton	cestui Thiebaut et aucune foiz li dit :« Aies joie et leesce en ton
cuercartuaurasunefillequiaura.i.filquiserademoltgrantmeritedevantDieuetde	cuer car tu auras une fille qui aura . i . fil qui sera de molt grant merite devant Dieu et de
grantlosentreleshomes.»DecesteanonciationquelisainzevesquesfistdesaintTiebautportaentesmoignage(f°CLXV	grant los entre les homes .» De ceste anonciation que li sainz evesques fist de saint Tiebaut porta en tesmoignage ( f ° CLXV
v°cola)unepovrepreudefamevevequivinta	v ° col a ) une povre preudefame veve qui vint a
dameGilequijaestoitençaintedestTiebautetlidit:«Confortetoiet	dame Gile qui ja estoit ençainte de st Tiebaut et li dit :« Conforte toi et
soieslieecartuportesentonventre.i.filquison	soies liee car tu portes en ton ventre . i . fil qui son
lieuauradevantDieuetquigranthonnorferaatozsesparenz	lieu aura devant Dieu et qui grant honnor fera a toz ses parenz
.»LichastiausdeProvinsousainzTiebauzfunorriz,sicomnosavonscidevantdit,est	.» Li chastiaus de Provins ou sainz Tiebauz fu norriz , si com nos avons ci devant dit , est
unlieusouilamoltdegentetfuçaenarriereau	un lieus ou il a molt de gent et fu ça en arriere au
bonconteHuedonquisiresfudeChampaignedecuiparaigessainzTiebauzfunez.Quantilot	bon conte Huedon qui sires fu de Champaigne de cui paraiges sainz Tiebauz fu nez . Quant il ot
passél'aaigedes'enfance,ilnes'acorda	passé l ' aaige de s ' enfance , il ne s ' acorda
pasalavolentédoumonde,ainz	pas a la volenté dou monde , ainz
escotadiligemmentetreçuitlescoumandemenzJhesuCristetpansoitmoutsouventensoncueralasolitaireviedes	escota diligemment et reçuit les coumandemenz Jhesu Crist et pansoit mout souvent en son cuer a la solitaire vie des
ermitesetdesautresquiapresausfurent;ildesirroitvestiraspresrobesetuserdepetitesviandes	ermites et des autres qui apres aus furent ; il desirroit vestir aspres robes et user de petites viandes
en.i.solitairelieu.Unjoravintentrecespansesqu'ilsedeparticeleementdeses	en . i . solitaire lieu . Un jor avint entre ces panses qu ' il se departi celeement de ses
genzetalae.i.hermitequiestoiten	genz et ala e . i . hermite qui estoit en
uneillede	une ille de
Sainneetlidescouvritoutsoncuer.Apresce,par	Sainne et li descouvri tout son cuer . Apres ce , par
leconsoildecelhermite,iletunschevaliers,qui	le consoil de cel hermite , il et uns chevaliers , qui
sescompainzestoitquiGautiersestoitapelez,monterentsorlorchevauxetduiescuieretalerent	ses compainz estoit qui Gautiers estoit apelez , monterent sor lor chevaux et dui escuier et alerent
alacitédeRains.EntelmennieresainzTiebauzquiestoitchevaliersNostreSeignor	a la cité de Rains . En tel menniere sainz Tiebauz qui estoit chevaliers Nostre Seignor
laissaporS'amortouzses	laissa por S ' amor touz ses
palaisetsonpereetsamereetsesfreresetsesparenz	palais et son pere et sa mere et ses freres et ses parenz
etsamaisnieettoutessesrichescesettotlebobantdoumondeets'enalaentelmenniere	et sa maisnie et toutes ses richesces et tot le bobant dou monde et s ' en ala en tel menniere
avocsoncompaignon.QuantilvindrentaRains,etilfurenthebergiédallezsaintRemi,ilquistrentachoisondeviseterl'	avoc son compaignon . Quant il vindrent a Rains , et il furent hebergié dallez saint Remi , il quistrent achoison de viseter l '
eglyseetlaisserentlorescuiersetlorchevausetissirent	eglyse et laisserent lor escuiers et lor chevaus et issirent
toutapiédelorosteletproposerentqu'iliroientapiéfairelorpeneance.Endementiersqu'ils'en	tout a pié de lor ostel et proposerent qu ' il iroient a pié faire lor peneance . Endementiers qu ' il s ' en
aloientilencontrerent.i.pelerinsetlordonnerentlorrichesrobesetsevestirentdelorpovres;etpuis	aloient il encontrerent . i . pelerins et lor donnerent lor riches robes et se vestirent de lor povres ; et puis
s'endepartirenttuitnupiéetalerentde	s ' en departirent tuit nu pié et alerent de
jorenjortantqu'ilvindrentenAlemaigne.Lademourerentil	jor en jor tant qu ' il vindrent en Alemaigne . La demourerent il
moltlonctensetsoffrirentdelorproprevolentégranzpovretezporl	molt lonc tens et soffrirent de lor propre volenté granz povretez por l
'amordeJhesuCristetsoffrirent(col.b)granztravauspor	' amor de Jhesu Crist et soffrirent ( col . b ) granz travaus por
lorvies.Ilportoientpierresalorcous,ilfauchoientlesprez,	lor vies . Il portoient pierres a lor cous , il fauchoient les prez ,
ilcuroientlesestables.Ala	il curoient les estables . A la
parfinilfirentcharbonetentelmennieregaaignoit	parfin il firent charbon et en tel menniere gaaignoit
povrementlorviesetgardoientcequ'ilpooientgaaignierporalerempelerinaigeasaintJaquesenGaliceUnpoudetensapres	povrement lor vies et gardoient ce qu ' il pooient gaaignier por aler em pelerinaige a saint Jaques en Galice Un pou de tens apres
ilfirentlorpelerinaigetuitdeschauz.Quantilrevenoient,lideaubless'aparut	il firent lor pelerinaige tuit deschauz . Quant il revenoient , li deaubles s ' aparut
aausensemblanced'omeetalacosteacostede	a aus en semblance d ' ome et ala coste a coste de
saintTiebautetselaissacheoirdevantluitouzestenduzetentelmennierelisainzcheïparmiluietreclamalenom	saint Tiebaut et se laissa cheoir devant lui touz estenduz et en tel menniere li sainz cheï parmi lui et reclama le nom
JhesuCristetsegarni	Jhesu Crist et se garni
dousignedelacroizetmaintenantlideaubless'esvanui.	dou signe de la croiz et maintenant li deaubles s ' esvanui .
AprescezchosessainzTiebauzrevintaTrievesenAlemaigneettrouvasonpere,jasoitcequebelnelifust	Apres cez choses sainz Tiebauz revint a Trieves en Alemaigne et trouva son pere , ja soit ce que bel ne li fust
pasdeceletroeve..I.	pas de cele troeve .. I .
pouapressainzTiebauzsedepartidelaetalaaRoume.Etporcequ'ilavoitdesirrier	pou apres sainz Tiebauz se departi de la et ala a Roume . Et por ce qu ' il avoit desirrier
deveoirlesepucreNostreSeignor,ils'enalaenVeniceetpuisenLombardieettrova	de veoir le sepucre Nostre Seignor , il s ' en ala en Venice et puis en Lombardie et trova
laentor.i.lieuc'	la entor . i . lieu c '
omapeloitSalins.Ilregardale	om apeloit Salins . Il regarda le
lieuettrovaparlavolontédeDieuunegrantplaceet	lieu et trova par la volonté de Dieu une grant place et
enceleplacelesmursausicomd'uneviezeglyseetlademouraaprescequ'ilot	en cele place les murs ausi com d ' une viez eglyse et la demoura apres ce qu ' il ot
soncorstravailliéenmaintpelerinaigeetfisttantenverslesseigneursdoulieuqueon	son cors travaillié en maint pelerinaige et fist tant envers les seigneurs dou lieu que on
lidonnalaplace.Etlorsfistune	li donna la place . Et lors fist une
petitemesonneteetlahabitaetmenasaintevieparlonctens.Premierementilfistabstinencedechar,apresilnemanjane	petite mesonnete et la habita et mena sainte vie par lonc tens . Premierement il fist abstinence de char , apres il ne manja ne
nebutforsquepaind'orgeetaigue	ne but fors que pain d ' orge et aigue
.Alaparfinilnemanjanebutforsquefruitetherbes	. A la parfin il ne manja ne but fors que fruit et herbes
etracines.Entelmenniereilvesquilonctens	et racines . En tel menniere il vesqui lonc tens
ettoutades	et tout ades
vestilahaireempressachar.QuantNostreSiresvitqu'ilmontoitsi	vesti la haire empres sa char . Quant Nostre Sires vit qu ' il montoit si
devertuenvertu,ilvoltqu'ilmontastjusqu'ala	de vertu en vertu , il volt qu ' il montast jusqu ' a la
dignitédeprovoireetilsifist	dignité de provoire et il si fist
comDiexl'avoitporveu.Apresceil	com Diex l ' avoit porveu . Apres ce il
fistmoltdediversespeneancesenlesquiexilnedormipas	fist molt de diverses peneances en les quiex il ne dormi pas
engisantmesenseant.Etcestechosefaisoitilsisoutilmentqu'ilsecouchoitensonlitdevantcezqui	en gisant mes en seant . Et ceste chose faisoit il si soutilment qu ' il se couchoit en son lit devant cez qui
leservoientetsecouvroitbien.Etquantilestoientcouchié,il	le servoient et se couvroit bien . Et quant il estoient couchié , il
selevoitisnellementetsemetoitenoroisonsagenoxetamainsjointesporluietportoutes'	se levoit isnellement et se metoit en oroisons a genox et a mains jointes por lui et por toute s '
églyseEtquantilvenoital'euredematines,il	églyse Et quant il venoit a l ' eure de matines , il
s'enaloitcouchierensonlitporcequ'ilne	s ' en aloit couchier en son lit por ce qu ' il ne
voloitpasquesamaisnies'enaperceust.Ses	voloit pas que sa maisnie s ' en aperceust . Ses
lizestoitunegranzhuchelargeensamblanced'unegrantcoucheetestoitcouverzdedrasdelin;	liz estoit une granz huche large en samblance d ' une grant couche et estoit couverz de dras de lin ;
etasonchevezavoit.i.	et a son chevez avoit . i .
tronset.	trons et .
i.chapeldelainnequ'ilavoitportéensesvoiaigesporlachalor.Quantilotensi	i . chapel de lainne qu ' il avoit porté en ses voiaiges por la chalor . Quant il ot ensi
travoillésoncorslonguementsorcelehuche,porcequ'ilfeistplusdepeneance,il	travoillé son cors longuement sor cele huche , por ce qu ' il feist plus de peneance , il
mistunehaire	mist une haire
desozsesdrasdelin.Etenlieudequ'ilsoloitgesirsorcellehuche,iljutdes	desoz ses dras de lin . Et en lieu de qu ' il soloit gesir sor celle huche , il jut des
lorsenavanten.i.troncchevé.Quantilot	lors en avant en . i . tronc chevé . Quant il ot
.ii.anzfaitecestepeneance,sescompainzGautiersrandisonesperitaNostreSeigneur,sicomnos	. ii . anz faite ceste peneance , ses compainz Gautiers randi son esperit a Nostre Seigneur , si com nos
creons.SainzTiebauz,apreslamortsoncompaignon,soffri	creons . Sainz Tiebauz , apres la mort son compaignon , soffri
plusorstemptacionsdel'Ennemi.Carentre	plusors temptacions de l ' Ennemi . Car entre
lesautrestemptations,lideaubleslenomaparsonnonetliditunenuitqu'ilse	les autres temptations , li deaubles le noma par son non et li dit une nuit qu ' il se
levastpordirematines.Quant	levast por dire matines . Quant
lisainzs'oïnomer,ilcuidac'unssuensamisl'apelastquipresdeluidemouroit.	li sainz s ' oï nomer , il cuida c ' uns suens amis l ' apelast qui pres de lui demouroit .
Etsialaasacelleettrouvaqu'ilsedormoitetsonhuisbienfermé.Lisainzcognutbienl'	Et si ala a sa celle et trouva qu ' il se dormoit et son huis bien fermé . Li sainz cognut bien l '
escharnissementdoudeable.SireclamalasainteTrinitéetfistsorsoilesignedelacroizetchaçal'Ennemiqui	escharnissement dou deable . Si reclama la sainte Trinité et fist sor soi le signe de la croiz et chaça l ' Ennemi qui
sigrantnoisedemenadevantluienfuiantcomsecefussentcharpentierquiboiscoupassent.Unautretensavintque	si grant noise demena devant lui en fuiant com se ce fussent charpentier qui bois coupassent . Un autre tens avint que
,comsainzTiebauzaloitpreechantetilfumontezsorunecharreteporpasser	, com sainz Tiebauz aloit preechant et il fu montez sor une charrete por passer
uneaigueetporcequ'ilestoitgrevezd	une aigue et por ce qu ' il estoit grevez d
'alerapié,lideaublesostaunedesroesdelacherreteporce	' aler a pié , li deaubles osta une des roes de la cherrete por ce
qu'illevoloit	qu ' il le voloit
fairecheoirenl'aigue,mesilnepotcarlacherretealaaussilegierement	faire cheoir en l ' aigue , mes il ne pot car la cherrete ala aussi legierement
outrecomsecefustuneplume.AprescequesainzTiebauzotsoufertesmaintestemptations,NostreSiresle	outre com se ce fust une plume . Apres ce que sainz Tiebauz ot soufertes maintes temptations , Nostre Sires le
visetaaucunefoizparsesenges,aucunesfoizensamblancedecoulon,aucunefoizensamblanced'ome	viseta aucune foiz par ses enges , aucunes foiz en samblance de coulon , aucune foiz en samblance d ' ome
etplusors(col.b)foizenmoltd'autressamblances.Un	et plusors ( col . b ) foiz en molt d ' autres samblances . Un
joravintquantilplouroitsespechiez,unevoizdescendi	jor avint quant il plouroit ses pechiez , une voiz descendi
doucielquilidit:«Thiebaut,	dou ciel qui li dit :« Thiebaut ,
nepleurepascartipechiétesontpardonné.»	ne pleure pas car ti pechié te sont pardonné .»
Apresavintc'unssuensserjanzestoittormentezd'unetropfortefievreetfissiqu'	Apres avint c ' uns suens serjanz estoit tormentez d ' une trop forte fievre et fis si qu '
ilsambloitqu'ildeustmorir.LimaladesproiasaintTiebaut	il sambloit qu ' il deust morir . Li malades proia saint Tiebaut
qu'ilpriastporluietmaintenantlimaladesquiagrantpainneavoitsouffertqu'enl'aportasta	qu ' il priast por lui et maintenant li malades qui a grant painne avoit souffert qu ' en l ' aportast a
l'églyse,s'enralatouzsainzasonostel.	l ' églyse , s ' en rala touz sainz a son ostel .
Quantlipereset	Quant li peres et
lameresaintTiebautoïrentnovelesdelui,ilvindrentaluiatoutgrantcompaigniedegentixgenzetfurent	la mere saint Tiebaut oïrent noveles de lui , il vindrent a lui atout grant compaignie de gentix genz et furent
moltliéquantilletrouverent.Entrelesjoiesetleslarmesetles	molt lié quant il le trouverent . Entre les joies et les larmes et les
soupirsquelamerefaisoitporsonfilqu'ele	soupirs que la mere faisoit por son fil qu ' ele
avoittrovéet	avoit trové et
porsonpaïsetsesautresenfanzqu'eleavoitlaissié,ellevainquilacharnelamordoumondeets	por son païs et ses autres enfanz qu ' ele avoit laissié , elle vainqui la charnel amor dou monde et s
'acordaal'esperitelamordeDieu,careledemouraavocsaintTiebautsonfileteslutporsesgranzpalais	' acorda a l ' esperitel amor de Dieu , car ele demoura avoc saint Tiebaut son fil et eslut por ses granz palais
unepetitemesonceleetporses	une petite mesoncele et por ses
granzcompaignies.i.lieusolitaireporpeneancefaireetporDieuserviravocsonfil.Sainz	granz compaignies . i . lieu solitaire por peneance faire et por Dieu servir avoc son fil . Sainz
Tiebauzservisameresihumblementqu'apainnesleporroit	Tiebauz servi sa mere si humblement qu ' a painnes le porroit
nusdire.DevantcequesainzTiebauztrespassast,ilditqu'iln'avoitsentitemptation	nus dire . Devant ce que sainz Tiebauz trespassast , il dit qu ' il n ' avoit senti temptation
granttensavoit;etlorsparlavolentédeDieu,sescorsfusisorprisqu'il	grant tens avoit ; et lors par la volenté de Dieu , ses cors fu si sorpris qu ' il
nepooitalernesamainasaboucheporter.Etcestechose	ne pooit aler ne sa main a sa bouche porter . Et ceste chose
faitDiexsoventasesamis,carillesviautensipurgierpartribulation	fait Diex sovent a ses amis , car il les viaut ensi purgier par tribulation
decueretdecors.SainzThiebauznemuaonquesnenechanjasonpropospormaladiequisoncorstravoillast	de cuer et de cors . Sainz Thiebauz ne mua onques ne ne chanja son propos por maladie qui son cors travoillast
qu'iladesnegeunast.Samaladieenforça.IlsotparlavolentédeDieuqu'iltrespasseroitenbrieftens	qu ' il ades ne geunast . Sa maladie enforça . Il sot par la volenté de Dieu qu ' il trespasseroit en brief tens
etselinonça.Ilcoumençaadefaillirdecorsaprescequ'ilotlaissiésompaïsledouziemean	et se li nonça . Il coumença a defaillir de cors apres ce qu ' il ot laissié som païs le douzieme an
,ilfu.iii.anzempelerinaigeet.ix.anzensonhabitacle.Quantil	, il fu . iii . anz em pelerinaige et . ix . anz en son habitacle . Quant il
duttrespasserilmanda.i.abbéquimoutestoitsesfamiliersacuiilcoumandasamereettozsesamisesperitiex	dut trespasser il manda . i . abbé qui mout estoit ses familiers a cui il coumanda sa mere et toz ses amis esperitiex
.Letierz	. Le tierz
jordevant	jor devant
sontrespassement,laterrecrollamoltformentpar.	son trespassement , la terre crolla molt forment par .
v.foiz.Tuitcil	v . foiz . Tuit cil
quiestoienten	qui estoient en
lacellesaintThiebautlesentirentbienetaucunqui	la celle saint Thiebaut le sentirent bien et aucun qui
deforsestoient.SainzTiebauztravilloit	defors estoient . Sainz Tiebauz travilloit
moltcorporelmentensamaladie.Unsdesesbonsamis	molt corporelment en sa maladie . Uns de ses bons amis
ditaceusquilaestoientqu'ilsedepartissentd'illuecetaucuns'en	dit a ceus qui la estoient qu ' il se departissent d ' illuec et aucun s ' en
departirent.Quantilfucommeniezilpria	departirent . Quant il fu commeniez il pria
Nostreseigneurpluseursfoizentelmenniere:«BiauSireDiex,aiespitiédetonpueple!»Quantilotcedit,il	Nostre seigneur pluseurs foiz en tel menniere :« Biau Sire Diex , aies pitié de ton pueple !» Quant il ot ce dit , il
randiaNostre	randi a Nostre
Seigneursonesperitetcil	Seigneur son esperit et cil
quiasontrespassementfurenttesmoignentc	qui a son trespassement furent tesmoignent c
'onqueslicorsnemuacoulor.Iltrespassaledarraainjorde	' onques li cors ne mua coulor . Il trespassa le darraain jor de
juingoutensqueHenrislifilzl'empereorHenriregnoit.Quantcildoupaïssorent	juing ou tens que Henris li filz l ' empereor Henri regnoit . Quant cil dou païs sorent
quelisainzestoittrespassez,cildesvilesetdescitezetclercet	que li sainz estoit trespassez , cil des viles et des citez et clerc et
laivindrentauserviceetentrerentparforcela	lai vindrent au service et entrerent par force la
oulisainzcorsgisoit.Lesautres	ou li sainz cors gisoit . Les autres
genzquiestoient	genz qui estoient
remeses,anciennesgens,enfantet	remeses , anciennes gens , enfant et
pueclesvindrent.	puecles vindrent .
ii.liesencontrelesaintcors,jusqu'a.i.lieuqu'	ii . lies encontre le saint cors , jusqu ' a . i . lieu qu '
enditalacortaucheminetlase	en dit a la cort au chemin et la se
reposèrentcilquilesaintcorsporterent.Letierzjorapresfulicorsensevelizenl'eglyseNotreDameacuititle	reposèrent cil qui le saint cors porterent . Le tierz jor apres fu li cors enseveliz en l ' eglyse Notre Dame a cui title
ilavoitestéordonnezaprovoire.AprescequelesgenzdoupaïsorentranduasaintTiebaut	il avoit esté ordonnez a provoire . Apres ce que les genz dou païs orent randu a saint Tiebaut
telsepouturecomildurent,Diexvostmoustrerpardiversmiraclesdequelmeritesesserjanzestoit.Domil	tel sepouture com il durent , Diex vost moustrer par divers miracles de quel merite ses serjanz estoit . Dom il
avintque.iii.famesdediverslieusquilorveuesavoientperdueslesrecouvrerentalatombesaint	avint que . iii . fames de divers lieus qui lor veues avoient perdues les recouvrerent a la tombe saint
Tiebaut.Autrefoisavintque.iii.autrespersonnesquimehaignieestoient	Tiebaut . Autre fois avint que . iii . autres personnes qui mehaignie estoient
parmaladiedelormainset	par maladie de lor mains et
delorpiezsiqu'ilnes'enporentaidiervindrentalatombesaintThiebautetparlameritedou	de lor piez si qu ' il ne s ' en porent aidier vindrent a la tombe saint Thiebaut et par la merite dou
saintfurentsennéentierement.EnlaterredeVeniceavoitunefamequilamainavoit	saint furent senné entierement . En la terre de Venice avoit une fame qui la main avoit
sechieeetcontraite;elevintalasepouturesaintTiebautet	sechiee et contraite ; ele vint a la sepouture saint Tiebaut et
fusenneedesamaladiedevanttoutlepueplequilaestoitEntreplusorsmiraclesqueDiexfaisoitporsaint	fu sennee de sa maladie devant tout le pueple qui la estoit Entre plusors miracles que Diex faisoit por saint
Tiebaut,ilvostque	Tiebaut , il vost que
lameritedesonserjantfustseueetnoncieeenlaterredomilavoitesténez	la merite de son serjant fust seue et nonciee en la terre dom il avoit esté nez
etporcevintla.i.hom	et por ce vint la . i . hom
delaterredeChampaignequila	de la terre de Champaigne qui la
clartédesesieuzavoitperdueetlarecouvraparlamerite	clarté de ses ieuz avoit perdue et la recouvra par la merite
dousaint	dou saint
.Unenfes	. Un enfes
quiavoitperdu.i.desesbrazetundesespiezdeparalisiefuameneza	qui avoit perdu . i . de ses braz et un de ses piez de paralisie fu amenez a
latombede	la tombe de
saintTiebautetcomilotfaites'oroisonetplusorautreavoc	saint Tiebaut et com il ot faite s ' oroison et plusor autre avoc
lui,ilse	lui , il se
dreçatouzsainsetrevintensamesonagrantjoie.UnsautreshomdelaterredeLombardieportoit	dreça touz sains et revint en sa meson a grant joie . Uns autres hom de la terre de Lombardie portoit
desaproprevolontésonbrazliédeferetentelmennierefaisoitpeneance.Et	de sa propre volonté son braz lié de fer et en tel menniere faisoit peneance . Et
vintempelerinaigealatombesaintTiebautetcomilveilloital'eglyse,iltendilebrasliédefer	vint em pelerinaige a la tombe saint Tiebaut et com il veilloit a l ' eglyse , il tendi le bras lié de fer
porreleverunechandoillequicheueestoitd'unchandelieraquoil'enlesatachoitdevantle	por relever une chandoille qui cheue estoit d ' un chandelier a quoi l ' en les atachoit devant le
saintetmaintenant,sesbrazfudesliezdouferetsaillililiensloingdeluietfistgrantson.Autrefoizavint	saint et maintenant , ses braz fu desliez dou fer et sailli li liens loing de lui et fist grant son . Autre foiz avint
queunshomdelacitédeToursqui	que uns hom de la cité de Tours qui
Martinsavoitnonetquimenchesdeferportoitestroitesenses.ii.brazparpeneance	Martins avoit non et qui menches de fer portoit estroites en ses . ii . braz par peneance
vintasaintTiebautquantilvivoitetliditquecelepeneancesoffroitporcequ'ilavoit	vint a saint Tiebaut quant il vivoit et li dit que cele peneance soffroit por ce qu ' il avoit
sonfrereocis.EtsainzTiebauzlidit:«Vat'enoutremerausepucreNostreSeignor,	son frere ocis . Et sainz Tiebauz li dit :« Va t ' en outremer au sepucre Nostre Seignor ,
cartuserasdesliesd'undetesbraz.»Cilialaetfudesliezsicomlisainzliotdit.	car tu seras deslies d ' un de tes braz .» Cil i ala et fu desliez si com li sainz li ot dit .
Quantils'enrepairoit,iloïdirequesainzTiebauzestoittrespassez,sien	Quant il s ' en repairoit , il oï dire que sainz Tiebauz estoit trespassez , si en
menamoltgrantdueletvintagranzplorjusqu'a	mena molt grant duel et vint a granz plor jusqu ' a
latombedousaintetliditentelmenniere:«Biausire,tume	la tombe dou saint et li dit en tel menniere :« Biau sire , tu me
coumandasquejealaisseau	coumandas que je alaisse au
saintsepucreNostreSeigneuretrevenisseatoi.Jesuirevenuz,jenet'	saint sepucre Nostre Seigneur et revenisse a toi . Je sui revenuz , je ne t '
aipastrouvé.Las!Queferai-ge?Sire,aiespitiédemoi,confortetonpelerinetdeslie,	ai pas trouvé . Las ! Que ferai - ge ? Sire , aies pitié de moi , conforte ton pelerin et deslie ,
s'ilteplest.»Quequeil	s ' il te plest .» Que que il
disoitcesparoles,l'autremenchecheidesonbrazetfistgrantson	disoit ces paroles , l ' autre menche chei de son braz et fist grant son
siquemoutdegentlevirentetenfirentgrantjoie.Unshomquiestoitmalades	si que mout de gent le virent et en firent grant joie . Uns hom qui estoit malades
d'ydropisievintalatombesaintTiebautporestrecurez	d ' ydropisie vint a la tombe saint Tiebaut por estre curez
desamaladie,carilestoitmoltdurementetmoltlaidementenflez.Etmaintenantqu'il	de sa maladie , car il estoit molt durement et molt laidement enflez . Et maintenant qu ' il
otfaites'oroisonausaint,toutel'enfleuresedepartidesoncorsetdemouratouzsainsettozhaitiez.	ot faite s ' oroison au saint , toute l ' enfleure se departi de son cors et demoura touz sains et toz haitiez .
Cestmiraclesetplusorsautrequicinesontpastouchié	Cest miracles et plusors autre qui ci ne sont pas touchié
fistNostre	fist Nostre
SiresporsaintTiebaut	Sires por saint Tiebaut
QVantlirois	QVant li rois
fumostier,etiluitque	fu mostier , et il uit que
lancelotfuuenuzetilotameneboortetlionelsilorfetmoutgrantioie,etdistque	lancelot fu uenuz et il ot amene boort et lionel si lor fet mout grant ioie , et dist que
biensoientiluenuz,etlafestecomenceparlaienzgrantetmerueilleuse,carmoutsontliezli	bien soient il uenuz , et la feste comence par laienz grant et merueilleuse , car mout sont liez li
compaignondelatablereondede	compaignon de la table reonde de
lauenueas.ii.freres,etmesSiresGauuainslordemandecomentill'ontpuisfetqueil	la uenue as . ii . freres , et mes Sires Gauuains lor demande coment il l ' ont puis fet que il
separtirentde	se partirent de
cort,etildientbiendieumerci,carilonttoziorz	cort , et il dient bien dieu merci , car il ont toz iorz
estesainzethaitiez.CertesfetmessiresGauuainscemeplest	este sainz et haitiez . Certes fet mes sires Gauuains ce me plest
mout.GRanzestla	mout . GRanz est la
ioiequecildelacortfontaboortetalionel,carpiecamesqu'ilnesauoientueuz,et	ioie que cil de la cort font a boort et a lionel , car pieca mes qu ' il nes auoient ueuz , et
liroiscomandequelestablessoientmises,carilesttensdemengierceli	li rois comande que les tables soient mises , car il est tens de mengier ce li
estauisSirefait	est auis Sire fait
Keuliseneschauxseuosasseeziaaudisnerilm'estauisqueuosenfraindroizlacostumedeceainz	Keu li seneschaux se uos asseez ia au disner il m ' est auis que uos enfraindroiz la costume de ceainz
,carnosauons	, car nos auons
ueutoziorz	ueu toz iorz
queuosahaute	que uos a haute
festen'asseiez	feste n ' asseiez
atabledeuantqueaucuneauenturefustenuostrecortauenueuoianttozlesbaronsdeuostre	a table deuant que aucune auenture fust en uostre cort auenue uoiant toz les barons de uostre
ostel.CertesfetliroisKeuuosditesuoir,cestecostumeaiie	ostel . Certes fet li rois Keu uos dites uoir , ceste costume ai ie
toziorztenueet	toz iorz tenue et
latendraitantcomieporrai,mesieauoiesi	la tendrai tant com ie porrai , mes ie auoie si
grantioiedelancelotetdesescousinsquiestoientuenuacortsain	grant ioie de lancelot et de ses cousins qui estoient uenu a cort sain
ethaitiequ'ilnemesouenoitdelacostume,oruosensouuiegnefetKeuENdementres	et haitie qu ' il ne me souenoit de la costume , or uos en souuiegne fet Keu ENdementres
qu'ilparloienteinsisientralaienzunsuaslezqui	qu ' il parloient einsi si entra laienz uns uaslez qui
distauroi.Sirenouelesuosaportmoutmerueilleuses.Quelesfetlirois.	dist au roi . Sire noueles uos aport mout merueilleuses . Queles fet li rois .
Diteslesmoitost.Sirelaaualdesozuostrepalesa.i	Dites les moi tost . Sire la aual desoz uostre pales a . i
.perrongrantqueieaiueufloter	. perron grant que ie ai ueu floter
pardesusl'eue,venezleueoir,cariesaibienqueceestauenturemerueilleuse,	par desus l ' eue , venez le ueoir , car ie sai bien que ce est auenture merueilleuse ,
etliroisdescentmaintenantporceste	et li rois descent maintenant por ceste
auentureueoir,etsifonttuitliautre,etquantilsontuenuzalariuesitroeuentle	auenture ueoir , et si font tuit li autre , et quant il sont uenuz a la riue si troeuent le
perronquiestoituenuzariueetissuzhorsdel'eue,etestoitdemarbreuermeil,etouperronestoitune	perron qui estoit uenuz a riue et issuz hors de l ' eue , et estoit de marbre uermeil , et ou perron estoit une
espeefichieequimoutestoitbeleet	espee fichiee qui mout estoit bele et
richeparsemblant,etenestoitliponzd'	riche par semblant , et en estoit li ponz d '
unepierreprecieuseouureza	une pierre precieuse ouurez a
letresd'ormoutsoutilment,etlibaronresgardoientlesletresquidisoientianusnem'osterade	letres d ' or mout soutilment , et li baron resgardoient les letres qui disoient ia nus ne m ' ostera de
cisecilnonaquicosteiependrai,	ci se cil non a qui coste ie pendrai ,
etcilseralimieldreschcheualiesdel	et cil sera li mieldres chcheualies del
monde.Et	monde . Et
quantliroisuoitcesletressidistalancelot,	quant li rois uoit ces letres si dist a lancelot ,
biausirecesteespeeestuostreparbondroit	biau sire ceste espee est uostre par bon droit
,cariesaibienqueuosesteslimieldrescheualiersdoumonde,etilresponttozcorrouciez.Certessireneelen	, car ie sai bien que uos estes li mieldres cheualiers dou monde , et il respont toz corrouciez . Certes sire ne ele n
'estmoieneien'auroielecoragedemetreimain,nehardement,carienesuimie	' est moie ne ie n ' auroie le corage de metre i main , ne hardement , car ie ne sui mie
dignesnesoffisanzqueieladoieprendre,etporcem'entendraiienen'imetraiia	dignes ne soffisanz que ie la doie prendre , et por ce m ' en tendrai ie ne n ' i metrai ia
lamain,carce	la main , car ce
seroitfolieseietendoieaauoir	seroit folie se ie tendoie a auoir
la,toutesuoiesfetliroisiessaierezuosseuoslaporriezoster.Sirefetilnonferai.Cariesai	la , toutes uoies fet li rois i essaierez uos se uos la porriez oster . Sire fet il non ferai . Car ie sai
bienquenusn'iessaieraiaporquoiilifaille	bien que nus n ' i essaiera ia por quoi il i faille
qu'iln'enrecoiueplaie.Etquesauezuosfetlirois	qu ' il n ' en recoiue plaie . Et que sauez uos fet li rois
.Sirefaitilielesaibien,et	. Sire fait il ie le sai bien , et
encoruosdiraiieautrechose,carieuoilqueuossachiez	encor uos dirai ie autre chose , car ie uoil que uos sachiez
qu'encest	qu ' en cest
iord'uicomencerontlesgranzauenturesetlesgranzmerueillesdousaintGraal	ior d ' ui comenceront les granz auentures et les granz merueilles dou saint Graal
.Quantliroisotquelancelotn'	. Quant li rois ot que lancelot n '
enferaplussidistamonSeignorGauuainbiaxniesessaiezi.Sirefaitilsauueuostre	en fera plus si dist a mon Seignor Gauuain biax nies essaiez i . Sire fait il sauue uostre
gracenonferepuisquemessireslancelotn	grace non fere puis que mes sires lancelot n
'iueltessaierg'	' i uelt essaier g '
imetroielamainpornoientcarcesauezuosbienqu'ilest	i metroie la main por noient car ce sauez uos bien qu ' il est
assezmieldres	assez mieldres
cheualiersdemoi,touteuoiesfaitliroisiessaieroizuosporcece	cheualiers de moi , touteuoies fait li rois i essaieroiz uos porce ce
queieleuoil.Nemieporl'espeeauoiretilgitelamainnetprentl'espeeparleheut	que ie le uoil . Ne mie por l ' espee auoir et il gite la mainn et prent l ' espee par le heut
etsache,mesilnelapuettrerefors,et	et sache , mes il ne la puet trere fors , et
liroislidist	li rois li dist
maintenant,biauxnies	maintenant , biaux nies
lessiezester,carbienauezfetmoncomandement.MesSiresGauuainsfetlancelotorsachiezquecesteespeeuostoucheraencoreside	lessiez ester , car bien auez fet mon comandement . Mes Sires Gauuains fet lancelot or sachiez que ceste espee uos touchera encore si de
presqueuosnelauoldriezauoirbaillieepor	pres que uos ne la uoldriez auoir bailliee por
unchastel.SirefetmessiresGauuainien'enpoimes.Seieen	un chastel . Sire fet mes sires Gauuain ie n ' en poi mes . Se ie en
deusseorendroitmorirsilefeisseieporlauolentemonSeignoracomplir.Etquantli	deusse orendroit morir si le feisse ie por la uolente mon Seignor acomplir . Et quant li
roisotcesteparolesiserepentdecequemesSiresGauuainsafet.Etlors	rois ot ceste parole si se repent de ce que mes Sires Gauuains a fet . Et lors
distaperceualqu'ilessaital'espee,etildistquesifera	dist a perceual qu ' il essait a l ' espee , et il dist que si fera
iluolentiersporfereamonSeignorGauuaincompaignie.Simetlamainal'espeeettretmesilnela	il uolentiers por fere a mon Seignor Gauuain compaignie . Si met la main a l ' espee et tret mes il ne la
puetauoir,etlorscroientbientuitcildelaplace	puet auoir , et lors croient bien tuit cil de la place
quelancelotdieuoir,etlesletresdoupontqueilsoientueraies	que lancelot die uoir , et les letres dou pont que il soient ueraies
.Sin'iamessi	. Si n ' i a mes si
hardiquimainiosastmetre,etmesSiresKeudist	hardi qui main i osast metre , et mes Sires Keu dist
auroi.Sire	au roi . Sire
sireparmonchief	sire par mon chief
orpoezuosseurementasseoiraudisnerquantuosplaira,caraauenturen'auezuospasfaillideuantmengierceme	or poez uos seurement asseoir au disner quant uos plaira , car a auenture n ' auez uos pas failli deuant mengier ce me
semble,alonsdoncfetlirois,carausintenestilbientens.Etlorss	semble , alons donc fet li rois , car ausint en est il bien tens . Et lors s
'enuontlicheualieretlaissentleperronalariue	' en uont li cheualier et laissent le perron a la riue
,etliroisfetl'eue	, et li rois fet l ' eue
cornersis'asietensonhautdois,et	corner si s ' asiet en son haut dois , et
licompaignondelatablereondes'asieentchascunensonleu.Celuiior	li compaignon de la table reonde s ' asieent chascun en son leu . Celui ior
seruirentlaienz.iiii.roituitcoronne,etauecauxtantdehauzhomesqueamerueilleslespoistlentenir	seruirent laienz . iiii . roi tuit coronne , et auec aux tant de hauz homes que a merueilles les poist len tenir
.Celuiiorfuassisliroisasonhautdoisoupales,	. Celui ior fu assis li rois a son haut dois ou pales ,
etotaluiseruirgrantcompaigniedehauzbarons.Siauinteinsintquantilsefurent	et ot a lui seruir grant compaignie de hauz barons . Si auint einsint quant il se furent
tuitassisparlaienzqu'iltrouerentque	tuit assis par laienz qu ' il trouerent que
tuitlicompaignondelatablereondefurentuenu,etlisiegeempli,forssolementcilquelenapeloitsiegeperilleux.	tuit li compaignon de la table reonde furent uenu , et li siege empli , fors solement cil que len apeloit siege perilleux .
Quantilorenteulepremiermessilorauintsimerueilleuseauenturequetuitlihuisdoupalaisouil	Quant il orent eu le premier mes si lor auint si merueilleuse auenture que tuit li huis dou palais ou il
menioient,etles	menioient , et les
fenestresclostrentparelesentelmanierequenus	fenestres clostrent par eles en tel maniere que nus
n'imistlamain,et	n ' i mist la main , et
neporquantlasalenefupasennuble,etdecestechosefurentesbahizlifoletlisage,etli	neporquant la sale ne fu pas ennuble , et de ceste chose furent esbahiz li fol et li sage , et li
roisartusquipremiersparladistpardieubiauseignornosauonshuiueuesmerueillesetci	rois artus qui premiers parla dist par dieu biau seignor nos auons hui ueues merueilles et ci
etalariue	et a la riue
,mesiecuitquenoslesuerronsencoranuitgreignorsquecestesnesont.	, mes ie cuit que nos les uerrons encor anuit greignors que cestes ne sont .
Endementresqueliroisparloiteinsisi	Endementres que li rois parloit einsi si
entralaienz.i.preudomauneblancherobeuielzetanciens,	entra laienz . i . preudom a une blanche robe uielz et anciens ,
mesiln'otcheualierlaienzquiseustparou	mes il n ' ot cheualier laienz qui seust par ou
ilientra,etlipreudonsuenoitapieetamenoitparlamain.i.cheualier	il i entra , et li preudons uenoit a pie et amenoit par la main . i . cheualier
aunesarmesuermeillessanzespee	a unes armes uermeilles sanz espee
etsanzescu,sidistausitostcomilfuenmilepalaispessoitauos,etapres	et sanz escu , si dist ausi tost com il fu enmi le palais pes soit a uos , et apres
distauroilaouilleuoit.Roisartus	dist au roi la ou il le uoit . Rois artus
get'amoignlecheualier	ge t ' amoign le cheualier
desirre,celuiquiestestrezdouhautlignageleroidauid,etdouparenteiosephd'arimacie,celui	desirre , celui qui est estrez dou haut lignage le roi dauid , et dou parente ioseph d ' arimacie , celui
parquilesmerueillesdecestpaiset	par qui les merueilles de cest pais et
desestrangesterresremaindront.Veezleci.Etliroisestmoutliezdecestenouele,sidistau	des estranges terres remaindront . Veez le ci . Et li rois est mout liez de ceste nouele , si dist au
preudomesirebiensoiezuosuenuzsecesteparoleest	preudome sire bien soiez uos uenuz se ceste parole est
ueraie,etbiensoitlicheualiersuenuz,carseceestcilquenosatendonsaacheuer	ueraie , et bien soit li cheualiers uenuz , car se ce est cil que nos atendons a acheuer
lesauenturesdousaintGraalonquessigrantioienefufaited'omecomenosferonsde	les auentures dou saint Graal onques si grant ioie ne fu faite d ' ome come nos ferons de
lui.Etquiqueilsoitoucilqueuosditesouautres:ieuoldroiequebien	lui . Et qui que il soit ou cil que uos dites ou autres : ie uoldroie que bien
liuenistporcequ'ilestsigentishonsetdesihautlignagecomeuosdites,Parfoifait	li uenist por ce qu ' il est si gentis hons et de si haut lignage come uos dites , Par foi fait
lipreudons	li preudons
uosenuerroizpartenstelcomencementquibelsera,etlorsfetlechcheualier	uos en uerroiz par tens tel comencement qui bel sera , et lors fet le chcheualier
tostdesarmersi	tost desarmer si
remestenunecotedecendaluermeil,etillia	remest en une cote de cendal uermeil , et il li a
bailliemaintenantunmanteluermeilaafublerqu'ilportoitsozs'espauletoutdesamitetpardedenzestoit	baillie maintenant un mantel uermeil a afubler qu ' il portoit soz s ' espaule tout de samit et par dedenz estoit
forrezd'unblanchermine.Qvantill'auestuetapareilliesilidist,	forrez d ' un blanc hermine . Qvant il l ' a uestu et apareillie si li dist ,
siuezmoisirecheualiers,etilsifet,etillemoinetotdroitausiegeperilleuxdelez	siuez moi sire cheualiers , et il si fet , et il le moine tot droit au siege perilleux delez
quoiLancelotseseoit,etsozlieueledrapdesoiequeciliauoientmis.	quoi Lancelot se seoit , et sozlieue le drap de soie que cil i auoient mis .
Sitroeue	Si troeue
lesletresquidient.CiestlisiegesGalaad	les letres qui dient . Ci est li sieges Galaad
.Etlipreudons	. Et li preudons
resgardelesletressilestroeuenouelementescritesceliestauis,etilconoistle	resgarde les letres si les troeue nouelement escrites ce li est auis , et il conoist le
non.Silidistsienhautquetuitcildelaienzl	non . Si li dist si en haut que tuit cil de laienz l
'oient.Sirecheualiersasseezuosci,carcistleuxestuostre.Etcils'asiettoutseurement	' oient . Sire cheualiers asseez uos ci , car cist leux est uostre . Et cil s ' asiet tout seurement
,etdistaupreudomeoruosempoezraler,	, et dist au preudome or uos em poez raler ,
carbienauezfetcequelenuoscomanda,etsaluezmoitouzcels	car bien auez fet ce que len uos comanda , et saluez moi touz cels
dousaintostel,	dou saint ostel ,
etmononcleleroipelles,etmonaiollericheroipescheor,etlorditesdeparmoiqueielesire	et mon oncle le roi pelles , et mon aiol le riche roi pescheor , et lor dites de par moi que ie les ire
ueoirauplustostqueieporraietqueieenaurailoisir.Etlipreudonss'em	ueoir au plus tost que ie porrai et que ie en aurai loisir . Et li preudons s ' em
partdelaienz,etcomandeleroiartusadieu	part de laienz , et comande le roi artus a dieu
,ettozlesautresausi,etquantlenli	, et toz les autres ausi , et quant len li
uoltdemanderqui	uolt demander qui
ilestoitiln'entint	il estoit il n ' en tint
onquespletaaus,ainzresponditotplainementque	onques plet a aus , ainz respondi tot plainement que
ilnelordiroitore	il ne lor diroit ore
pas,carillesauroientbienatensseill'osoientdemander	pas , car il le sauroient bien a tens se il l ' osoient demander
.Siuientaumestrehuisdoupalaisquiclosestoit	. Si uient au mestre huis dou palais qui clos estoit
sil'oeure,etdescentenlacortaual,ettroeue	si l ' oeure , et descent en la cort aual , et troeue
cheualiersetescuiersiusqu'a.xv.quil'atendoient,etestoientuenuzo	cheualiers et escuiers iusqu ' a . xv . qui l ' atendoient , et estoient uenuz o
lui.Etilmonteetsepartdelacortentelmanierequ'ilnesorentplusdesonestrea	lui . Et il monte et se part de la cort en tel maniere qu ' il ne sorent plus de son estre a
celefoiz	cele foiz
.Qvantcildelasaleuirentseoirlecheualierousiegequetantpreudomeauoientredoute,etoutantesgranzauentures	. Qvant cil de la sale uirent seoir le cheualier ou siege que tant preudome auoient redoute , et ou tantes granz auentures
estoientauenuesparmaintesfoizsin'iaceluiquin'enait	estoient auenues par maintes foiz si n ' i a celui qui n ' en ait
grantmerueille.Cariluoient	grant merueille . Car il uoient
celuisiiuenehomequ'ilneuoientdongracelipuistestreuenue,secen'est	celui si iuene home qu ' il ne uoient don grace li puist estre uenue , se ce n ' est
delauolentenostreseignor,etlafestecomencegrantparlaienz,	de la uolente nostre seignor , et la feste comence grant par laienz ,
sifonthonoraucheualieret	si font honor au cheualier et
liunetliautre,carbienpensentquecesoitcilparquilesmerueilles	li un et li autre , car bien pensent que ce soit cil par qui les merueilles
dousaintGraaldoiuentfaillir	dou saint Graal doiuent faillir
,etbienleseuentparl'esprouementdousiege,ouonqueshonsnes'estoitassis	, et bien le seuent par l ' esprouement dou siege , ou onques hons ne s ' estoit assis
acuiiln'enfustmeschau,enaucunemanierenemesacestui.Sileseruentet	a cui il n ' en fust meschau , en aucune maniere ne mes a cestui . Si le seruent et
honorentdequanqu'ilpueent,comeceluiqu'iltiennetamestreetaseignorpardesuscelsde	honorent de quan qu ' il pueent , come celui qu ' il tiennet a mestre et a seignor par desus cels de
latablereonde.Etlancelotquimoutuolentiersleresgardoitporlamerueillequ'	la table reonde . Et lancelot qui mout uolentiers le resgardoit por la merueille qu '
ilenaconoistqueceestoitcilqueilahuifetcheualiernouel.Si	il en a conoist que ce estoit cil que il a hui fet cheualier nouel . Si
enamoutgrantioie,etporcelifet	en a mout grant ioie , et por ce li fet
illagreignorhonorqu'ilpuet,etlemetenparolesdemainteschoses	il la greignor honor qu ' il puet , et le met en paroles de maintes choses
,etlidemande	, et li demande
desonestrequ'ill'endiedesonestrequ	de son estre qu ' il l ' en die de son estre qu
'ill'endie	' il l ' en die
aucunechose,etcilquiauquesleconoistnel'oserefuser.Sirespontmaintesfoizacequ	aucune chose , et cil qui auques le conoist ne l ' ose refuser . Si respont maintes foiz a ce qu
'illidemande.Mesboorzquitantestliezquenusplus,et	' il li demande . Mes boorz qui tant est liez que nus plus , et
quibienconoistqueceestGalaadlefilzlancelot,cilquidoitlesauenturesmenerachiefparole	qui bien conoist que ce est Galaad le filz lancelot , cil qui doit les auentures mener a chief parole
alionelsonfrere,etlidist	a lionel son frere , et li dist
biaufreresauezuosquicistcheualiersestquisietousiegeperilleux	biau frere sauez uos qui cist cheualiers est qui siet ou siege perilleux
.Jenelsaimiebienfetlionel.Mestant	. Je nel sai mie bien fet lionel . Mes tant
queceestcilquiaestehuifetcheualiernouel,quemessireslancelotfistcheualierdesamain,	que ce est cil qui a este hui fet cheualier nouel , que mes sires lancelot fist cheualier de sa main ,
etceestcildoncentreuosetmoiauonstoteiorparleque	et ce est cil donc entre uos et moi auons tote ior parle que
messireslancelot	mes sires lancelot
engendra,enlafilleauricheroipescheor.	engendra , en la fille au riche roi pescheor .
Veraiementle	Veraiement le
sachiezuos	sachiez uos
fetboortqueceestil,etqu'ilestnostrecousinsprochains.Etdecesteauenture	fet boort que ce est il , et qu ' il est nostre cousins prochains . Et de ceste auenture
deuonsnosestremoltliez,carcen'	deuons nos estre molt liez , car ce n '
estmiedoutequ'ilneuiegneencoragreignorchosequecheualierqueieonquesconeusse,si	est mie doute qu ' il ne uiegne encor a greignor chose que cheualier que ie onques coneusse , si
enaiabelcomencement.	en a ia bel comencement .
HoravosdicveraraizundeJesuChristipassiun:lossosaffanzvol	Hora vos dic vera raizun de Jesu Christi passiun : los sos affanz vol
remembrarperquecestmundtotasalvad.Trentatresanz	remembrar per que cest mund tot a salvad . Trenta tres anz
etalquesplus,des	et alques plus , des
quecarnpres,interrafu.PertotobredqueverusDeus,pertotsostegquehomcarnels.	que carn pres , in terra fu . Per tot obred que verus Deus , per tot sosteg que hom carnels .
Peccadnegununquenonfiz,per	Peccad negun unque non fiz , per
epslosnostresfuaucis	eps los nostres fu aucis
.Lasuamorzvidanosrend,sapassiunstoznosredenps.Cumaproismed	. La sua morz vida nos rend , sa passiuns toz nos redenps . Cum aproismed
sapassiuns-chofunostraredemptions-,aproismervol	sa passiuns - cho fu nostra redemptions -, aproismer vol
alaciutat:afanzpernossustegmultgranz.CumelperveingaBetfage-	a la ciutat : afanz per nos susteg mult granz . Cum el perveing a Betfage -
vil'esdesozmontOlivet-,avantdelssosdosenveied,unasneadducere	vil ' es desoz mont Olivet -, avant dels sos dos enveied , un asne adducere
seroved.Cumcelasnezfuamenaz,delormantelzbenl'antparad:delormantelz,delor	se roved . Cum cel asnez fu amenaz , de lor mantelz ben l ' ant parad : de lor mantelz , de lor
vestitbenliaprestuntoss'assis.PersuagrandhumilitadJesus	vestit ben li aprestunt oss ' assis . Per sua grand humilitad Jesus
rexmagnessusmonted	rex magnes sus monted
,sicumprophetesanzmulzdiscantedaveiendeJesuCrist.Anzpetizdisquechofus	, si cum prophetes anz mulz dis canted aveien de Jesu Crist . Anz petiz dis que cho fus
fait,JesusloLazersuscitat,chiquatredisenmonimentjagudaveietozpudenz.Cumcoaudidtota	fait , Jesus lo Lazer suscitat , chi quatre dis en moniment jagud aveie toz pudenz . Cum co audid tota
lagent,queJesusve,loreispodenz,chiepslomorzfaiserevivere,agrandhonorencontra	la gent , que Jesus ve , lo reis podenz , chi eps lo morz fai se revivere , a grand honor encontra
'xirent.Alquantdelspalmesprendentrames,delsoliversalquantlasbranches;encontr'alreiqui	' xirent . Alquant dels palmes prendent rames , dels olivers alquant las branches ; encontr ' al rei qui
fezlocel,issidlodilepopleslez.Cantenligranelipetit:"	fez lo cel , issid lo di le poples lez . Canten li gran e li petit :"
FiliDavit,filiDavit|"Palis	Fili Davit , fili Davit |" Palis
,vestit,palis,mantenlsdavantextendent	, vestit , palis , mantenls davant extendent
assospez.Granfolesaredre,grandavan:grane	assos pez . Gran foles aredre , gran davan : gran e
petitDeuvanlaudant.Ensobretotpetizenfanosannasempervanclamant.Alaciptadcumaproismet,etel	petit Deu van laudant . Ensobre tot petiz enfan osanna semper van clamant . A la ciptad cum aproismet , et el
lavidella'sgarded,desonpiucorgreususpiret,dessossanzolzfortlagrimez."Hjerussalem,	la vid ella ' sgarded , de son piu cor greu suspiret , dessos sanz olz fort lagrimez ." Hjerussalem ,
Hjerussalem,gaite-disel-pertospechet|Pensarnonpoz,pensar	Hjerussalem , gai te - dis el - per tos pechet | Pensar non poz , pensar
nolvols;nont'opermettosgranz	nol vols ; non t ' o permet tos granz
orgolz.Venrantlian,venrantlidiquett'asaldrantoiinimic;iltotentornt'arberjaranet	orgolz . Venrant li an , venrant li di quett ' asaldran toi inimic ; il tot entorn t ' arberjaran et
aterracrebantaran.Lostosenfanzquiinte	a terra crebantaran . Los tos enfanz qui in te
sunt,amalespenasaucidront;entosbelzmurs	sunt , a males penas aucidront ; en tos belz murs
,entasmaisonspedrassubr'altrenonlaiseront.Litoicaitiupertotasgenzmenad	, en tas maisons pedrassubr ' altre non laiseront . Li toi caitiu per totas genz menad
enerenatormenz,quareutefiz,numcognoguist	en eren a tormenz , quar eu te fiz , num cognoguist
,salvarteving,numreceubist."Cumchoag	, salvar te ving , num receubist ." Cum cho ag
ditetpercoidat,entemplumDeusemperintret.	dit et percoidat , en templum Deu semper intret .
Losmarchedantquaeintrobed,agranddestreitforslosgitez	Los marchedant quae introbed , a grand destreit fors los gitez
.LossostalanttafortmonstredquegrantpavorspresalsJudeus;dedobplacordalzvaifirend,totlormarchedvaidesfazend	. Los sos talant ta fort monstred que grant pavors pres als Judeus ; de dobpla cordalz vai firend , tot lor marched vai desfazend
.FeloJudeu	. Felo Judeu
cumilchovidren,	cum il cho vidren ,
enzenlorcorsgrandanenvie;permalsconselzvandemandannostresenniorcumtradissant	enz en lor cors grand an envie ; per mals conselz van demandan nostre sennior cum tradissant
.LofelJudesEscariothalsJudeusvengraen	. Lo fel Judes Escarioth als Judeus vengra en
rebost:"Quem'endarezelvos	rebost :" Que m ' en darez el vos
tradrai?Vostrestalenzademplirai."Trentadenersdunclienpromisdrent,sonbon	tradrai ? Vostres talenz ademplirai ." Trenta deners dunc li en promisdrent , son bon
senniorquelotradisse.Sicheramerzvensipetit|Hancnonfudhomqui	sennior que lo tradisse . Si chera merz ven si petit | Hanc non fud hom qui
magisl'audis.EtaceldiquedizenPasches,cumlacenaJesusocfaita,elsus	magis l ' audis . Et a cel di que dizen Pasches , cum la cena Jesus oc faita , el sus
leveddelpiumanjer,assosfedelslavedlisped	leved del piu manjer , assos fedels laved lis ped
.Etperlopanetperlovinfortsaccrament	. Et per lo pan et per lo vin fort saccrament
lorcommandez,perremembrarsapassiun,quefairerovaatrestot.Depanetvinsanctificattot	lor commandez , per remembrar sa passiun , que faire rova a trestot . De pan et vin sanctificat tot
sosfidelsisaciet,maisqueJudesEscharioh,cuiunasopaenfletlocor.Judascumogmanjedla	sos fidels i saciet , mais que Judes Escharioh , cui una sopa enflet lo cor . Judas cum og manjed la
sopa,diablesenenzensagola.Semperleveddelpiumanjer,totalsJudeusovainuncer.Jesuslo	sopa , diable sen enz en sa gola . Semper leved del piu manjer , tot als Judeus o vai nuncer . Jesus lo
bonspersapietadtandulcement	bons per sa pietad tan dulcement
presaparler.SobresonpeizfezcondurmirsantJohan,losoncheramic.Acelsopar	pres a parler . Sobre son peiz fez condurmir sant Johan , lo son cher amic . A cel sopar
unsermonfiz;chicelnonsabtalnonaudid.Contralsafanzquean	un sermon fiz ; chi cel non sab tal non audid . Contrals afanz que an
apadirtozsosfidelsbenengarnid.AlosancPedreperchoindadquecelanoitluineiara;Pedresforments'en	a padir toz sos fidels ben en garnid . Alo sanc Pedre perchoindad que cela noit lui neiara ; Pedres forment s ' en
adunad,perepsamortnolgurpira.ChristusJesusdens	adunad , per epsa mort nol gurpira . Christus Jesus den s
'enleved,Gehsemani-vil'es-n'anez.Tozsosfidelssederrovet,evanorarsolsenanez	' en leved , Gehsemani - vil ' es - n ' anez . Toz sos fidels seder rovet , evan orar sols en anez
.Granzfulidols,fortmarrimenz,sicondormirenttuitades;Jesuscumveg,	. Granz fu li dols , fort marrimenz , si condormirent tuit ades ; Jesus cum veg ,
losesveled,trestozorarbeinlosmanded.Eduncorarcumelanned,si	los esveled , trestoz orar bein los manded . E dunc orar cum el anned , si
fortsudordunquessuded,quecumlosagsaterracurrentde	fort sudor dunques suded , que cum lo sags a terra current de
sasudorlassanctasgutes.	sa sudor las sanctas gutes .
Alsosfidelscumrepadred,tambenlementlosconforted.LifelJudesjas'aproismedabgrancompanniedelsJudeus.	Alsos fidels cum repadred , tam benlement los conforted . Li fel Judes ja s ' aproismed ab gran compannie dels Judeus .
JesuscumvidralosJudeus,zolordemandez:"Quequerent?"Illi	Jesus cum vidra los Judeus , zo lor demandez :" Que querent ?" Il li
respondenttuitadun:"JesumqueremNazarenum|""Eusoiaquel|"zodisJesus.Tuitlifeluncadegrentjus.Terce	respondent tuit adun :" Jesum querem Nazarenum |"" Eu soi aquel |" zo dis Jesus . Tuit li felun cadegrent jus . Terce
vezlorodemanded,atotastreischedentenvers.Maislifeluntuittrassudadversnostredonsonaproismad.Judasli	vez lor o demanded , a totas treis chedent envers . Mais li felun tuit trassudad vers nostre don son aproismad . Judas li
felensennafei:"Celuiprendetcuibassaerei."JudascumveggraaJesum,semperlitendlosonmenton;	fel ensenna fei :" Celui prendet cui bassaerei ." Judas cum veggra a Jesum , semper li tend lo son menton ;
Jesuslibonsnolrefuded,altradeturbaisairdoned."Amicx-zodisJesuslobons-per	Jesus li bons nol refuded , al tradetur baisair doned ." Amicx - zo dis Jesus lo bons - per
que'mtradesintobaisol?Melztifuranonfussesnaz,quemetradasper	que ' m trades in to baisol ? Melz ti fura non fusses naz , que me tradas per
cobetad."Armandesterentevirum,detotaspartpresdrentJesum.Nosdefendednenossusted;alamortvaicumunsanels.	cobetad ." Armand esterent evirum , de totas part presdrent Jesum . Nos defended ne nossusted ; a la mort vai cum uns anels .
SanctPedresolsvenjarlovol;estraisloferqueallazog,siconsegueduservfellon,la	Sanct Pedre sols venjar lo vol ; estrais lo fer que al laz og , si consegued u serv fellon , la
destreaureliali	destre aurelia li
excos.Jesusli	excos . Jesus li
bonsbenredpermal,l'aurelia	bons ben red per mal , l ' aurelia
adservsempersaned.Liadensmans,cumeladron,sil'entmenenapassiun.Doncloengurpissensei	ad serv semper saned . Liadens mans , cume ladron , si l ' ent menen a passiun . Donc lo en gurpissen sei
fedel,cumel	fedel , cum el
desanzdizloraveit;sanzPedresolssegwenlovai,quaesuafinvedervoldrat.Annanomnavent	desanz diz lor aveit ; sanz Pedre sols segwen lo vai , quae sua fin veder voldrat . Anna nomnavent
leJudeua	le Judeu a
cuiJesusfuretmenez.Donc	cui Jesus furet menez . Donc
s'adunouentlifelon,vederannouentpresJesum.DequantilquerentleforsfaitcumilJesumoicisesant,nonfudtrovez	s ' adunouent li felon , veder annouent pres Jesum . De quant il querent le forsfait cum il Jesum oicisesant , non fud trovez
neenvenguz,quarelforsfaitnonfeistneul.	ne envenguz , quar el forsfait non feist neul .
Davantl'estedlepontifex,siconjuret	Davant l ' ested le pontifex , si conjuret
peripsumDeuquellordissestperpurafiedsivers	per ipsum Deu quellor dissest per pura fied si vers
Jesus,filsDeu,estil."Tuepsl'asdeit"responJesus.Tuitli	Jesus , fils Deu , est il ." Tu eps l ' as deit " respon Jesus . Tuit li
felloncridentadun:"Maiorforsfaitqueiquerem?Perluimedepsaudit	fellon crident adun :" Maior forsfait que i querem ? Per lui medeps audit
l'avem."Losossansolsduncquescubrirent,acolejarfellonloprisdrent;ensobretot	l ' avem ." Losos sans ols duncques cubrirent , a colejar fellon lo prisdrent ; ensobre tot
sil'escarnissent:"Dinos,prophete,chit'ofisdret?"Forsenlasestrasestet	si l ' escarnissent :" Di nos , prophete , chi t ' o fisdret ?" Fors en las estras estet
Petre;alfogl'useire	Petre ; al fog l ' useire
l'aeswardevet.Desaraisonsi	l ' aeswardevet . De sa raison si
l'esfrededqueloDeufillifaineier.Anzquaelanoitlojalzcantes,tercevezPetre	l ' esfreded que lo Deu fil li fai neier . Anz quae la noit lo jalz cantes , terce vez Petre
loneiez.Jesuslibonsloreswardet,lui	lo neiez . Jesus li bons lo reswardet , lui
recognostrelsemperfiz.Petrusd'aloforss'enaled,amaramentmultseploret,per	recognostrel semper fiz . Petrus d ' alo fors s ' en aled , amarament mult se ploret , per
ciolaissedDeusse	cio laissed Deus se
neier;quedenosaietpieted|Cumlematinsfudesclairez,davantPilatl'enantmenet;fortment	neier ; que de nos aiet pieted | Cum le matins fud esclairez , davant Pilat l ' en ant menet ; fortment
lovantilacusand,lasoamortmultdemandant.PilazErodl'	lo vant il acusand , la soa mort mult demandant . Pilaz Erod l '
enenviet,cuidesabanzvoliet	en enviet , cui desabanz voliet
mel;deJesuChristipassionamsepaierentacieljorn.LofelHerodescumlo	mel ; de Jesu Christi passion am se paierent a ciel jorn . Lo fel Herodes cum lo
vid,multlezsemperenesdevint.Deluilongtempsmultaaudit,semperpensedvertuzfeisis.Demultesvises	vid , mult lez semper en esdevint . De lui long temps mult a audit , semper pensed vertuz feisis . De multes vises
l'apeled,Jesuslibonsmotnolsoned.Judeul'acusent,elsetais;adunrespondrenon	l ' apeled , Jesus li bons mot nol soned . Judeu l ' acusent , el se tais ; ad un respondre non
denat.Dunclodespeisel'	denat . Dunc lo despeis e l '
escarnitlifelHerodesencel	escarnit li fel Herodes en cel
di;blancvestimentsil'avestit,fellonPiladloretramist.Pilazqueanzl'envollaiser,	di ; blanc vestiment si l ' a vestit , fellon Pilad lo retramist . Pilaz que anz l ' en vol laiser ,
nolconsentuntfellunJudeu.Vidaperdonentalladrun."	nol consentunt fellun Judeu . Vida perdonent al ladrun ."
Aucid,aucid-crident-	Aucid , aucid - crident -
Jesum|"Barrabantperdonentlavide,Jesuminaltacruzclaufisdrent."Crucifige,crucifige|"cridentPilattrestuitensems."Cumaucidraieu	Jesum |" Barrabant perdonent la vide , Jesum in alta cruz claufisdrent ." Crucifige , crucifige |" crident Pilat trestuit ensems ." Cum aucidrai eu
vostrerei?-zodisPilaz	vostre rei ?- zo dis Pilaz
-forsfaiz	- forsfaiz
nones;rumprelfaraietflagellar,poisseslaisarail	non es ; rumprel farai et flagellar , poisses laisarai l
'enannar	' en annar
."Ensemscridenttuitlifelluntentroencelenvanlasvoz:"SitulaisesviureJesum,non	." Ensems crident tuit li fellunt entro en cel en van las voz :" Si tu laises viure Jesum , non
esamicsl'emperador."Pilazsasmans	es amics l ' emperador ." Pilaz sas mans
dunqueslaved,quedesamortposchesneger.EnsemscridenttuitliJudeu:"Sobrenossiatozli	dunques laved , que de sa mort posches neger . Ensems crident tuit li Judeu :" Sobre nos sia toz li
pechez|"Pilazcumaudidtalsraisons,	pechez |" Pilaz cum audid tals raisons ,
jalorgurpisnostresennior;donc	ja lor gurpis nostre sennior ; donc
lorecebentlifellun,forsl'enconducentenlacort.Depurpuredonclovestirenteten	lo recebent li fellun , fors l ' en conducent en la cort . De purpure donc lo vestirent et en
samanunrauslimisdrent;coronaprendentdelasespinesetenson	sa man un raus li misdrent ; corona prendent de las espines et en son
cabfellunl'asisdrent,Dedavantluituitagenolzsis'	cab fellun l ' asisdrent , De davant lui tuit a genolz si s '
excrebantentlifellon;dunclosaludentcumsenior	excrebantent li fellon ; dunc lo saludent cum senior
etadescarnemperador	et ad escarn emperador
.Etcumasez	. Et cum asez
l'ontescarnid,dunclivestentsonvestiment,etelmedepssipres	l ' ont escarnid , dunc li vestent son vestiment , et el medeps si pres
sacruz,avantozvaiapasiun.Femnesluivandetrasseguanploranlovanetgaimentan	sa cruz , avan toz vai a pasiun . Femnes lui van detras seguan ploran lo van et gaimentan
.Jesuslipiusredregarder,ab	. Jesus li pius redre garder , ab
lesfemnespresaparler."Audez,filliesJerusalem;permenonvosestobsplorer;maispervoset	les femnes pres a parler ." Audez , fillies Jerusalem ; per me non vos est obs plorer ; mais per vos et
pervostresfilzplorezassaz,qu'iobsvoses."CumelpervengaGolgota,davanlaporta	per vostres filz plorez assaz , qu ' i obs vos es ." Cum el perveng a Golgota , davan la porta
delaciptat,dunc	de la ciptat , dunc
lorgurpitsoechamisaechisenscusturaefofaitice.Ilnol	lor gurpit soe chamisae chi sens custurae fo faitice . Il no l
'auserenderamar,maischil'aura,sortangitad;nonfut	' auseren deramar , mais chi l ' aura , sort an gitad ; non fut
partizsosvestimenz,zofugranzsignatotperver.En	partiz sos vestimenz , zo fu granz signa tot per ver . En
hunafet,hunavertettuitsoifideldeventester;lososregnaznonesdevis,	huna fet , huna vertet tuit soi fidel devent ester ; lo sos regnaz non es devis ,
encaritadtozesuniz.Edelsfelunsqu'euvosdisanz,lai	en caritad toz es uniz . E dels feluns qu ' eu vos dis anz , lai
deiveniroeulaisai;quarillofelmesclenabvin,nostraesenior	dei venir o eu laisai ; quar il lo fel mesclen ab vin , nostrae senior
lotenden	lo tenden
il.Cuml'	il . Cum l '
anlevadsusenlacruz,dosasoslazpendenlasruns:entrecelsdospendentJesum.Ilperescarno	an levad sus en la cruz , dos a sos laz penden lasruns : entre cels dos pendent Jesum . Il per escarn o
fantrestot.Cumill'anmessusenlacruz,granfanescarn	fan trestot . Cum il l ' an mes sus en la cruz , gran fan escarn
,grancridaizun;ensobretozunsdelsladruns	, gran cridaizun ; ensobre toz uns dels ladruns
,elescarniereiJesum.Respondetl'altre:"Malidiz	, el escarnie rei Jesum . Respondet l ' altre :" Mal i diz
.Elmoratort	. El mor a tort
,rennonforsfist;maisnosadreitpercolpasgranzesmesoidiencestahanz."	, ren non forsfist ; mais nos a dreit per colpas granz esmes oidi en cest ahanz ."
EnversJesumsosolztorned,sipiamentluiappelled:"Demetmembrespertamercet,cutu	Envers Jesum sos olz torned , si piament lui appelled :" De met membres per ta mercet , cu tu
vendras,Crist,entonren."	vendras , Crist , en ton ren ."
Responli	Respon li
bonsquinonmentid,chienepsamortsemperfupius:"	bons qui non mentid , chi en epsa mort semper fu pius :"
Eut'opromet,oiencestdi	Eu t ' o promet , oi en cest di
abmevenrasinparadis."ODeus,versrex,JesuCrist,cital	ab me venras in paradis ." O Deus , vers rex , Jesu Crist , ci tal
donfaispertamercit,chiperhunaconfessionvideperdonesalladrun,nostelaudametnoitedi	don fais per ta mercit , chi per huna confession vide perdones al ladrun , nos te laudam et noit e di
,denosaies	, de nos aies
veramercit	vera mercit
;tunosperdone	; tu nos perdone
celzpecazqu'enosvetdesttuapietad.Jusquenonadeslomeiditrestotcestmundgranznoizcubrid;fui	celz pecaz qu ' e nos vetdest tua pietad . Jusque nona des lo meidi trestot cest mund granz noiz cubrid ; fui
losolelzetfuilaluna,postqueDeuffilzsuspensusfure.Adepsanonacumperving,	lo solelz et fui la luna , post que Deuffilz suspensus fure . Ad epsa nona cum perving ,
duncescridedJesusgranz	dunc escrided Jesus granz
criz.Hebraicefortment	criz . Hebraice fortment
lodis:"Heli,Heli,perquemgulpist?"Unsdelsfellunschi'staiki,	lo dis :" Heli , Heli , per quem gulpist ?" Uns dels felluns chi ' sta iki ,
susenlacruzlitenl'azit.Jesusfortmenduncrecridet	sus en la cruz li ten l ' azit . Jesus fortmen dunc recridet
;lespiritusde	; le spiritus de
luianet.Cumde	lui anet . Cum de
Jesul'anma'nanet,tanduramentterracrollet,rochesfendient	Jesu l ' anma ' n anet , tan durament terra crollet , roches fendient
,chedentmunt,sepulcrasanzobrirentmult.Et	, chedent munt , sepulcra sanz obrirent mult . Et
multcorpssanzensunexutetinteromnessuntvedud;quiintemplumDeicortinepend,juschelaterrapermei	mult corps sanz en sun exut et inter omnes sunt vedud ; qui in templum Dei cortine pend , jusche la terra per mei
fend.Delazlacrozestet	fend . De laz la croz estet
MariaedecuiJesus	Mariae de cui Jesus
veracarnprisdret;cumcelacarnvidramurir,qualagredol,nol	vera carn prisdret ; cum cela carn vidra murir , qual agre dol , nol
sabomvius.Elamoltbensabremembrardesoacarn	sab om vius . Ela molt ben sab remembrar de soa carn
cumDeusfunaz.Jalvedeselasimorir,elresurdra,chosabperver.Maisnemperro	cum Deus fu naz . Jal vedes ela si morir , el resurdra , cho sab per ver . Mais nemperro
granzfulidols,chitraversetperlosoncor;nulzom	granz fu li dols , chi traverset per lo son cor ; nulz om
mortalznolpodpenser,sanzSymeonzloipercogded.JosepsPilatmultapreiatlocorpsJesuqu'ellidones;a	mortalz nol pod penser , sanz Symeonz loi percogded . Joseps Pilat mult a preiat lo corps Jesu qu ' el li dones ; a
grandhonorell'enportet,ensoschamsilsl'envolopet.Nicodemusdell'altrapartmultunguement	grand honor el l ' en portet , en sos chamsils l ' envolopet . Nicodemus dell ' altra part mult unguement
hiaportat;entermirraetaloenquasicentliurasadoned.Agrandhonordecespimencl'aromatizencuschement	hi aportat ; enter mirra et aloen quasi cent liuras a doned . A grand honor de ces pimenc l ' aromatizen cuschement
.Dunclopausenelmonumentocorpsnonjagancaceltemps.Lasoamadrevirgofuetsen	. Dunc lo pausen el monument o corps non jag anc a cel temps . La soa madre virgo fu et sen
pechedsiportetlui.Sosmunumentfuretoznous,anzluinoijagunquenulzom.	peched si portet lui . Sos munument fure toz nous , anz lui noi jag unque nulz om .
Nonfudassazancalsfelluns;davantPilattrestuitenvont:"Nostepraeiam,pertamercetgardesimet,non	Non fud assaz anc als felluns ; davant Pilat trestuit en vont :" Nos te praeiam , per ta mercet gardes i met , non
siaemblez.Quarelzodisqueresurdraetalterzdiviuspareistra;emblarl'auran	sia emblez . Quar el zo dis que resurdra et al terz di vius pareistra ; emblar l ' auran
lisoifidel	li soi fidel
,atozdiranquerevisquet.Granzenavemaguderrors,orenaurempecemaiors."Armazvassalzdunc	, a toz diran que revisquet . Granz en avem agud errors , or en aurem pece maiors ." Armaz vassalz dunc
lorliuret,lomonumentlorcomandet.ChristusJesus,quiDeusesversquisemperfuetsemperer,	lor liuret , lo monument lor comandet . Christus Jesus , qui Deus es vers qui semper fu et semper er ,
jafoslacharnsdeluiaucise,regnetperocumanzsefisdret.	ja fos la charns de lui aucise , regnet pero cum anz se fisdret .
Quael'enfernduncasalit,fortSatananalovenquit;persoamortsil'avencut	Qua el ' enfern dunc asalit , fort Satanan alo venquit ; per soa mort si l ' a vencut
quecontraomnenonavertud.Etquieraliomprimerselsoienffantpersonpechet;eli	que contra omne non a vertud . Etqui era li om primers el soi enffant per son pechet ; e li
petiteteligranetquiesteventpermulzanz	petitet e li gran etqui estevent per mulz anz
.Quarancnonfonulomcarnals,encelenfernnonfosanaz,usquevenguesqui,senspechet,pertozsolses	. Quar anc non fo nulom carnals , en cel enfern non fos anaz , usque vengues qui , sens pechet , per toz solses
comunalei.Argentneaurnonidonatmasquesonsang	comuna lei . Argent ne aur non i donat mas que son sang
etsoacarn;d'egcelenferntozlosliuret,enparadislosarberget.Etalterzdilomattinclar	et soa carn ; d ' eg cel enfern toz los liuret , en paradis los arberget . Et al terz di lo mattin clar
,cumlisoleilzfoesclairaz,tresfemnesvanalmonument;moltcarsportaventunguemenz.L'angeles	, cum li soleilz fo esclairaz , tres femnes van al monument ; molt cars portavent unguemenz . L ' angeles
Deudeceldessendsis'aproismetalmonument;tal	Deu de cel dessend si s ' aproismet al monument ; tal
aregardcumfocsardenzetcumlaneusblancvestimenz.Enpasquelvidrenli	a regard cum focs ardenz et cum la neus blanc vestimenz . En pas quel vidren li
custod,sis'espaurirendepavor,quequaissesmorzaterravengrendegranpavorquesobl'elz	custod , si s ' espauriren de pavor , que quaisses morz a terra vengren de gran pavor que sobl ' elz
vengre.Sus	vengre . Sus
enlapeddrel'angelsist	en la peddre l ' angel sist
,siparletalasfemnes,dis:"Nos'sneient	, si parlet a las femnes , dis :" Nos ' s neient
ciperquecrement,queJesumCristbenrequeret.Anazenesetnonesci,totacomplit	ci per que crement , que Jesum Crist ben requeret . Anaz en es et non es ci , tot a complit
quunquevosdis.Venezvederlolocvoiantolisoscorpsjacdesabanz.	quun que vos dis . Venez veder lo loc voiant o li sos corps jac desabanz .
Asosfidelstotannuncaz,	A sos fidels tot annuncaz ,
masvosPetdrunnoioblidez:en	mas vos Petdrun noi oblidez : en
Galileaavantenvai,allolvetran	Galilea avant en vai , allol vetran
oditlorad."Ellesd'equicumsunttornades,Jesuslasasenpr'encontradas;duncreconnossentlosenior	o dit lor ad ." Elles d ' equi cum sunt tornades , Jesus las a senpr ' encontradas ; dunc reconnossent lo senior
,sil'adorentcumredemptor.Lonostraeseindraeeneps	, si l ' adorent cum redemptor . Lo nostrae seindrae en eps
celdiveduzfuraeveiadescinc.PrimeralvitsanctaMariae,decuisepdiables	cel di veduz furae veiades cinc . Primeral vit sancta Mariae , de cui sepdiables
forsmisdret.Empreslovidrencellesduaes	forsmisdret . Empres lo vidren celles duaes
delmunument,cumseretornent	del munument , cum se retornent
.Petdreslovitenepscel	. Petdres lo vit en eps cel
di,abluiparletsilconjaudit.Enverslovespraeenversloserdunclorevidrendoifidel;castelEmausabelzentret	di , ab lui parlet sil conjaudit . Envers lo vesprae envers lo ser dunc lo revidren doi fidel ; castel Emaus ab elz entret
,abelzensemblesisopet.	, ab elz ensemble si sopet .
Jas'adunentlisoifidel,jadicentuitqueviuseret;cumilmenaventalraizon,	Ja s ' adunent li soi fidel , ja dicen tuit que vius eret ; cum il menaven tal raizon ,
Jesusestetenmettrestoz."Paxvobissit	Jesus estet en mettrestoz ." Pax vobis sit
-disatrestoz-eusoiJesusquipassussoi;vedezmasmans,vedez	- dis a trestoz - eu soi Jesus qui passus soi ; vedez mas mans , vedez
mospeds,vedezmolaz,qu'ifuiplages."Fortmentsunilespaventat,illinoncredentqueaiacarn	mos peds , vedez mo laz , qu ' i fui plages ." Fortment sun il espaventat , il li non credent que aia carn
;zopensentil,queenterelzlespiritusaparegues.Melepeisonequimanget,enveritad	; zo pensent il , que enter elz le spiritus aparegues . Mel e peison equi manget , en veritad
losconfirmet;sapassionpeisonstostazelomelssignadeitat	los confirmet ; sa passion peisons tostaz e lo mels signa deitat
.Alquesvos	. Alques vos
aideitderaizonqueJesusfezpospassion;tot	ai deit de raizon que Jesus fez pos passion ; tot
nolvosposceubencomptar,nolpodnulomdemadrenaz.Asosfidelsquarantadispermulzsemblanzsemonstretviu	nol vos posc eu ben comptar , nol pod nulom de madre naz . A sos fidels quaranta dis per mulz semblanz se monstret viu
;emsembl'abelz	; emsembl ' ab elz
becemanjed,deregnumDeusemper	bec e manjed , de regnum Deu semper
parlet.Eperesmundroalsallartozbabtizarintrinitad;quiluicredran,cilerentsalv;quinol	parlet . E per es mund roals allar toz babtizar in trinitad ; qui lui credran , cil erent salv ; qui nol
cretran,	cretran ,
serandamnat.Signesfaranlisoifidelqualselabanzfairesoleit.Linguesnoves	seran damnat . Signes faran li soi fidel quals el abanz faire soleit . Lingues noves
ilparlaranetdiablesencalceran.Sialcunsd'elsbevenveren,nonauramal,zosabperver	il parlaran et diables encalceran . Si alcuns d ' els beven veren , non aura mal , zo sab per ver
;sobraemalabdesmansmetranetsanitadatoz	; sobrae malabdes mans metran et sanitad a toz
rendran.SusenumontdonchesmontatqueHolivet	rendran . Sus en u mont donches montat que Holivet
numnatvosai.Levetsaman,silsbenedis;vengrelanuvols,silcollit.Elorvedent	numnat vos ai . Levet sa man , sils benedis ; vengre la nuvols , sil collit . E lor vedent
montetencel,addextrisDeuJesusesset;etquivenratozjudicar,atozrendra	montet en cel , addextris Deu Jesusesset ; etqui venra toz judicar , a toz rendra
ebenemal	e ben e mal
.Lisoifidelensontornet;aldezenjornjacumperveng,SpiritusSanctussobr'elzched,	. Li soi fidel en son tornet ; al dezen jorn ja cum perveng , Spiritus Sanctus sobr ' elz ched ,
silsenflametcumfugsardenz.Ildesabanzsuntaserad,deCrist	sils enflamet cum fugs ardenz . Il desabanz sunt aserad , de Crist
nonsabentmotparlar;enpaschevengvertuzdecel,ilnondobtennegunJudeu.Pertoz	non sabent mot parlar ; en pas che veng vertuz de cel , il non dobten negun Judeu . Per toz
lengatgesvanparlan,lasvirtuzCrist	lengatges van parlan , las virtuz Crist
vanannuncian;no	van annuncian ; no
lorpodomvius	lor pod om vius
contrastar,signesfazenperpodestad.Espandutsunt	contrastar , signes fazen per podestad . Espandut sunt
pertotcesmund,regnumDeinuncentpertot;pertot	per tot ces mund , regnum Dei nuncent per tot ; per tot
convertentpopl'etgent,ChristusJesuspertotabelz.LoSatanasdol	convertent popl ' et gent , Christus Jesus per tot ab elz . Lo Satanas dol
enagrand,alsDeufidelsfaidursafanz.Alcanzencruz	en a grand , als Deu fidels fai durs afanz . Alcanz en cruz
failoslevar	fai los levar
,alquanzd'espadesdegollar;ellos	, alquanz d ' espades degollar ; ellos
alquanzfaiescorcer,alquanzenfogviustrebucher,etengradilielsfaitoster,alquanz	alquanz fai escorcer , alquanz en fog vius trebucher , et en gradiliels fai toster , alquanz
appetdreslapider.	appetdres lapider .
Luiqueaiude?Nulsvencera;cumpeislorfai	Lui que aiude ? Nuls vencera ; cum peis lor fai
,ilcreisentmais.LocapaCristesvegurad,pertotesmundesadhoraz.Noscestespugnesnonavem	, il creisent mais . Lo cap a Crist esvegurad , per tot es mund es adhoraz . Nos cestes pugnes non avem
,contranosepspugnardevem;fraindredevemnozvoluntez,	, contra nos eps pugnar devem ; fraindre devem noz voluntez ,
quepartaiamabDeufidels.Quarfinimunznonesmultlon,etregnumDeufortmentesprob;dontrenoslezfacam	que part aiam ab Deu fidels . Quar finimunz non es mult lon , et regnum Deu fortment es prob ; dontre nos lez facam
loben,gurpissem	lo ben , gurpissem
mundetsompechet.ChristusJesus,	mund et som pechet . Christus Jesus ,
quimansensus,mercetaiasdepechedors;en	qui mans ensus , mercet aias de pechedors ; en
talsraizonssiammespraes,pertapitadlomperdones.Teposcheretdraegraciaedavant	tals raizons si ammespraes , per ta pitad lom perdones . Te posche retdrae graciae davant
topairegloriae|SanzSpiritumposchelaudaretnuncpertotin	to paire gloriae | Sanz Spiritum posche laudar et nunc per tot in
secula.AMEN	secula . AMEN
DomineDeudevemps	Domine Deu devemps
lauder,Etasossanczhonorporter.Insu'amorcantompsdelssanz,Quaeporluiaugrentgranzaanz;	lauder , Et a sos sancz honor porter . In su ' amor cantomps dels sanz , Quae por lui augrent granz aanz ;
EtorestempsetsiestbiensQuaenoscantumpsdesantLethgier.	Et or es temps et si est biens Quae nos cantumps de sant Lethgier .
PrimesdidraivosdelshonorsQuaeilawretabduosseniors;ApresditraivosdelsaanzQue	Primes didrai vos dels honors Quae il awret ab duos seniors ; Apres ditrai vos dels aanz Que
lisuoscorpssustingsigranz,EtEwruins,cilDeumentiz,Que	li suos corps susting si granz , Et Ewruins , cil Deu mentiz , Que
luiagrandtormentoccist.Quantinfansfud,doncacielstemps,Alrei	lui a grand torment occist . Quant infans fud , donc a ciels temps , Al rei
loduistrentsoiparentQuidonc	lo duistrent soi parent Qui donc
regnevetacieldi:CiofudLothiers,filsBaldequi	regnevet a ciel di : Cio fud Lothiers , fils Baldequi
.Ill'enamat,Deulocovit,Rovatqueletresapresist.Didun,l'ebisquedePeitieus	. Il l ' enamat , Deu lo covit , Rovat que letres apresist . Didun , l ' ebisque de Peitieus
,LuilcomandatcielreisLothiers	, Luil comandat ciel reis Lothiers
.Illoreciut,tam	. Il lo reciut , tam
benenfist,Abumagistresemprelmist,QuilodoistbiendecielsavierDonDeuservirporbonafied	ben en fist , Ab u magistre semprel mist , Qui lo doist bien de ciel savier Don Deu servir por bona fied
.Etcumill'autdoitdelciel'art,Rendelquiluilocomandat.Illoreciu	. Et cum il l ' aut doit del ciel ' art , Rendel qui lui lo comandat . Il lo reciu
,bienlonodrit;Ciofudlonxtiempsobselosting.Deusl'exaltatcuiel	, bien lo nodrit ; Cio fud lonx tiemps ob se los ting . Deus l ' exaltat cui el
servid,De	servid , De
sanctMAXENZabbasdivint.NefudnulsomdelsonjuventQuimieldrefustdoncacielstiemps;Perfectusfudincaritet	sanct MAXENZ abbas divint . Ne fud nuls om del son juvent Qui mieldre fust donc a ciels tiemps ; Perfectus fud in caritet
,Fidautilgrandet	, Fid aut il grand et
veritiet,Etinraizonsbelsothsermons;Humilitietothpertrestoz.Ciosemprefudetjasier	veritiet , Et in raizons bels oth sermons ; Humilitiet oth per trestoz . Cio sempre fud et ja si er
:Quifailobien,laudazener;EtsanzLetgierssemprefudbons	: Qui fai lo bien , laudaz en er ; Et sanz Letgiers sempre fud bons
,Semprefistbienoqueelpod.	, Sempre fist bien o que el pod .
Davantloreienfudlaudiez;Cumill'audit,fulinamet.A	Davant lo rei en fud laudiez ; Cum il l ' audit , fu lin amet . A
selmandatetciolidist:Acurtfust,sempreluiservist.Ill'exaltatel'onorat,Sa	sel mandat et cio li dist : A curt fust , sempre lui servist . Il l ' exaltat e l ' onorat , Sa
gratialiperdonat,EthunctambienqueilenfistDeHostedunevesqueenfist.	gratia li perdonat , Et hunc tam bien que il en fist De Hostedun evesque en fist .
Quandiusvisquetciel	Quandius visquet ciel
reisLothiers,BienhonorezfudsanczLethgiers.Ilsefudmorz,damzifudgranz.Ciocontroverent	reis Lothiers , Bien honorez fud sancz Lethgiers . Il se fud morz , damz i fud granz . Cio controverent
baronfranc,Por	baron franc , Por
cioquefuddebonafiet,DeChielperigfesissentrei.Uncompteioth,pres	cio que fud de bona fiet , De Chielperig fesissent rei . Un compte i oth , pres
enl'estrit;CielepsnumauretEvrui.NevolreciwreChielperin,MaisloseufredreTheoiri.	en l ' estrit ; Ciel eps num auret Evrui . Ne vol reciwre Chielperin , Mais lo seu fredre Theoiri .
Nelcondignetnulsdesospiers,Reivoluntfair'estresogred.Illopresdrenttuitaconseil	Nel condignet nuls de sos piers , Rei volunt fair ' estre so gred . Il lo presdrent tuit a conseil
,Estresogretenfisdrenrei	, Estre so gret en fisdren rei
;EtEwruinsotengrandol,Porroqueventrenolsenpoth.Por	; Et Ewruins ot en gran dol , Porro que ventre nols en poth . Por
cieltielduolrovasclergier,Sis'enintrat	ciel tiel duol rovas clergier , Si s ' en intrat
inunmonstier.ReisChielpericstambienenfist,DesanctLethgierconsilierfist.Quandiusalsuo	in un monstier . Reis Chielperics tam bien en fist , De sanct Lethgier consilier fist . Quandius al suo
consieledrat,IncontraDeubensigarda,Leiconsentitetobservat,Etsonregnetbendominat.Ja	consiel edrat , Incontra Deu ben si garda , Lei consentit et observat , Et son regnet ben dominat . Ja
fudtelsom,Deuinimix,Quil'encusatabChielpering.L'	fud tels om , Deu inimix , Qui l ' encusat ab Chielpering . L '
irafudgranzcumdesenior,Etsancz	ira fud granz cum de senior , Et sancz
Lethgiersocs'entpavor;Jalosotbien,illocelat	Lethgiers oc s ' ent pavor ; Ja lo sot bien , il lo celat
,Anuilomnenoldemonstrat.Quantciel'iraetelsesdevent,Paschasfurentin	, A nuil omne nol demonstrat . Quant ciel ' irae tels esdevent , Paschas furent in
epsceldi;	eps cel di ;
EtsanczLethgiers	Et sancz Lethgiers
fistsonmistier	fist son mistier
,Missaecantat,fistlo	, Missae cantat , fist lo
mulben.Pobl'etloreicommuniet,Etsenscumgietsi	mul ben . Pobl ' et lo rei communiet , Et sens cumgiet si
s'enralet.ReisChielperics,cumill'audit,Presdrasosmeis,aluistramist;	s ' en ralet . Reis Chielperics , cum il l ' audit , Presdra sos meis , a luis tramist ;
Ciolimandatquerevenist,Sagratiaportotouist.EtsanczLethgiersnes	Cio li mandat que revenist , Sa gratia por tot ouist . Et sancz Lethgiers nes
sothmesfait;Cumvitles	soth mesfait ; Cum vit les
meis,aluiralat.Ilciolidistetadunat:"Tosconsiliersjanonestrai.Meu'evesquet	meis , a lui ralat . Il cio li dist et adunat :" Tos consiliers ja non estrai . Meu ' evesquet
nemleztenerPortequisempremvolsaver	nem lez tener Por te qui semprem vols aver
.Enumonstiermelaisseintrer.Posci	. En u monstier me laisse intrer . Pos ci
nonposc,laivolester."Envizlofist,nonvoluntiers,Laissel	non posc , lai vol ester ." Enviz lo fist , non voluntiers , Laisse l
'intrarinumonstier.CiofudLusosutilintrat;Clerj'Ewruiillotrovat.CilEwruinsmoltli	' intrar in u monstier . Cio fud Lusos ut il intrat ; Clerj ' Ewrui illo trovat . Cil Ewruins molt li
volmiel,	vol miel ,
Tothperenveia,nonperel.EtsanczLethgiersfistsomistier,Ewruipristacastier:	Toth per enveia , non per el . Et sancz Lethgiers fist so mistier , Ewrui prist a castier :
Ciel'iragrandetcielcorropt,Ciolipreia,laissaslototh.FusliporDeu,	Ciel ' ira grand et ciel corropt , Cio li preia , laissas lo toth . Fus li por Deu ,
nelfusporlui.Ciolipreia,paiass'ablui.EtEwruins	nel fus por lui . Cio li preia , paias s ' ab lui . Et Ewruins
fistfinctapais;Cioldemonstrat	fist fincta pais ; Ciol demonstrat
,quesipaias.Quandiusincielmonstier	, que si paias . Quandius in ciel monstier
instud,Cioldemonstrat,amixlifust.Maisenavantvoscioaurez,Cumilledratpormalafid.	instud , Ciol demonstrat , amix li fust . Mais en avant vos cio aurez , Cum ill edrat por mala fid .
RexChielperingsilsefudmorz;Porloregnetlosowrenttost.Vindrentparenteloramic,	Rex Chielperings il se fud morz ; Por lo regnet lo sowrent tost . Vindrent parent e lor amic ,
LisanctLethgier	Li sanct Lethgier
,liEwrui.Cioconfortentadambesduos,Ques'entralgentinlorhonors.EtsanczLethgiersdenfistdra	, li Ewrui . Cio confortent ad ambes duos , Que s ' ent ralgent in lor honors . Et sancz Lethgiers den fistdra
bien,Quaes'enralaten	bien , Quae s ' en ralat en
s'evesquet.EtEwruinsdenfisdramiel,Quaedoncdevenganatemaz.Sonquevqueilacoronat,Tothlo	s ' evesquet . Et Ewruins den fisdra miel , Quae donc deveng anatemaz . Son quev que il a coronat , Toth lo
laiserarecimer.DomineDeuillolaissat,Et	laisera recimer . Domine Deu il lo laissat , Et
adiables	a diables
comandat.Quidoncfudmielsetaluivint,Ilvoluntierssemperreciut	comandat . Qui donc fud miels et a lui vint , Il voluntiers semper reciut
.Cumfulcenautgrandadunat,Loregneprest	. Cum fulc en aut grand adunat , Lo regne prest
adevastar.Afoc,aflammavaiardant,Etagladiespercutan.Porquantilpot,tan	a devastar . A foc , a flamma vai ardant , Et a gladies percutan . Por quant il pot , tan
faidemiel;PorDeunelvoltilobserver.Cielne	fai de miel ; Por Deu nel volt il observer . Ciel ne
fudnezdemedreviusQuitalexercitevidist.AdOstedun,acilla	fud nez de medre vius Qui tal exercite vidist . Ad Ostedun , a cilla
ciu,DomsanctLethgiervaiasalir.	ciu , Dom sanct Lethgier vai asalir .
Nepotintrerenlaciutat	Ne pot intrer en la ciutat
;Deforsl'asist,fistigranmiel.	; Defors l ' asist , fist i gran miel .
EtsanczLethgiersmulenfud	Et sancz Lethgiers mul en fud
trists,Por	trists , Por
cieltielmielquaedeforsvid.Sosclerjespresilrevestiz,Etobsescroixforss'enexit	ciel tiel miel quae defors vid . Sos clerjes pres il revestiz , Et ob ses croix fors s ' en exit
.Porronexit,vollipreierQuaetotcielmiellaissesporDeu.CielEwruins	. Porron exit , vol li preier Quae tot ciel miel laisses por Deu . Ciel Ewruins
,qualhoralvid,Penrelrovat,lierlofist.HORENAUREZLASPOENASgranz,Quae	, qual horal vid , Penrel rovat , lier lo fist . HOR EN AUREZ LAS POENAS granz , Quae
ilenfisdra,litiranz.Liperfidestamfudcruels,Lisolsdelcaplifaicrever.Cumsi	il en fisdra , li tiranz . Li perfides tam fud cruels , Lis ols del cap li fai crever . Cum si
l'autfait,misl'enreclus;Ne	l ' aut fait , mis l ' en reclus ; Ne
sothnulsom	soth nuls om
qu'esdevenguz.AmlaslawraslifaitalierHanclalinguaquaeautinquev.	qu ' es devenguz . Am las lawras li fai talier Hanc la lingua quae aut in quev .
Cumsil'auttothvituperet,DistEwruins,quitanfudmiels:"Horaperduddondeuparlier;Ja	Cum si l ' aut toth vituperet , Dist Ewruins , qui tan fud miels :" Hor a perdud don deu parlier ; Ja
nonpodramaisDeulaudier."Aterrajoth,multfoafflicz;	non podra mais Deu laudier ." A terra joth , mult fo afflicz ;
Nonoctobsecuiencalsist.Superlispieznepodester,Quetozlosatilcondemnets.	Non oct ob se cui en calsist . Super lis piez ne pod ester , Que toz los at il condemnets .
Oraperduddondeuparlier;Janonpodra	Or a perdud don deu parlier ; Ja non podra
maisDeulaudier.Sedilnon	mais Deu laudier . Sed il non
adlingu'aparlier,Deusexaudislissospensaez;Etsiel	ad lingu ' a parlier , Deus exaudis lis sos pensaez ; Et si el
nonadolscarnels,En	non ad ols carnels , En
corlosadespiritiels;Etsiencorpsagrandtorment,L'animanawraconsolament.Guenesothnumcuil	cor los ad espiritiels ; Et si en corps a grand torment , L ' animan awra consolament . Guenes oth num cuil
comandat;Lajus	comandat ; La jus
encartresl'enmenat;EtenFescant,in	en cartres l ' en menat ; Et en Fescant , in
cielmonstier,IlloreclusdrentsanctLethgier.DomineDeus	ciel monstier , Illo reclusdrent sanct Lethgier . Domine Deus
incielflaielIvisitetLethgier	in ciel flaiel I visitet Lethgier
sonserw.Lalabialiadrestaurat,SicumdesanzDeupreslaudier;Ethancenautmercisigrand	son serw . La labia li ad restaurat , Si cum desanz Deu pres laudier ; Et hanc en aut merci si grand
,Parlierlofistsicumdesanz.DoncpresLethgiersapreier,	, Parlier lo fist si cum desanz . Donc pres Lethgiers a preier ,
PoblebenfistcredreinDeu.Et	Poble ben fist credre in Deu . Et
Ewruis,cumill'audit,Credrenelpotantroquelvid.Cumillovid,fudcorroptios;	Ewruis , cum il l ' audit , Credre nel pot antro quel vid . Cum il lo vid , fud corroptios ;
Doncoctablui	Donc oct ab lui
duresraizons.Elcorsexastraaltirant,Peislipromestadenavant.Agrandfuror,agranflaiel,	dures raizons . El cors exastra al tirant , Peis li promest ad en avant . A grand furor , a gran flaiel ,
SilrecomandaLaudebert	Sil recomanda Laudebert
.Ciolirova,etnoitetdiMiellifesistdontrequ'elviu	. Cio li rova , et noit et di Miel li fesist dontre qu ' el viu
.CielLaudeberzfurabuonsom,EtsanctLethgierduisasondom.Illivolfairemultamet;Bewre	. Ciel Laudeberz fura buons om , Et sanct Lethgier duis a son dom . Il li vol faire mult amet ; Bewre
lirovaaporter.Garda,sividgrandclaritet;Decelvindre,fud	li rova aporter . Garda , si vid grand claritet ; De cel vindre , fud
deparDeu.Sicumroors	de par Deu . Si cum roors
incelesgranz,Etsicumflammesclarardanz.CilLaudeberz,qualhoralvid	in cel es granz , Et si cum flammes clar ardanz . Cil Laudeberz , qual horal vid
,Tornes'	, Torne s '
alsaltres,silordist:"CiestomnetielmultaimaDeus	als altres , si lor dist :" Ciest omne tiel mult aima Deus
,Porcuitelscausavindeciel."Porciels	, Por cui tels causa vin de ciel ." Por ciels
signesquevidrenttels,Deupresdrentmultaconlauder.Tuitliomnedecielpais	signes que vidrent tels , Deu presdrent mult a conlauder . Tuit li omne de ciel pais
,Trestuitapresdrentavenir;EtsanczLethgierslisprediat	, Trestuit apresdrent a venir ; Et sancz Lethgiers lis prediat
,DomineDeuilleslucrat.RendetcielfruitespiritielQuaeDeusliauretperdonat.	, Domine Deu il les lucrat . Rendet ciel fruit espiritiel Quae Deus li auret perdonat .
EtEwruins,cumill'audit,Credrenelpotantroquelvid.Cilbiensqu'elfist,	Et Ewruins , cum il l ' audit , Credre nel pot antro quel vid . Cil biens qu ' el fist ,
cillipesat	cil li pesat
;Occiderelocommandat.Quatr'omnesitramistarmezQueluialessuntdecoller.	; Occidere lo commandat . Quatr ' omnes i tramist armez Que lui alessunt decoller .
LitresvindrentasanctLethgier,Jussegiterentasospez.Delor	Li tres vindrent a sanct Lethgier , Jus se giterent a sos pez . De lor
pechietzqueaurentfaizIllosabsolsetperdonet.Lo	pechietz que aurent faiz Il los absols et perdonet . Lo
quarz,unsfel,nomaVadart,Abuninspiethlodecollat.Etcumill'	quarz , uns fel , nom a Vadart , Ab un inspieth lo decollat . Et cum il l '
audtollutloquev,Locorpsesterasobrelspiez.	aud tollut lo quev , Lo corps estera sobrels piez .
Ciofudlonxdisquenoncadit;Lais'aprosmatqueluifirid.Entrol	Cio fud lonx dis que non cadit ; Lai s ' aprosmat que lui firid . Entrol
talialospezdejus,Locorpsesterasempre	talia los pez dejus , Lo corps estera sempre
sus.Delcorpsasazl'	sus . Del corps asaz l '
avezaudit,Etdelsflaielsquegranzsustint.L'animareciutDomineDeus;	avez audit , Et dels flaiels que granz sustint . L ' anima reciut Domine Deus ;
Alsaltres	Als altres
sanzenvaiencel.IlnosaiudobcielSenior	sanz en vai en cel . Il nos aiud ob ciel Senior
Porcuisustinctelspassions	Por cui sustinc tels passions
