tandus.siuisum	tandus . si uisum
fueritexpedire	fuerit expedire
.caueat	. caueat
etiamdiligenter.neadexcomunicationemcuiusquam.	etiam diligenter . ne ad excomunicationem cuiusquam .
absquemanifestaetrationabilicausaprocedat.adquamsi	absque manifesta et rationabili causa procedat . ad quam si
taliterforteprocesserit:etrequisitus.humiliter	taliter forte processerit : et requisitus . humiliter
processumhuiusmodinoncuraueritabsquegrauamine	processum huiusmodi non curauerit absque grauamine
reuocare:granatus:	reuocare : granatus :
aputsuperioremdeponatdeiniusta	aput superiorem deponat de iniusta
excomunicationequerelam.	excomunicatione querelam .
quodsiabsquepericulomorepotest	quod si absque periculo more potest
:adexcomunicatorem.	: ad excomunicatorem .
illumcumsuomandatoremittat.infracompetentem	illum cum suo mandato remittat . infra competentem
terminumabsoluendum.alioquinipseperse.uelper	terminum absoluendum . alioquin ipse per se . uel per
aliumprout	alium prout
uideritexpedire:sufficienticautionerecepta:	uiderit expedire : sufficienti cautione recepta :
munuseiabsolutionisimpendat.cumqueaduersusexcommunicatoremde	munus ei absolutionis impendat . cumque aduersus excommunicatorem de
iniustaexcomunicationeconstiterit:	iniusta excomunicatione constiterit :
excommunicatorcondempnetur	excommunicator condempnetur
excommunicatoadinteresse.aliasnichilominuscumculpequalitaspostulauerit	excommunicato ad interesse . alias nichilominus cum culpe qualitas postulauerit
:superiorisarbitriopuniendus	: superioris arbitrio puniendus
.cumnonleuis	. cum non leuis
sitculpatantaminfligerepenaminsonti	sit culpa tantam infligere penam insonti
:nisiforsanerraueritexcausaprobabili.maxime	: nisi forsan errauerit ex causa probabili . maxime
silaudabilisopinionisexistat.uerumsi	si laudabilis opinionis existat . uerum si
contraexcomunicationissententiamnichil	contra excomunicationis sententiam nichil
rationabilefueritaconquerenteprobatum	rationabile fuerit a conquerente probatum
:idem.etsuperiniustaexcomunicationismolestia.	: idem . et super iniusta excomunicationis molestia .
perpenamad	per penam ad
interesse.uelaliamsecundumsuperiorisarbitrium.nisiforsan	interesse . uel aliam secundum superioris arbitrium . nisi forsan
etipsumprobabiliserrorexcuset.	et ipsum probabilis error excuset .
etsupereopro	et super eo pro
quoinstafuitexcommunicationeligatus:percautionem	quo insta fuit excommunicatione ligatus : per cautionem
receptamsatisfacerecompellatur.uelinpristinamreducatur	receptam satisfacere compellatur . uel in pristinam reducatur
sententiam:usque	sententiam : usque
adsatisfactionemcondignaminuiolabiliterobseruandam.	ad satisfactionem condignam inuiolabiliter obseruandam .
siueroiudexsuumrecognoscenserrorem.	si uero iudex suum recognoscens errorem .
paratussittalemreuocaresententiam.et	paratus sit talem reuocare sententiam . et
isproquo	is pro quo
latafuerit	lata fuerit
.neabsquesatisfactione	. ne absque satisfactione
reuocetillamappellet.	reuocet illam appellet .
appellationinondeferatinhacparte:nisitalis	appellationi non deferat in hac parte : nisi talis
siterror.de	sit error . de
quomeritoualeatdubitari	quo merito ualeat dubitari
.ettunc	. et tunc
sufficienticautionerecepta.quodcoram	sufficienti cautione recepta . quod coram
eoadquem	eo ad quem
extiteritappellatum:ueldelegatoab	extiterit appellatum : uel delegato ab
ipso.iuripareatexcommunicatum	ipso . iuri pareat excommunicatum
absoluat.sicquepeneprescripteminime	absoluat . sicque pene prescripte minime
subiacebit.cauensomninoneuoluntateperuersainalterius	subiacebit . cauens omnino ne uoluntate peruersa in alterius
preiudiciummentiaturerrorem.sidistrictionis	preiudicium mentiatur errorem . si districtionis
canoniceuulteffugeredisciplinam	canonice uult effugere disciplinam
.Demodorecusandiiudicem	. De modo recusandi iudicem
Dumspecialisit	Dum speciali sit
prohibitioneprouisum.nequisinaliquem	prohibitione prouisum . ne quis in aliquem
excomunicationissententiam	excomunicationis sententiam
nisicompetenticommonitionepremissa.promulgarepresumat:uolentes	nisi competenti commonitione premissa . promulgare presumat : uolentes
etiamprouidere	etiam prouidere
.nefortecommonitusfrustratorierecusationisuelappellationis	. ne forte commonitus frustratorie recusationis uel appellationis
obiectu:monentisdeclinarepossitexamen:	obiectu : monentis declinare possit examen :
statuimus.quodsiallegauerit.se	statuimus . quod si allegauerit . se
iudicemhaberesuspectum.	iudicem habere suspectum .
corameodemcausamsuspicionisiusteassignet.	coram eodem causam suspicionis iuste assignet .
etipsecumaduersario.uelsi	et ipse cum aduersario . uel si
aduersariumfortenonhabet:cumiudicearbitros	aduersarium forte non habet : cum iudice arbitros
communitereligat.autsicommuniterconuenire	communiter eligat . aut si communiter conuenire
nonpossunt:eligantabsquemalitia.ipseunum.	non possunt : eligant absque malitia . ipse unum .
etillealium.quidesuspicionis	et ille alium . qui de suspicionis
causacognoscant.Etsi	causa cognoscant . Et si
nequiuerintinunamconcordaresententiam:	nequiuerint in unam concordare sententiam :
aduocenttertium	aduocent tertium
.utquodduoexipsisdecreuerint	. ut quod duo ex ipsis decreuerint
:roburobtineatfirmitatis.sciantqueseadid	: robur obtineat firmitatis . sciantque se ad id
fideliterexequendum.exiniunctonobisinuirtuteobedientie	fideliter exequendum . ex iniuncto nobis in uirtute obedientie
.subobtestationediuiniindiciidistrictopreceptoteneri	. sub obtestatione diuini indicii districto precepto teneri
.causauerosuspicionislegitima.	. causa uero suspicionis legitima .
coramipsisinfracompetentem	coram ipsis infra competentem
terminumnonprobata:suaiuridictioneiudexutatur.	terminum non probata : sua iuridictione iudex utatur .
atipsaprobatalegitime.derecusatorisassensu.persone	at ipsa probata legitime . de recusatoris assensu . persone
ydoneecommittatnegotiumrecusatus.	ydonee committat negotium recusatus .
ueladsuperioremtransmittat.utineoipseprocedat	uel ad superiorem transmittat . ut in eo ipse procedat
.secundumquod	. secundum quod
fueritprocedendum	fuerit procedendum
.porroexcommunicatio	. porro excommunicatio
adappellationisobstaculumconuolante.sieius	ad appellationis obstaculum conuolante . si eius
excessuseuidentiareiuelipsiusconfessione	excessus euidentia rei uel ipsius confessione
.uelaliomodolegitime	. uel alio modo legitime
fueritmanifestus:cumappellationisremediumnonsitaddefensionem	fuerit manifestus : cum appellationis remedium non sit ad defensionem
iniquitatis.sedpresidiuminnocentieinstitutum:	iniquitatis . sed presidium innocentie institutum :
nonestprouocationihuiusmodideferendum.Excessuquoquedubioexistente	non est prouocationi huiusmodi deferendum . Excessu quoque dubio existente
.nefriuoleappellationisdiffugioappellansiudicis	. ne friuole appellationis diffugio appellans iudicis
processumimpediat.corameodemprobabilemcausamappellationisexponat	processum impediat . coram eodem probabilem causam appellationis exponat
.talemuidelicet.quesiforetprobata:	. talem uidelicet . que si foret probata :
possetlegitimareputarietsitunchabueritaduersariuminfra	posset legitima reputari et si tunc habuerit aduersarium infra
terminumsecundumlocorumdistantiamettemporisqualitatemet	terminum secundum locorum distantiam et temporis qualitatem et
naturamnegotii.abeodemiudicemoderandum	naturam negotii . ab eodem iudice moderandum
appellationeinterpositaprosequatur.quamsiprosequinoncurauerit	appellatione interposita prosequatur . quam si pro sequi non curauerit
:extunc.	: ex tunc .
ipseiudexnonobstanteprocedat.	ipse iudex non obstante procedat .
nulloautemaduersariocomparente.cum	nullo autem aduersario comparente . cum
iudexexsuo	iudex ex suo
officioprocedatappellationiscausacoramsuperiore	officio procedat appellationis causa coram superiore
probata:superiorsue	probata : superior sue
iuridictionisofficiumexequatur.sedetsiappellansin	iuridictionis officium exequatur . sed et si appellans in
eiusprobationedefecerit:ad	eius probatione defecerit : ad
eumaquoipsummalitioseappellasseconstiterit:reuertatur	eum a quo ipsum malitiose appellasse constiterit : reuertatur
.ceterum.hasduasconstitutionespremissas	. ceterum . has duas constitutiones premissas
.nolumusadregularesextendi	. nolumus ad regulares extendi
contrasuasobseruantiasspeciales	contra suas obseruantias speciales
.Depenaexcommunicationis	. De pena excommunicationis
iniuste	in iuste
Subinterminationediuiniindicii	Sub interminatione diuini indicii
penitusinterdicimus.ne	penitus interdicimus . ne
causacupiditatisnullusaudeatexcommunicationisuinculoaliqueminnodare.	causa cupiditatis nullus audeat excommunicationis uinculo aliquem innodare .
uelabsoluereinnodatum:inillismaximeregionibus	uel absoluere innodatum : in illis maxime regionibus
inquibusexconsuetudine	in quibus ex consuetudine
cumexcommunicatusabsoluiturpecuniariapenamulctantur.statuentesut	cum excommunicatus absoluitur pecuniaria pena mulctantur . statuentes ut
cumexcommunicationissententiaminiustamfuisse	cum excommunicationis sententiam iniustam fuisse
constiterit.excomunicatoradrestituendam	constiterit . excomunicator ad restituendam
pecuniamsicextortam.	pecuniam sic ex tortam .
per.cen.ec.compellatur	per . cen . ec. compellatur
.etnisi	. et nisi
fueritprobabili	fuerit probabili
erroredeceptus.tamtundeminiuriam	errore deceptus . tamtundem iniuriam
passopersoluat.etsi	passo persoluat . et si
fortesoluendononfuerit.animaduersionealia	forte soluendo non fuerit . animaduersione alia
castigetur.	castigetur .
DerestrictaprohibitioneNondebetreprehensibilematrimonii	De restricta prohibitione Non debet reprehensibile matrimonii
iudicari.sisecundum	iudicari . si secundum
uarietatemtemporumstatutaquoqueuarienturhumana.	uarietatem temporum statuta quoque uarientur humana .
presertimcum	presertim cum
urgensnecessitas.ueleuidensutilitas	urgens necessitas . uel euidens utilitas
idexposcat.quoniamipse	id exposcat . quoniam ipse
deusexhiisquein	deus ex hiis que in
ueter.terre.statuerat:non	ueter . terre . statuerat : non
nullamutauitinnouo.cumergoprohibitiones	nulla mutauit in nouo . cum ergo prohibitiones
deconiugioinsecundoet	de coniugio in secundo et
tertioaffinitatisgenere.minime	tertio affinitatis genere . minime
contrahendo:etdesobolesuscepta.	contrahendo : et de sobole suscepta .
exsecundisnuptiis	ex secundis nuptiis
.cognationiuirinoncopulanda.priorisdifficultatemfrequenterinducant	. cognationi uiri non copulanda . prioris difficultatem frequenter inducant
.etaliquandopericulumpariantanimarum.	. et aliquando periculum pariant animarum .
utcessanteprohibitione.cesseteffectus	ut cessante prohibitione . cesset effectus
:constitutionessuperhoceditas.sacricomprobationeconcilii	: constitutiones super hoc editas . sacri comprobatione concilii
reuocantes:presenticonstitutionedecernimus.utsiccontrahentes.	reuocantes : presenti constitutione decernimus . ut sic contrahentes .
deceteroliberecopulentur.prohibitioquoquecopule	de cetero libere copulentur . prohibitio quoque copule
coniugalis.quartumconsanguinitatisetaffinitatisgradumnonexcedat	coniugalis . quartum consanguinitatis et affinitatis gradum non excedat
.quoniaminulterioribusgradibus	. quoniam in ulterioribus gradibus
iamnonpotestabsquegrauidispensiohuius	iam non potest absque graui dispensio huius
prohibitioobseruari:Quaternariusenim	prohibitio obseruari : Quaternarius enim
numerusbenecongruitprohibitioniconiugiicorporalis	numerus bene congruit prohibitioni coniugii corporalis
.dequodicitapostolus.quoduirnonhabet	. de quo dicit apostolus . quod uir non habet
potestatemsuicorporis	potestatem sui corporis
.sedmulier.neque	. sed mulier . neque
mulierhabetpotestatemsuicorporis.seduir	mulier habet potestatem sui corporis . sed uir
.Quia.iiii.sunthumoresin	. Quia . iiii . sunt humores in
corpore.quodconstatexquatuorelementis.cum	corpore . quod constat ex quatuor elementis . cum
ergoiamusqueadquartumgradumprohibitioconiugalis	ergo iam usque ad quartum gradum prohibitio coniugalis
copulesitrestricta	copule sit restricta
:eamuolumusitaesseperpetuam.	: eam uolumus ita esse perpetuam .
nonobstantibusconsultationibussuperhoc	non obstantibus consultationibus super hoc
dudumeditis.uel	dudum editis . uel
abaliis.uelanobis:ut	ab aliis . uel a nobis : ut
siquiscontraprohibitionemhuiusmodipresumpseritcopularinulla	siquis contra prohibitionem huiusmodi presumpserit copulari nulla
longinquitatedefendanturannorum.	longinquitate defendantur annorum .
cumquidemdiuturnitastemporisnonminuat	cum quidem diuturnitas temporis non minuat
peccatum.	peccatum .
sedaugeat.tantoquegrauiorasint	sed augeat . tantoque grauiora sint
crimina:quantodiutius.infelicemanimamtenuerintalligatam	crimina : quanto diutius . infelicem animam tenuerint alligatam
destinamatrimoniaDepenacontrahentium	destina matrimonia De pena contrahentium
clamuminhibitiocopuleconiugalis	clamum inhibitio copule coniugalis
sitintribusultimisgradibusreuocata:eamuolumus	sit in tribus ultimis gradibus reuocata : eam uolumus
inaliisdistricte	in aliis districte
seruari.undepredecessorumnostroruminherendo	seruari . unde predecessorum nostrorum inherendo
uestigiis.clandestinaconiugiapenitusinhibemus.	uestigiis . clandestina coniugia penitus inhibemus .
prohibentesetiam	prohibentes etiam
.nequissacerdos	. ne quis sacerdos
talibusinteressepresumat	talibus inter esse presumat
.quarespecialemquorundamlocorumconsuetudinem.ad	. quare specialem quorundam locorum consuetudinem . ad
aliageneraliterprorogando	alia generaliter prorogando
.statuimusutcummatrimoniafuerintcontrahenda:in	. statuimus ut cum matrimonia fuerint contrahenda : in
ecclesiisperpresbiteros	ecclesiis per presbiteros
publiceproponatur	publice proponatur
.competentiterminoprefinito.utinfraillum:qui	. competenti termino prefinito . ut infra illum : qui
uolueritetualuerit	uoluerit et ualuerit
:legitimumimpedimentumopponat	: legitimum impedimentum opponat
.etipsipresbiterinichilominusinuestigentutrumaliquodimpedimentum	. et ipsi presbiteri nichilominus inuestigent utrum aliquod impedimentum
obsistat.cumergoprobabilisapparuerittexta:statuimus	obsistat . cum ergo probabilis apparuerit texta : statuimus
uttales	ut tales
perprelatosecclesiarumabobseruantiaueterisrituscompescantur	per prelatos ecclesiarum ab obseruantia ueteris ritus compescantur
.utquos	. ut quos
christianereligionilibereuoluntatisarbitriumobtulit.salutiferecoactionisnecessitas	christiane religioni libere uoluntatis arbitrium obtulit . salutifere coactionis necessitas
ineiusobseruationeconseruet	in eius obseruatione conseruet
.cumminusmalum	. cum minus malum
existatuiamdomininonagnoscere.quamagnitam:	existat uiam domini non agnoscere . quam agnitam :
retroireproliberationesancteterre.adliberandumsanctam	retroire pro liberatione sancte terre . ad liberandum sanctam
terramdemanibusimpiorum:ardenti	terram de manibus impiorum : ardenti
desiderioaspirantes:deprudentumuirorumquiplene	desiderio aspirantes : de prudentum uirorum qui plene
noueruntcircumstantias	nouerunt circumstantias
temporumetlocorumsacroapprobanteconciliodiffininimus.ut	temporum et locorum sacro approbante concilio diffininimus . ut
itacrucesignatise	ita cruce signati se
preparent:quodinkalendis.iunii	preparent : quod in kalendis . iunii
sequentispostproximum.omnesquidisposuerunttransireper	sequentis post proximum . omnes qui disposuerunt transire per
mare:conueniantinregnum	mare : conueniant in regnum
siciliealiisicutopportuerit.etdecuerit.apudbrundusium	sicilie alii sicut opportuerit . et decuerit . apud brundusium
.etalii	. et alii
apudmessanam.etpartes	apud messanam . et partes
utrobiqueuicinas.ubietnos	utrobique uicinas . ubi et nos
disponentedomino	disponente domino
disposuimuspersonalitertuncadesse.quatinusconsilio	disposuimus personaliter tunc ad esse . quatinus consilio
etauxilio:exercituschristianus	et auxilio : exercitus christianus
salubriterordinetur.cumbenedictionediuinaetapostolica	salubriter ordinetur . cum benedictione diuina et apostolica
profecturus.ad	profecturus . ad
eundemquoqueterminumsestudeantpreparare:qui	eundem quoque terminum se studeant preparare : qui
proposueruntproficisciperterram	proposuerunt proficisci per terram
.significaturihoc	. significaturi hoc
interimnobis.uteisadauxiliumetconsiliumopportunum	interim nobis . ut eis ad auxilium et consilium opportunum
.legatumdenostrolatereidoneum	. legatum de nostro latere idoneum
concedamus.sacerdotesautemetclericiqui	concedamus . sacerdotes autem et clerici qui
fuerintinexercituchristianotamsubditiquamprelatiorationi	fuerint in exercitu christiano tam subditi quam prelati orationi
etexhortationidiligenterinsistantdocenteseosuerbopariteretexemplo	et exhortationi diligenter insistant docentes eos uerbo pariter et exemplo
.uttimoremetamoremdiuinumsemperhabeant	. ut timorem et amorem diuinum semper habeant
anteoculos.nequiddicant	ante oculos . ne quid dicant
autfaciant.quod	aut faciant . quod
diuinammaiestatemoffendat	diuinam maiestatem offendat
.Etsialiquandolapsifuerintinpeccatum	. Et si aliquando lapsi fuerint in peccatum
peruerampenitentiammoxresurgant	per ueram penitentiam mox resurgant
gerenteshumilitatemcordisetcorporis.et	gerentes humilitatem cordis et corporis . et
taminuictuquaminuestitu	tam in uictu quam in uestitu
:mediocritatemseruantes:dissensionesetemulationes	: mediocritatem seruantes : dissensiones et emulationes
omninouitando.liuore	omnino uitando . liuore
etrancore	et rancore
omninorelegatis.utsicspiritualibusetmaterialibusarmismuniti	omnino relegatis . ut sic spiritualibus et materialibus armis muniti
aduersushostesfideisecuriusprelientur.necdesua	aduersus hostes fidei securius prelientur . nec de sua
presumentes.seddediuina	presumentes . sed de diuina
uirtutesperantes	uirtute sperantes
.Ipsisautem	. Ipsis autem
clericisindulgemus.utbeneficiasuaintegrepercipiant	clericis indulgemus . ut beneficia sua integre percipiant
pertriennium.ac	per triennium . ac
siessentinecclesiaresidentes	si essent in ecclesia residentes
.etsinecesse	. et si necesse
fuerit:	fuerit :
eaperidemtempuspignori	ea per idem tempus pignori
ualeantobligare.ne	ualeant obligare . ne
autemhoc	autem hoc
sanctumpropositum	sanctum propositum
impediriueltardaricontingatuoniuersis	impediri uel tardari contingat uoniuersis
ecclesiarumprelatisdistricte	ecclesiarum prelatis districte
precipimus.ut	precipimus . ut
singuliperlocasuaillosquisignumcrucis	singuli per loca sua illos qui signum crucis
deposuerunt:resumere.actamillosquamalioscruce	deposuerunt : resumere . ac tam illos quam alios cruce
signatosetquosadhucsignari	signatos et quos adhuc signari
contingerit:adreddendumdomino	contingerit : ad reddendum domino
uotasua	uota sua
.diligentermoneantet	. diligenter moneant et
inducant.etsinecessefueritperexcomunicationisin	inducant . et si necesse fuerit per excomunicationis in
personas.	personas .
etinterdictisententiasin	et interdicti sententias in
terriseorum:omnitergiuersationecessante	terris eorum : omni tergiuersatione cessante
:compellant.illisdumtaxatexceptis.	: compellant . illis dumtaxat exceptis .
quibustaleimpedimentumoccurrerit.utsecundum	quibus tale impedimentum occurrerit . ut secundum
prouidentiamuotumeorummeritocommutaridebeatuel	prouidentiam uotum eorum merito commutari debeat uel
differri.ad	differri . ad
hecnequidinnegotiochristiiehsudecontingentibus	hec ne quid in negotio christi iehsu de contingentibus
omittatur.uolumus	omittatur . uolumus
etmandamus.utpatriache.archiepiscopi.episcopi.	et mandamus . ut patriache . archiepiscopi . episcopi .
abbates.etaliiquicuramobtinent	abbates . et alii qui curam obtinent
animarumstudiose	animarum studiose
proponantcommissis	proponant commissis
sibipopulisuerbumcrucis.obsecrantes	sibi populis uerbum crucis . obsecrantes
.per.patremet	. per . patrem et
filiumetspiritumsanctumunumsolumuerum	filium et spiritum sanctum unum solum uerum
eternumdeum.regesDuces.principes	eternum deum . reges Duces . principes
.marchiones.comites	. marchiones . comites
.etbarones.aliosquemagnates.	. et barones . aliosque magnates .
necnoncommuniaciuitatumuillarumqueetoppidumutquipersonaliter	nec non communia ciuitatum uillarumque et oppidum ut qui personaliter
etillucnon	et illuc non
accesserintinsubsidiumterresanctecompetentemconferant	accesserint in subsidium terre sancte competentem conferant
numerumbellatorum.cum	numerum bellatorum . cum
expensisusquead	expensis usque ad
trienniumnecessariissecundumpropriasfacultatesinremissionempeccatorum	triennium necessariis secundum proprias facultates in remissionem peccatorum
suorumproutingeneralibuslitterisest	suorum prout in generalibus litteris est
expressum.etadmaiorem	expressum . et ad maiorem
cautelametiaminferiusexprimetur.cuius	cautelam etiam inferius exprimetur . cuius
remissionisuolumusesseparticipes	remissionis uolumus esse participes
nonsolumeosquiadhocnauesproprias	non solum eos qui ad hoc naues proprias
exhibuerint:sedetillos	exhibuerint : sed et illos
quipropterhocopusstuduerintfabricare.renuentibus:autem	qui propter hoc opus studuerint fabricare . renuentibus : autem
siquifortetamingratifuerintdominodeonostro	si qui forte tam ingrati fuerint domino deo nostro
.exparte	. ex parte
apostolicafirmiterprotestentur.utsciant	apostolica firmiter protestentur . ut sciant
sesuperhocinnouissimodistrictiexaminisdie	se super hoc in nouissimo districti examinis die
:coramtremendoiudiceresponsuros.priustamenconsiderantesqua	: coram tremendo iudice responsuros . prius tamen considerantes qua
conscientiaquauesecuritatecomparerepoterint	conscientia quaue securitate comparere poterint
coramunigenitodeifilio	coram unigenito dei filio
iehsuchristo.cuiomnia	iehsu christo . cui omnia
deditpaterin	dedit pater in
manus.sieipropeccatoribus	manus . si ei pro peccatoribus
crucifixoseruirerenuerintinhoc	crucifixo seruire renuerint in hoc
negotio.quasipropriesibiproprio.cuius	negotio . quasi proprie sibi proprio . cuius
munereuiuunt.cuiusbeneficiosustentantur.	munere uiuunt . cuius beneficio sustentantur .
quinetiam	quin etiam
cuiussanguinesuntredempti.neergoin	cuius sanguine sunt redempti . ne ergo in
humeroshominumoneragrauiaetimportabiliaimponere	humeros hominum onera grauia et importabilia imponere
uideamurquedigitonostro	uideamur que digito nostro
mouerenolimus:similesillisquidicunt.	mouere nolimus : similes illis qui dicunt .
utiqueetnonfaciunt.Ecce	utique et non faciunt . Ecce
nosdehiisqueultranecessariasetmoderatasexpensaspotuimus	nos de hiis que ultra necessarias et moderatas expensas potuimus
reseruare.xxx.milialibraruminhocopusconcedimus	reseruare . xxx . milia librarum in hoc opus concedimus
.etdonamus	. et donamus
.preternauigiumquodcrucesignatisde	. preter nauigium quod cruce signa tis de
urbeatqueuicinispartibusconferemus.	urbe atque uicinis partibus conferemus .
assignaturinichilominusadhoc	assignaturi nichilominus ad hoc
opus.triamiliamarcharumargenti.	opus . tria milia marcharum argenti .
queapudnosde	que apud nos de
quorundamfideliumelemosinis	quorundam fidelium elemosinis
remanserunt.aliisinnecessitatesetutilitatespredicteterreper	remanserunt . aliis in necessitates et utilitates predicte terre per
manusfelicis	manus felicis
memorie.albertiIerosolimitanipatriarche.	memorie . alberti Ierosolimitani patriarche .
acmagistrorumtempliet	ac magistrorum templi et
hospitalisfideliterdistributis.cupientes	hospitalis fideliter distributis . cupientes
autemaliosecclesiarum	autem alios ecclesiarum
prelatosnecnonclericosuniuersosetinmeritoet	prelatos nec non clericos uniuersos et in merito et
inpremiohabereparticipesetconsortes.excommuni	in premio habere participes et consortes . ex communi
conciliiapprobationestatuimusutomnesomninoclericitamsubditi	concilii approbatione statuimus ut omnes omnino clerici tam subditi
quamprelati.uicesimamecclesiasticorum	quam prelati . uicesimam ecclesiasticorum
prouentuumusqueadtrienniumintegreconferant	prouentuum usque ad triennium integre conferant
insubsidium	in subsidium
terresancte.per	terre sancte . per
manuseorumquiadhocfuerint	manus eorum qui ad hoc fuerint
prouidentiaapostolicaordinati.quibusdamdumtaxat	prouidentia apostolica ordinati . quibusdam dum taxat
religiosisexceptisprestationemeritoeximendis.Iliisquesimiliter.qui	religiosis exceptis prestatione merito eximendis . Iliisque similiter . qui
assumpto.uelassumendocrucissignaculo.suntpersonaliterprofecturi	assumpto . uel assumendo crucis signaculo . sunt personaliter profecturi
.nosautemet	. nos autem et
fratresnostri.sancteecclesieromanecardinales	fratres nostri . sancte ecclesie romane cardinales
.plenariamdecimampersoluemus.	. plenariam decimam persoluemus .
sciantqueseomnesadhoc	sciantque se omnes ad hoc
fideliterobseruandumper	fideliter obseruandum per
excomunicationissententiamobligatos.Ita	excomunicationis sententiam obligatos . Ita
quodilliquisuperfraudemscienter	quod illi qui super fraudem scienter
commiserint:sententiamexcomunicationisincurrant	commiserint : sententiam excomunicationis incurrant
.sane.quia	. sane . quia
iustoiudiciocelestisimperatorisobsequiis	iusto iudicio celestis imperatoris obsequiis
inherentes.specialidecetprerogatiua	inherentes . speciali decet prerogatiua
gaudere.cumtempusproficiscendiannumexcedatinmodico.	gaudere . cum tempus proficiscendi annum excedat in modico .
crucesignaticollectis.ueltalliis	cruce signati collectis . uel talliis
.aliisquegrauaminibussint	. aliisque grauaminibus sint
immunes.quorum	immunes . quorum
personaset	personas et
bona.postcrucemsusceptam:subbeatipetri	bona . post crucem susceptam : sub beati petri
etnostraprotectionesuscepimus.statuentes	et nostra protectione suscepimus . statuentes
utsubarchiepiscoporumepiscoporum.atqueomniumprelatorum	ut sub archiepiscoporum episcoporum . atque omnium prelatorum
ecclesiedefensioneconsistant	ecclesie defensione consistant
.propriisnichilominus	. propriis nichilominus
protectoribusadhocspecialiterdeputatis.	protectoribus ad hoc specialiter deputatis .
Itautbonaeorum.donecdeipsorumobitu	Ita ut bona eorum . donec de ipsorum obitu
certissimereditucognoscatur:integra	certissime reditu cognoscatur : integra
maneantacquieta.etsi	maneant ac quieta . et si
quisquamcontrapresumpserit.cen.ecclesiecompescatur	quisquam contra presumpserit . cen . ecclesie compescatur
.siquiueroproficiscentium	. si qui uero proficiscentium
illuc.ad	illuc . ad
prestandasusurasiuramentotenenturastricti:creditoreseorum	prestandas usuras iuramento tenentur astricti : creditores eorum
.utremittanteis	. ut remittant eis
prestitumiuramentum.etabusurarumexactionedesistant:	prestitum iuramentum . et ab usurarum exactione desistant :
eademprecipimusdistrictionecompelli.Quidsiquiscreditorumeos	eadem precipimus districtione compelli . Quid siquis creditorum eos
adsolutionemcoegerintusurarum:eumad	ad solutionem coegerint usurarum : eum ad
restitutionemearumsimilicogianimaduersionemandamus	restitutionem earum simili cogi animaduersione mandamus
.Iudeosueroad	. Iudeos uero ad
remittendasusuraspersecularem	remittendas usuras per secularem
compelliprecipimuspotestatem	compelli precipimus potestatem
.etdonecillasremiserint	. et donec illas remiserint
:abuniuersischristifidelibusperexcomunicationissententiam	: ab uniuersis christi fidelibus per excomunicationis sententiam
eisomninocommuniodenegetur.	eis omnino communio denegetur .
hiisautemquiiudeis	hiis autem qui iudeis
debitasoluerenequierint.inpresentisic	debita soluere nequierint . in presenti sic
principesseculares	principes seculares
utilidilationeprouideant.quodpost	utili dilatione prouideant . quod post
iterarreptumusquequode	iter arreptum usquequo de
ipsorumobituuelreditucertissimecognoscatur.usurarumincommodanon	ipsorum obitu uel reditu certissime cognoscatur . usurarum incommoda non
incurrantperfecteconscendatactionis.Quodpre	incurrant perfecte conscendat actionis . Quod pre
pleniusdeclaratur.perhoc	plenius declaratur . per hoc
quodmonsiste.monsorebdicitur.orebenim	quod mons iste . mons oreb dicitur . oreb enim
ardorinterpretatur.Inmontemitaqueoreb	ardor interpretatur . In montem itaque oreb
ascendit.quicaritatis	ascendit . qui caritatis
ardoresuccensus	ardore succensus
.prerogatiuaconuersationisceterosantecellit.Inmonteisto	. prerogatiua conuersationis ceteros antecellit . In monte isto
dominus.in	dominus . in
flammaignismoysilegiturapparuisse.constattamenrubumin	flamma ignis moysi legitur apparuisse . constat tamen rubum in
quodominusapparuit:penitusille	quo dominus apparuit : penitus ille
sumpermansisse	sum permansisse
.Inquofactodaturintelligi.quiaignis	. In quo facto datur intelligi . quia ignis
caritatisnonconburit.sedilluminat.non	caritatis non conburit . sed illuminat . non
consumit.sedconseruat.quiauirtute	consumit . sed conseruat . quia uirtute
suaforisspinaspeccatorumexurit.etintusuiriditatem	sua foris spinas peccatorum exurit . et intus uiriditatem
uirtutumillibatamcustodit	uirtutum illibatam custodit
.ascendamusfratresinmontem	. ascendamus fratres in montem
istum.etabigneistocalefierisatagamus.	istum . et ab igne isto calefieri satagamus .
nonmaneamusinsegor.ciuitate	non maneamus insegor . ciuitate
parua.sed	parua . sed
inmonteistosaluosnosfaciamus	in monte isto saluos nos faciamus
.professionienimnostre	. professioni enim nostre
conuenit.ut	conuenit . ut
nonsolummandata.sed	non solum mandata . sed
etconsiliadiuina	et consilia diuina
studeamusadimplere.etin	studeamus adimplere . et in
tabernaculodominiseruientes	tabernaculo domini seruientes
.nontameninsancta.sedet	. non tamen in sancta . sed et
insanctasanctorumcontendamusintroire.maneamusinmonteisto	in sancta sanctorum contendamus introire . maneamus in monte isto
cummoyse.etceteradomino	cum moyse . etcetera domino
frequentercolloquamur.uttandemperuenireualeamusad	frequenter colloquamur . ut tandem peruenire ualeamus ad
montemillum:quipositusestinuerticemontium	montem illum : qui positus est in uertice montium
.adquemfluentomnesgentes.	. ad quem fluent omnes gentes .
adhuncmontemprophetanosinuitansait.ueniteascendamus	ad hunc montem propheta nos inuitans ait . uenite ascendamus
inmontemdomini.monsiste.	in montem domini . mons iste .
dominusest	dominus est
iehsuchristus.monspinguis.	iehsu christus . mons pinguis .
monscoagulatus.cuimontesincaseati.nonualeret	mons coagulatus . cui montes in caseati . non ualeret
coequari.Ipse	coequari . Ipse
estenimquemunxitdeusoleoleticiepreparticibussuis	est enim quem unxit deus oleo leticie preparticibus suis
.quigratiamnonadmensuramaccepit	. qui gratiam non ad mensuram accepit
.sedeamfidelibus	. sed eam fidelibus
suis.proutcuiquenoueritexpedire:gratuita	suis . pro ut cuique nouerit expedire : gratuita
bonitatedisitribuit.adhunc	bonitate disitribuit . ad hunc
montem.idestadseipsum.producere	montem . idest adse ipsum . producere
nosdignetur.dominusnosteriehsuchristus.	nos dignetur . dominus noster iehsu christus .
quicumpatre	qui cum patre
etspritusanctouiuit	et spritu sancto uiuit
etregnatper	et regnat per
omniaseculorum	omnia seculorum
secula.amenremuitiehsuspritu.etturbauitse	secula . amen remuit iehsu spritu . et turbauit se
ipsum.etlacrimatus	ipsum . et lacrimatus
estetclamauit	est et clamauit
.lazareueniforas	. lazare ueni foras
.legimusinscripturissacris.etutinamscriptum	. legimus in scripturis sacris . et utinam scriptum
sitindelebilisincoridibus	sit indelebilis in coridibus
nostris.quiaomnis	nostris . quia omnis
christiactio:animefidelisestlectio.siquidemipse	christi actio : anime fidelis est lectio . siquidem ipse
christusrectelibricenseturnomine.	christus recte libri censetur nomine .
eoquodin	eo quod in
ipsoformamuitenostre	ipso formam uite nostre
legeredebeamusdequo	legere debeamus de quo
libroperezechielemprophetamscriptum	libro per ezechielem prophetam scriptum
est.Expanditcorammelibrum.qui	est . Expandit coram me librum . qui
scriptuseratintuset	scriptus erat intus et
foris.Etdominusineuangelioloquensaddiscipulos.	foris . Et dominus in euangelio loquens ad discipulos .
gaudeteinquit.quianominauestrascripta	gaudete inquit . quia nomina uestra scripta
suntinlibrouite.felix	sunt in libro uite . felix
animaqueinlibrohoclegereiugiteretmeditaristuduerit	anima que in libro hoc legere iugiter et meditari studuerit
.etadexemplum	. et ad exemplum
redemptorissui.iusticieetsanctitatisopribusfuerit	redemptoris sui . iusticie et sanctitatis opribus fuerit
informata.frequensenimhuiuslibrilectio.redire	in formata . frequens enim huius libri lectio . redire
docetadcor	docet ad cor
hominem.	hominem .
etculpasagnoscere.suspirareadueniam.morescomponere	et culpas agnoscere . suspirare adueniam . mores componere
.carnemsubicerespiritui.salutemquerere.uitaminuenire	. carnem subicere spiritui . salutem querere . uitam inuenire
.Etquidemdiuersosinhoclibrodiuersalegentes	. Et quidem diuersos in hoc libro diuersa legentes
.ezechielisprophetetestimonium	. ezechielis prophete testimonium
comprobat.quiineodemlibrocoramseexpanso	comprobat . qui in eodem libro coram se expanso
.lamentationesetcarmen.etue.	. lamentationes et carmen . et ue .
scriptafuissecommemorat.	scripta fuisse commemorat .
Expanditinquit	Expandit inquit
corammelibrum.quieratscriptusintusetforis	coram me librum . qui erat scriptus intus et foris
.etscriptaerantineo.	. et scripta erant in eo .
lamentationes.etcarmen.etue.	lamentationes . et carmen . et ue .
triahecadtriplicemstatum	tria hec ad triplicem statum
uitepresentisnonincongrue	uite presentis non incongrue
respiciunt.inquodiuersidiuersisaffectistudiis.	respiciunt . in quo diuersi diuersis affecti studiis .
uelabin	uel ab in
uioaduiamiusticie.peroperapenitentiediriguntur.	uio ad uiam iusticie . per opera penitentie diriguntur .
uelcelestisgratiemunereiustificati.iamnuncin	uel celestis gratie munere iustificati . iam nunc in
semitisperfectionisambulant.uelcertelatashuiusseculi	semitis perfectionis ambulant . uel certe latas huius seculi
uiasgradientes.	uias gradientes .
arectitudine	a rectitudine
mandatorumdei.pertortuososuitiorumcircuitus	mandatorum dei . per tortuosos uitiorum circuitus
.magisacmagiselongantur.suntenim	. magis ac magis elongantur . sunt enim
quidamquiuitiisetsceleribusirretiti	quidam qui uitiis et sceleribus irretiti
.dumrecogitantsuppliciaimpiiset	. dum recogitant supplicia impiis et
peccatoribuspreparata.dum.	peccatoribus preparata . dum .
dumattenduntcarceremtenebrosum.fletusetstridorem	dum attendunt carcerem tenebrosum . fletus et stridorem
dentium.uermem	dentium . uermem
quinonmoritur.ignem	qui non moritur . ignem
quinonextinguiturduminquamattendunthecomniamente	qui non extinguitur dum inquam attendunt hec omnia mente
conpunguntur.confugiunt	conpunguntur . confugiunt
adlamenta	ad lamenta
penitentie.planguntfortiturmalaquecommiserunt.	penitentie . plangunt fortitur mala que commiserunt .
ethiiinlibroqui	et hii in libro qui
christusest:lamentationesscriptasinueniunt.suntaliiqui	christus est : lamentationes scriptas inueniunt . sunt alii qui
magnitudinembeneficiorumdeierga	magnitudinem beneficiorum dei erga
sediligentiusintuentes.	se diligentius intuentes .
quoduidelicet.depeccatiperpetrationemerentibus.non	quod uidelicet . de peccati perpetratione merentibus . non
solumcommissamisericorditurdimisit.sedetamissa	solum commissa misericorditur dimisit . sed et amissa
liberaliterrestaurauit.quoddignossupplicio.sanguinepropriode	liberaliter restaurauit . quod dignos supplicio . sanguine proprio de
morteredemit.	morte redemit .
quoddenique	quod denique
persuerantibusinfinem:eaqueoculusnonuidere.	persuerantibus in finem : ea que oculus non uidere .
necaurisaudiuit.necincor	nec auris audiuit . nec in cor
hominisascendunt.repromisit:talesinquam	hominis ascendunt . repromisit : tales inquam
specelestiumbonorumconfortati.currunthilariteruiam	spe celestium bonorum confortati . currunt hilariter uiam
mandatorumdei.	mandatorum dei .
etutmereanturassequi	et ut mereantur assequi
quoddeusrepromittit:studentmodis	quod deus repromittit : student modis
omnibusamarequodprecipit.pregaudiospiritusinuocemlaudiset	omnibus amare quod precipit . pregaudio spiritus inuocem laudis et
iubilationiserumpunt	iubilationis erumpunt
.ethiiinlibroquichristusestcarmen	. et hii in libro qui christus est carmen
exaratuminueniunt.dequocarminepsalmistaait	exaratum inueniunt . de quo carmine psalmista ait
.statuitsuprapetrampedes	. statuit supra petram pedes
meos.etdirexitgressus	meos . et direxit gressus
meos.Etinmisit	meos . Et inmisit
inosmeumcanticumnouum	in os meum canticum nouum
.carmendeonostro.suntetaliiquiin	. carmen deo nostro . sunt et alii qui in
profundouitiorumconstituti	profundo uitiorum constituti
.postperpetratamala:ceruicemmentis	. post per petrata mala : ceruicem mentis
erigentadnullaspenitentie	erigent ad nullas penitentie
lamentationesinclinantur	lamentationes inclinantur
.nullacelestiumgaudiorumcorriguntur	. nulla celestium gaudiorum corriguntur
exspectatione.ethiiproculdubio	exspectatione . et hii proculdubio
inlibroquichristus	in libro qui christus
est:scriptuminueniuntue	est : scriptum inueniunt ue
dampnationiseterne.perlamentationesigitur:penitentiaet	dampnationis eterne . per lamentationes igitur : penitentia et
lacrimepeccatorum.percarmen:	lacrime peccatorum . per carmen :
gaudiaiustorum.perue:suppliciareproborumconuenienter	gaudia iustorum . per ue : supplicia reproborum conuenienter
exprimuntur.tibiigituruirbonequiperadoptionis	exprimuntur . tibi igitur uir bone qui per adoptionis
spirituminlucesereniorisconscientie	spiritum in luce serenioris conscientie
iocundaris.qui	iocundaris . qui
repletusfructuiusticie.mordaci	repletus fructu iusticie . mordaci
peccatorummemoria	peccatorum memoria
.nonpungeris	. non pungeris
:tibiinqua	: tibi inqua
:carmenin	: carmen in
hoclibroloquituruerbaconsolationis.uerbaspiritalisiocunditatis	hoc libro loquitur uerba consolationis . uerba spiritalis iocunditatis
quesunt	que sunt
.adepiscopo	. ad episcopo
gratie.feruordeuotionisinterne.angelorumconsortium	gratie . feruor deuotionis in terne . angelorum consortium
.gaudiumsinefinemansurum.utprohiisomnibus	. gaudium sine fine mansurum . ut pro hiis omnibus
gratiasagensdeo:	gratias agens deo :
pertemporalembonorumoperumexercitationem	per temporalem bonorum operum exercitationem
.transeat	. transeat
.quandoquefeliciteradfutureglorieper	. quandoque feliciter ad future glorie per
hennitatem.tuautemhomopeccatorquiiampridem	hennitatem . tu autem homo peccator qui iam pridem
fedusinisticummorte.etpactum	fedus in isti cum morte . et pactum
cuminferno.quicumlazaro	cum inferno . qui cum lazaro
sepultusiacesinsepulcro	sepultus iaces in sepulcro
tenebroseconscientie.pressuslapidepraueconsuetudinis.	tenebrose conscientie . pressus lapide praue consuetudinis .
ligatusinstitispeccatorum.etuelatam	ligatus institis peccatorum . et uelatam
habensfaciem	habens faciem
sudariopessimointernececitatis.tuinquamquisicdormis	sudario pessimo interne cecitatis . tu inquam qui sic dormis
:aduocemredemptorissaltem	: aduocem redemptoris saltem
nuncexurgeamortuis	nunc exurge a mortuis
.etuteuadasue	. et ut euadas ue
dampnationiseterne:legeinlibrohoclamentationesdoloriset	dampnationis eterne : lege in libro hoc lamentationes doloris et
penitentie.corpustuumcrucifigecumuiciisetconcupiscentiis	penitentie . corpus tuum crucifige cum uiciis et concupiscentiis
eius.ut	eius . ut
etipsossensuscorporis.anoxiispostmodum	et ipsos sensus corporis . a noxiis postmodum
retrahasexcessibus.neuidelicet	retrahas excessibus . ne uidelicet
.oculusuideatuanitatem.neaurisaudiatiudiciumsanguinis	. oculus uideat uanitatem . ne auris audiat iudicium sanguinis
ueldetractionem	uel detractionem
.nonodoratusqueratsuauia.	. non odoratus querat suauia .
nongustusdeliciosa:nondeniquemanusextendaturadillicita	non gustus deliciosa : non denique manus extendatur ad illicita
.certesollicitudinemredemptoristuicircatediligentiusintuearis	. certe sollicitudinem redemptoris tui circa te diligentius intuearis
:iamdeceterosalutistuenegligensac	: iam de cetero salutis tue negligens ac
desidiosusessenonpoteris.	desidiosus esse non poteris .
quinimmoreiecta	quin immo reiecta
curarumseculariumcuriositate.totamsollicitudinemtuaminipsumproicies	curarum secularium curiositate . totam sollicitudinem tuam in ipsum proicies
.memorsemper	. memor semper
uerbiillius.quobeatuspetrusinepistola	uerbi illius . quo beatus petrus in epistola
suasalubriternos	sua salubriter nos
ammonensait.omnemsollicitudinemuestramproicientesineum	ammonens ait . omnem sollicitudinem uestram proicientes ineum
.quoniamipsicuraestde	. quoniam ipsi cura est de
uobis.hecautemsollicitudodiuinecaritatiset	uobis . hec autem sollicitudo diuine caritatis et
compassionisergamiserum.etuitiorumfetentiumsordibusobuolutum:	compassionis erga miserum . et uitiorum fetentium sordibus obuolutum :
inuerbisquepremisimuseuidenter	in uerbis que premisimus euidenter
exprimitur.ubiscriptum	exprimitur . ubi scriptum
est.fremuitiehsuspiritu.etceterain	est . fremuit iehsu spiritu . etcetera in
quibusuerbisquatuornobisdiligentiusattendendaproponuntur.	quibus uerbis quatuor nobis diligentius attendenda proponuntur .
queinsuscitatione	que in suscitatione
lazari.nonsineterticausamisterii.dominusegisseperhibetur	lazari . non sine terti causamisterii . dominus egisse perhibetur
.fremuitenimspiritu.turbauit	. fremuit enim spiritu . turbauit
seipsum.lacrimatusest.etclamauit.	se ipsum . lacrimatus est . et clamauit .
Queigituirredemptornosterinsuscitationelazaricorporaliterexhibuit:	Que igituir redemptor noster in suscitatione lazari corporaliter exhibuit :
heciniustitficationepeccatoris.peruisitationissue	hec in iustitficatione peccatoris . per uisitationis sue
gratiamcotidiespiritaliteroperarinondesistit.fremit	gratiam cotidie spiritaliter operari non desistit . fremit
enimspiritu.dumpeccatorem	enim spiritu . dum peccatorem
perillicitadefluentem.	per illicita defluentem .
detereteternisuppliciicomminatione.quasiturbatumseostenditcum	deteret eterni supplicii comminatione . quasi turbatum se ostendit cum
inpenitentemut	in penitentem ut
adlamentapenitentieredeat:temporaliconcutitaduersitate.	ad lamenta penitentie redeat : temporali concutit aduersitate .
necesseestenimut	necesse est enim ut
quempremianoninuitant:saltemterrores	quem premia non inuitant : saltem terrores
eternedampnationis.etangustietemporalisaduersitatis.apeccatis	eterne dampnationis . et angustie temporalis aduersitatis . a peccatis
retrahant.lacrimatur	retrahant . lacrimatur
autemdumperaffectumpaterne	autem dum per affectum paterne
pietatispenitentemsuscipitadueniam.uoce	pietatis penitentem suscipit adueniam . uoce
ueroclamosamortuum	uero clamosa mortuum
resuscitat:dumde	resuscitat : dum de
profundauitiorumuoraginemisericorditerereptum.peruirtutemuere	profunda uitiorum uoragine misericorditer ereptum . per uirtutem uere
confessionis:	confessionis :
reuocatad	reuocat ad
uitam.nonnemanifestecontra	uitam . nonne manifeste contra
peccatoresfremereuidetur	peccatores fremere uidetur
dominus.ubiait.mittenturintenebrasexteriores.	dominus . ubi ait . mittentur in tenebras exteriores .
ibieritfletusetstridordentium:etiamalibi	ibi erit fletus et stridor dentium : etiam alibi
.perysaiamprophetamdeelectisloquiturdicens.Egredientur	. per ysaiam prophetam de electis loquitur dicens . Egredientur
.etuidebunt	. et uidebunt
cadauerauirorum.quipreuaricatisuntinme	cadauera uirorum . qui preuaricati sunt in me
.uermiseorumnonmorietur.etignisnonextinguetur	. uermis eorum non morietur . et ignis non extinguetur
.eteruntusqueadsacietatemuisionisomnicarni.	. et erunt usque ad sacietatem uisionis omni carni .
hancfremitumpreuiderat	hanc fremitum preuiderat
inspirituprophetaabacuc	in spiritu propheta abacuc
cumdicebat.Infremituconculcabisterram.	cum dicebat . In fremitu conculcabis terram .
infuroreobstupefacies	in furore obstupefacies
gentes.Infremituinquitconculcabisterram	gentes . Infremitu inquit conculcabis terram
.idesthominesterrenasapientes.penametiam	. idest homines terrena sapientes . penam etiam
reproborumdescribensprophetadauid.secretorumdeiconscius	reproborum describens propheta dauid . secretorum dei conscius
.tuueroinquitduceseosinputeuminteritus.In	. tu uero inquit duces eos inputeum interitus . In
quibusuerbisbreuiternotaturpenarumgehennaliumperpetuitas.	quibus uerbis breuiter notatur penarum gehennalium perpetuitas .
acerbitassimuletuarietas.perputeumenimde	acerbitas simul et uarietas . per puteum enim de
cuiusprofunditatenonpatetegressuspenarumperpetuitasexprimitur.per	cuius profunditate non patet egressus penarum perpetuitas exprimitur . per
interitum:acerbitasearumdemdesignatur.perhocautemquod	interitum : acerbitas earumdem designatur . per hoc autem quod
dictumest.	dictum est .
deduceseos:	deduces eos :
tormentorumuarietasqueuariisdebeturpeccatorumgenerationibus	tormentorum uarietas que uariis debetur peccatorum generationibus
:conuenienterintelligitur.undeinlibroiobscriptumest	: conuenienter intelligitur . unde in libro iob scriptum est
.transibuntdeaquis	. transibunt de aquis
niuiumadcalorem	niuium ad calorem
nimium.nonsolumautemfremuitiehsusspiritu	nimium . non solum autem fremuit iehsus spiritu
.sedetturbauitse	. sed et turbauit se
ipsumlacrimatus	ipsum lacrimatus
est.etclamauit	est . et clamauit
.sedquid	. sed quid
estdomineiehsu.quodturbarisintemetipso	est domine iehsu . quod turbaris in temet ipso
quiutscriptumest.omniacumtranquillitateiudicas.	qui ut scriptum est . omnia cum tranquillitate iudicas .
quiespaxuera.que	qui es pax uera . que
omnemsensumexuperat.quisemperidemipsees	omnem sensum exuperat . qui semper idem ipse es
.stabilisquemanens.das	. stabilis que manens . das
cunctamoueri.	cuncta moueri .
undetibilacrime.	unde tibi lacrime .
quepenitentiesunt	que penitentie sunt
indicia.quipeccatumnon	indicia . qui peccatum non
fecisti.nec	fecisti . nec
estinuentusdolusinoretuo.	est inuentus dolus in ore tuo .
quipaternepietatishabundantia:proinimicismortemsubirenon	qui paterne pietatis habundantia : pro inimicis mortem subire non
dubitasti.	dubitasti .
quiprocrucifixoribuscuisutnonperirentorasti	qui pro crucifixoribus cuis ut non perirent orasti
.quideniqueproconciliandistibipeccatoribustanta	. qui denique pro conciliandis tibi peccatoribus tanta
sustinuisti:sedattenditefratres.quenon	sustinuisti : sed attendite fratres . que non
solumquecumque	solum quecumque
scripta.sedetquecumquefactasunt	scripta . sed et quecumque facta sunt
.adnostramdoctrinamscriptaetfactasunt.ut	. ad nostram doctrinam scripta et facta sunt . ut
quiperadoptionis	qui per adoptionis
gratiammembrachristisumus.	gratiam membra christi sumus .
totastudeamusimitarideuotione.quod	tota studeamus imitari deuotione . quod
prosalutenostragestumesseconstat	pro salute nostra gestum esse constat
incapite.Quodenimchristusnasci.circumcidi	in capite . Quod enim christus nasci . circumcidi
.crucifigi.moriuoluit:	. crucifigi . mori uoluit :
nichilhorumpropterse.	nichil horum propter se .
sedomnia	sed omnia
propterelectossustinuit.nequeenim.in	propter electos sustinuit . neque enim . in
peccatonatus.nec	peccato natus . nec
apeccatocircumcisus.necpropeccatosuo.sed	a peccato circumcisus . nec pro peccato suo . sed
propterdelictanostramortuusest.paulo	propter delicta nostra mortuus est . paulo
apostoloattestantequiait.	apostolo attestante qui ait .
christusmortuusestpropterdelictanostraetresurrexitpropter	christus mortuus est propter delicta nostra et resurrexit propter
iustificationemnostram.sicet	iustificationem nostram . sic et
propternos.nonautempropterse.	propter nos . non autem propter se .
fremuitspiritu.turbauitseipsum.lacrimatus	fremuit spiritu . turbauit se ipsum . lacrimatus
est.etclamauit.	est . et clamauit .
fremuitinquamspiritu.utsalutaremcontra	fremuit inquam spiritu . ut salutarem contra
uitiafremitumincordibusnostrissuscitaret.turbauit	uitia fremitum in cordibus nostris suscitaret . turbauit
semetipsum:utquantumdeperpetratismalisturbari.	semet ipsum : ut quantum deperpetratis malis turbari .
etdoleredebeamus:	et dolere debeamus :
innotesceret.lacrimatusest.utnosprouocaretadlacrimas	innotesceret . lacrimatus est . ut nos prouocaret ad lacrimas
deuotecompunctionis.clamauitautem:utcorde	deuote compunctionis . clamauit autem : ut corde
contritosinuitaretadremediumsalutifereconfessionis	contritos inuitaret ad remedium salutifere confessionis
.tuncenim	. tunc enim
christusin	christus in
nobisclamarenonincongruedicitur	nobis clamare non incongrue dicitur
.cumnosutinconfessionepeccatorumclamemus.	. cum nos ut in confessione peccatorum clamemus .
salubriterexhortatur.Illeigiturutiliterclamatquiruptopudoris	salubriter exhortatur . Ille igitur utiliter clamat qui rupto pudoris
etuerecundiesilentio:peccatorumsuorumuulnera.in	et uerecundie silentio : peccatorum suorum uulnera . in
confessionedetegitet	confessione detegit et
manifestat.Ethocestquod	manifestat . Et hoc est quod
aitdominus.lazareueniforas.perlazarum	ait dominus . lazare ueni foras . per lazarum
quifetensetquatriduanusin	qui fetens et qua triduanus in
sepulcrolatuit	sepulcro latuit
.peccatoremquemlibetnoninmeritoaccipimus	. peccatorem quemlibet non in merito accipimus
.quipressusmolepraueconsuetudinis.sub	. qui pressus mole praue consuetudinis . sub
latebristenebrose	latebris tenebrose
conscientieseabscondit.Quidum	conscientie se abscondit . Qui dum
scelerumsuorum	scelerum suorum
inmanitateterritus.conscientiefeditate	in manitate territus . conscientie feditate
confusus.ne	confusus . ne
uiassuasdominomanifestet.noxio	uias suas domino manifestet . noxio
pudoreuincitur:uelutincarcereligatus	pudore uincitur : uelut in carcere ligatus
etinclusus.neforasprodireualeatprohibetur.De	et inclusus . ne foras prodire ualeat prohibetur . De
quoinlibro	quo in libro
iob.benescriptumest.siincluseritdeushominem	iob . bene scriptum est . si incluserit deus hominem
:nullusestquiaperiat.certepeccator	: nullus est qui aperiat . certe peccator
quilibetineo	quilibet in eo
quodmaleoperatur.conscientiesuecarcerem	quod male operatur . conscientie sue carcerem
sibifacit.neeuadendilocuminueniat.quam	sibi facit . ne euadendi locum inueniat . quam
peccatisexigentibusoptinerenon	peccatis exigentibus optinere non
meretur.Includitautemdeushominem.	meretur . Includit autem deus hominem .
duminclusononaperit	dum incluso non aperit
.pergratie	. per gratie
spiritualisinfusionem.utigitur	spiritualis infusionem . ut igitur
sicinclususliber	sic inclusus liber
exireualeat.	exire ualeat .
uteducaturuinctusdedomocarceris.sedensin	ut educatur uinctus de domo carceris . sedens in
tenebris.etumbramortis:necesseestut	tenebris . et umbra mortis : necesse est ut
clauisdauidchristusscilicet.	clauis dauid christus scilicet .
quiclauditetnemoaperit.aperit	qui claudit et nemo aperit . aperit
etnemoclaudit.solutispeccatorumuinculis	et nemo claudit . solutis peccatorum uinculis
.fractis	. fractis
uitiorumseris:liberauoceclametetdicat.	uitiorum seris : libera uoce clamet et dicat .
lazareueniforas.portaautemperquamreoaditus	lazare ueni foras . porta autem per quam reo aditus
euadendiconceditur.	euadendi conceditur .
confessiopeccatorumest.quediuhabitantibusinregione	confessio peccatorum est . que diu habitantibus in regione
umbremortis.demumlucemgratie	umbre mortis . demum lucem gratie
spiritualisinfundit.etereptosauetusta	spiritualis infundit . et ereptos a uetusta
seruitutepeccati:inlibertatem	seruitute peccati : in libertatem
spiritus.etuitenouitatemrestituit.portahec	spiritus . et uite nouitatem restituit . porta hec
fratres.portasalutisestetiustitie.	fratres . porta salutis est et iustitie .
adeoutquilibetdenaufragiomundihuiuseuadere	adeo ut quilibet de naufragio mundi huius euadere
cupiens.necessehabeattransirepeream	cupiens . necesse habeat transire per eam
.utcumpsalmista	. ut cum psalmista
possitdicere.aperitemihiportamiustitie.etingressus	possit dicere . aperite mihi portam iustitie . et ingressus
ineam.confitebor	in eam . confitebor
domino.hecportadomini.iustiintrabunt	domino . hec porta domini . iusti intrabunt
meam.necesseestinquamutperportamsalutisad	meam . necesse est inquam ut per portam salutis ad
denmredeat.	denm redeat .
quiperportas	qui per portas
mortisegressus:	mortis egressus :
inregionedissimilitudinis.ab	in regione dissimilitudinis . ab
eolongiusab	eo longius ab
errauerat.suntautemtresportemortis.	errauerat . sunt autem tres porte mortis .
perquasfiliihuiusseculiadamoremmundihuius	per quas filii huius seculi ad amorem mundi huius
ingrediuntur.quas	ingrediuntur . quas
studiisomnibusdeclinaresataguntquideductiperportas	studiis omnibus declinare satagunt qui deducti per portas
iusticie:adpatriamclaritatis	iusticie : ad patriam claritatis
eterne:celestis	eterne : celestis
gatiemunereperducuntur.Etestprimaportamortis:	gatie munere perducuntur . Et est prima porta mortis :
carnalisconcupiscentiemomentanea	carnalis concupiscentie momentanea
uoluptas.secunda:rerumtranseuntiuminmoderatacupiditas	uoluptas . secunda : rerum transeuntium in moderata cupiditas
.tercia:gloriesecularisuanasublimitas.has	. tercia : glorie secularis uana sublimitas . has
portasmortisinepistolasuabeatus	portas mortis in epistola sua beatus
iohaneseuidenterexprimit.ubi	iohanes euidenter exprimit . ubi
ait.omne	ait . omne
quodestin	quod est in
mundoautestconcupiscentiacarnis	mundo aut est concupiscentia carnis
.autconcupiscentiaoculorum.uelsuperbia	. aut concupiscentia oculorum . uel superbia
uite.concupiscentiaenimcarnis.referturaduoluptatem.	uite . concupiscentia enim carnis . refertur ad uoluptatem .
concupiscentiaoculorum:ad	concupiscentia oculorum : ad
mundanamcupiditatem.superbiauite:ad	mundanam cupiditatem . superbia uite : ad
gloriesecularis.sublimitatem.Et	glorie secularis . sublimitatem . Et
quidemperportamcarnalis	quidem per portam carnalis
concupiscentiequodsine	concupiscentie quod sine
grauimeroredicendum	graui merore dicendum
nonest.	non est .
ingrediunturinnumeri.eoquod	ingrediuntur in numeri . eo quod
patensintroitus.	patens introitus .
etspatiosauiasit	et spatiosa uia sit
queducitad	que ducit ad
eam.quodnimirumcertissimeprobanthii.	eam . quod nimirum certissime probant hii .
quitimoredeipostposito	qui timore dei post posito
.cubilibusuacantetin	. cubilibus uacant et in
pudicitiis.etcarnissuedesideriasequentesuelutiumenta	pudicitiis . et carnis sue desideria sequentes uel ut iumenta
computrueruntinstercoribussuis.quiin	computruerunt in stercoribus suis . qui in
carneseminant.etdecarnemetuent	carne seminant . et de carne metuent
corruptionem.iocisdelectanturetnisibus.et	corruptionem . iocis delectantur et nisibus . et
exteriorinitorecorporis:	exteriori nitore corporis :
interiorishominisdeformantpulcritudinem	interioris hominis deformant pulcritudinem
.certequamdetestabilissitcarnalisconcupiscentieuoluptas	. certe quam detestabilis sit carnalis concupiscentie uoluptas
.exeonimirumcolligitur.	. ex eo nimirum colligitur .
quodappetituseius:anxietatis	quod appetitus eius : anxietatis
etuecordie.	et uecordie .
actus:confusioniset	actus : confusionis et
ignominie.exitus:penitudiniset	ignominie . exitus : penitudinis et
uerecundieplenus	uerecundie plenus
essedinoscitur	esse dinoscitur
.undesecularisilleferturdixissephilosophus	. unde secularis ille fertur dixisse philosophus
uilisresluxuriadeuilummembrorumdescendensoperatione	uilis res luxuria de uilum membrorum descendens operatione
.cuiusnecesse	. cuius necesse
estutinfinepeniteas.porroper	est ut in fine peniteas . porro per
portammundanecupiditatisingrediuntur.	portam mundane cupiditatis ingrediuntur .
hiiquilucrisinhiantesillicitis.	hii qui lucris in hiantes illi citis .
questumpietatemexistimant	questum pietatem existimant
.inquibus	. inquibus
amordiuitiaruminsaciabilis.animammiseramdesideriocruciat.sed	amor diuitiarum insaciabilis . animam miseram desiderio cruciat . sed
usunequaquamrefrigerat.quodenimcum	usu nequaquam refrigerat . quod enim cum
laboreadquiritur.cumtimorepossidetur	labore adquiritur . cum timore possidetur
.etquodhiislongeinfelicius	. et quod hiis longe infelicius
:tandem	: tandem
cumdoloremiserabiliteramittitur.undequidamspiritu	cum dolore miserabiliter amittitur . unde quidam spiritu
deiplenus.deamatoribus	dei plenus . de amatoribus
huiusmundi.satiseleganterait.Queruntutadquirant	huius mundi . satis eleganter ait . Querunt ut adquirant
.adquirunt	. adquirunt
.utperdant.perdunt	. ut perdant . perdunt
utdoleant.Etpaulus	ut doleant . Et paulus
apostolus.Quiuoluntinquitdiuitesfieri.inciduntin	apostolus . Qui uolunt inquit diuites fieri . incidunt in
temptationes.	temptationes .
etinlaqueumdiaboli.etindesideriamulta	et in laqueum diaboli . et in desideria multa
inutiliaetnociua.quemergunthominemin	inutilia et nociua . que mergunt hominem in
interitumetperditionem.superquemlocumsicaitexpositor	interitum et perditionem . super quem locum sic ait expositor
.nichiltamasperum.nichiltampernitiosum.quam	. nichil tam asperum . nichil tam pernitiosum . quam
siuirecclesiasticus.maximesublimemtenenslocum.	si uir ecclesiasticus . maxime sublimem tenens locum .
diuitiishuiusseculistudeat.	diuitiis huius seculi studeat .
talisenim	talis enim
nonsolumse.sedetceteros:	non solum se . sed et ceteros :
performamcontrariampericulosubicit.et	per formam contrariam periculo subicit . et
inruinamprecipitat.terciaporta	in ruinam precipitat . tercia porta
mortis.est	mortis . est
sublimitasgloriesecularis.que	sublimitas glorie secularis . que
reueraconiuncta	reuera coniuncta
estporte.quamdescripsimusnominemundane	est porte . quam descripsimus nomine mundane
cupiditatis.fit	cupiditatis . fit
enimplerumque.utperhabundantiamdiuitiarum.pateatascensus	enim plerumque . ut perhabundantiam diuitiarum . pateat ascensus
adculmensecularumdignitatum.undepaulusin	ad culmen secularum dignitatum . unde paulus in
potentibushuiusmundimorbumdiuitiarum.idest	potentibus huius mundi morbum diuitiarum . idest
superbiamuolensreprimere:thimotheoscribensait.	superbiam uolens reprimere : thimotheo scribens ait .
precipediuitibus	precipe diuitibus
huiusseculi.	huius seculi .
nonsublime	non sublime
sapere.nequesperareinincertodiuitiarum.	sapere . neque sperare in incerto diuitiarum .
sedindeouiuo.quidat.	sed in deo uiuo . qui dat .
nobishabundanteromniaadfruendum.Inhac	nobis habundanter omnia ad fruendum . In hac
portasedemsibistatuerunt.quidignitatesecclesiasticas	porta sedem sibi statuerunt . qui dignitates ecclesiasticas
licetindignicecanimisambitione.impudenterusurpantet	licet indigni cecanimis ambitione . impudenter usurpant et
rapiunt.	rapiunt .
dequibusdominusperysaiamprophetamconqueriturdicens.	de quibus dominus per ysaiam prophetam conqueritur dicens .
Ipsiregnauerunt.etnonex	Ipsi regnauerunt . et non ex
me.principesexciterunt	me . principes exciterunt
.etnoncognoui.talesenimpre	. et non cognoui . tales enim pre
essenesciunt.	esse nesciunt .
subesse	sub esse
nonsustinent.etprodessenonsatagunt.elongari	non sustinent . et prodesse non satagunt . elongari
prorsusadoctrinasaluatoris.	prorsus a doctrina saluatoris .
quadicit.Quimaiorestuirum.erit	qua dicit . Qui maior est uirum . erit
ministeruester.ubiplaneministeriumsubiectionisdominusindicit.	minister uester . ubi plane ministerium subiectionis dominus indicit .
sedambitionemdampnationispenitusinterdicit.etquod	sed ambitionem dampnationis penitus interdicit . et quod
uerboprecipit:exemploroborat	uerbo precipit : exemplo roborat
.Egoinquitinmediouestrumsum.	. Ego inquit in medio uestrum sum .
tanquamquiministrat.	tanquam qui ministrat .
Quiautemmundihuiusuenanturgloriam.infauoris	Qui autem mundi huius uenantur gloriam . in fauoris
popularisaurasectandadelectantur.insplendoreuestium.in	popularis aura sectanda delectantur . in splendore uestium . in
ciborumglorianturuoluptate.amantprimos	ciborum gloriantur uoluptate . amant primos
recubitusincenis.etprimas	recubitus in cenis . et primas
cathedrasinsynagogis.salutationesin	cathedras in synagogis . salutationes in
foro.etuocariabhominibusrabicumtamen	foro . et uocari ab hominibus rabi cum tamen
dominusineuangeliodicat.neuocemini	dominus in euangelio dicat . neuocemini
magistri.quiamagisteruesterunusestchristus.hee	magistri . quia magister uester unus est christus . hee
suntportemortis	sunt porte mortis
quasenummauimus.porteinferi.perquasfiliihuius	quas enummauimus . porte inferi . per quas filii huius
seculigradientes.ruuntinprecipicium.quibus	seculi gradientes . ruunt in precipicium . quibus
portesalutisopponuntur.perquasnecesseest	porte salutis opponuntur . per quas necesse est
utintroeat.qui	ut introeat . qui
inoffensopedetenderecontendit	in offenso pede tendere contendit
addeum.	ad deum .
Etestprimaportasalutis	Et est prima porta salutis
.deuotacordis	. deuota cordis
compunctio.secunda:ueraethumilis	compunctio . secunda : uera et humilis
orisconfessio.tercia:condigna	oris confessio . tercia : condigna
operissatisfactio.De	operis satisfactio . De
hiisportispsalmistaait.Introiteportaseius	hiis portis psalmista ait . Introite portas eius
inconfessione.atriaeiusinhymnisconfiteminiilli.	in confessione . atria eius in hymnis confitemini illi .
heesuntporteparadisi.dequibushiisdiebus	hee sunt porte paradisi . de quibus hiis diebus
canimus.paradisiportasaperuitnobisieiuniitempus	canimus . paradisi portas aperuit nobis ieiunii tempus
.hasportaspetrusintroierat.dumpostinmanitatem	. has portas petrus introierat . dum post inmanitatem
culpe.misericorditerrespectusest	culpe . misericorditer respectus est
adomino.et	a domino . et
egressusforas.fleuit	egressus foras . fleuit
amare.Inegressu	amare . In egressu
enimnotaturconfessio.infletuamaro:cordisconpunctio	enim notatur confessio . in fletu amaro : cordis conpunctio
.quodautemin	. quod autem in
eosecutasitcondignasatisfactiooperis:	eo secuta sit condigna satisfactio operis :
exeonimirumcolligitur.quodposttamgrauis	ex eo nimirum colligitur . quod post tam grauis
lapsusprecipicium:adtanterediiteminentiam	lapsus precipicium : ad tante rediit eminentiam
sanctitatis.pulsemusdilectissimifratresad	sanctitatis . pulsemus dilectissimi fratres ad
portasistas.etaperienturnobis.aperta	portas istas . et aperientur nobis . aperta
estnobissiuolumusuiapenitentie.quia	est nobis si uolumus uia penitentie . quia
sicutaitbeatus	sicut ait beatus
beatusiohanesapostolus.si	beatus iohanes apostolus . si
confiteamurpeccatanostra.fidelisetiustusestdominius	confiteamur peccata nostra . fidelis et iustus est dominius
.utremittat	. ut remittat
nobispecctanostra.etemundetnos	nobis peccta nostra . et emundet nos
abomniiniquitate.Itaquefratresdirigamusoperanostra	ab omni iniquitate . Itaque fratres dirigamus opera nostra
adexemplar.quodnobisinmontemonstratumest.	ad exemplar . quod nobis in monte monstratum est .
utuidelicetunusquisquenostramfremat	ut uidelicet unusquisque nostram fremat
spiritu.turbetseipsum.lacrimetur.	spiritu . turbet se ipsum . lacrimetur .
etclamet.	et clamet .
frematinquamin	fremat in quam in
sefremat	se fremat
etcontrase.Inse	et contra se . In se
quidem:per	quidem : per
interioremcordisamaritudinem.contrase.per	interiorem cordis amaritudinem . contra se . per
exterioremcorporisafflictionem.utdicerepossitcumpsalmista.	exteriorem corporis afflictionem . ut dicere possit cum psalmista .
afflictussumethumiliatussumnimis.	afflictus sum et humiliatus sum nimis .
rugiebamagemitucordismei	rugiebam a gemitu cordis mei
.turbetetiamseipsumperdolorem.lacrimetur	. turbet etiam se ipsum per dolorem . lacrimetur
perpietatem	per pietatem
.clametperorationem.Exaudistiinquituocedeprecationis	. clamet per orationem . Exaudisti inquit uoce deprecationis
mee.dumclamaremadte	mee . dum clamarem ad te
.clamet.autem.	. clamet . autem .
etdicatanime	et dicat anime
sue.lazareueniforas.lazarusinterpretaturadiutus	sue . lazare ueni foras . lazarus interpretatur adiutus
.perlazarumigiturquelibetfidelisanimaconuenientur	. per lazarum igitur quelibet fidelis anima conuenientur
accipitur.quepotissimumillius	accipitur . que potissimum illius
indigetadiutoris:quide	indiget adiutoris : qui de
seipsodicit	se ipso dicit
sinemenichilpotestisfacere.Etdequopsalmista	sine me nichil potestis facere . Et de quo psalmista
ait.adiutor	ait . adiutor
inoportunitatibusintribulatione.sperentintequinouerunt	in oportunitatibus in tribulatione . sperent in te qui nouerunt
te.Quamfidelisquamnecessariussit	te . Quam fidelis quam necessarius sit
adiutoriste.manifestedeclarat	adiutor iste . manifeste declarat
ecclesia.queper	ecclesia . que per
singulashorasdeuotisipsumprecibusinuocans.deusinquitin	singulas horas deuotis ipsum precibus inuocans . deus inquit in
adiutoriummeumintende.domine	adiutorium meum intende . domine
adadiuuandammefestina.hecigiturfidelis	ad adiuuandam me festina . hec igitur fidelis
anima.que	anima . que
perlazarumsignificataest.uocante	per lazarum significata est . uocante
domino.forasuenit.duma.	domino . foras uenit . dum a .
mortepeccatiresuscitata.inluce	morte peccati resuscitata . in luce
bonorumoperumambulat.etcooperantegratia	bonorum operum ambulat . et cooperante gratia
deuirtuteinuirtutemproficit.Queetiam	de uirtute in uirtutem proficit . Que etiam
adtantamregiseternifamiliaritatemdignanter	ad tantam regis eterni familiaritatem dignanter
admittitur.utinconuiuioeius	admittitur . ut in conuiuio eius
plenodeliciisomnibus.	pleno deliciis omnibus .
recumberedignareperiatur.	recumbere digna reperiatur .
sicenimscriptumestiniohaniseuangelio.ante	sic enim scriptum est in iohanis euangelio . ante
quinquediespasche.uenit	quinque dies pasche . uenit
iehsubethaniam.ubilazarusfueratmortuus	iehsu bethaniam . ubi lazarus fuerat mortuus
.fecerunt	. fecerunt
autemeicenamibi	autem ei cenam ibi
.lazarusuerounuseratexdiscumbentibuscumeo	. lazarus uero unus erat ex discumbentibus cum eo
.hanccenamfratreseternamsacietatemdiuineuisionisaccipimus	. hanc cenam fratres eternam sacietatem diuine uisionis accipimus
.dequacenainapocalipsiscriptumest	. de qua cena in apocalipsi scriptum est
.Beatiqui	. Beati qui
adcenamnuptiarum	ad cenam nuptiarum
agniuocatisunt.sponsusetiamincanticis:	agni uocati sunt . sponsus etiam in canticis :
hiusceneconuiuasalloquens:	hius cene conuiuas alloquens :
etadepulandumgratulanterinuitans:aitcomediteamici	et ad epulandum gratulanter inuitans : ait comedite amici
.etbibite.	. et bibite .
etinebriaminikarissimi.Inquibusuerbisnotandumest	et inebriamini karissimi . In quibus uerbis notandum est
.quiaquicomeduntamici	. quia qui comedunt amici
.quiuerobibuntetinebriabuntur:	. qui uero bibunt et inebriabuntur :
perhibenturessekarissimi.sanctienim	perhibentur esse karissimi . sancti enim
inpresentiuita	in presenti uita
comedunt.dumsupernecontemplationis	comedunt . dum superne contemplationis
dulcedinempregustantes:suauiuirtutum	dulcedinem pregustantes : suaui uirtutum
delectationesereficiunt.In	delectatione se reficiunt . In
eternaautembeatitudinebibuntetinebriantur.	eterna autem beatitudine bibunt et inebriantur .
dumtranslatiin	dum translati in
gloriam:perfectadiuinecognitionisplenitudine.etinterni	gloriam : perfecta diuine cognitionis plenitudine . et interni
amorisiocunditateperfruuntur.Dehiisinpsalmoscriptum	amoris iocunditate perfruuntur . De hiis in psalmo scriptum
est.Inebriabuntur	est . Inebriabuntur
abubertatedomustue.ettorrenteuoluptatistuepotabiseos	abubertate domus tue . et torrente uoluptatis tue potabis eos
.huiustorrentisuoluptate.nos	. huius torrentis uoluptate . nos
ineternoconuiuio.non	in eterno conuiuio . non
solumpotare.sedetinebriaredignetur	solum potare . sed et inebriare dignetur
sponsusecclesiedominusnosteriehsu	sponsus ecclesie dominus noster iehsu
christus.utabsortamorte	christus . ut absorta morte
inuictoriam.ineoqui	in uictoriam . in eo qui
uitanostra	uita nostra
est.sinefinefeliciteruiueremereamur	est . sine fine feliciter uiuere mereamur
.prestanteeodemdominonostroiehsuchristo.cuius	. prestante eodem domino nostro iehsu christo . cuius
regnumetimperiumpermanetin	regnum et imperium permanet in
seculaseculorum	secula seculorum
.amensermoinquadragesimaQuichristisunt:	. amen sermo in quadragesima Qui christi sunt :
carnemsuamcrucifixerunt	carnem suam crucifixerunt
cumuitiiset	cum uitiis et
concupiscentiis.simultiplicesuitepresentismiserias.	concupiscentiis . si multiplices uite presentis miserias .
quibusmiserhomoculpisexigentibusincessanteraffligitur.diligentiusattendamus	quibus miser homo culpis exigentibus incessanter affligitur . diligentius attendamus
.incolatusnostriprolongationem.cumpsalmistanonimmeritodeflere	. incolatus nostri prolongationem . cum psalmista non immerito deflere
possumus.licetenimteste	possumus . licet enim teste
prophetabreuessicutdieshominis.inhoc	propheta breues sicut dies hominis . in hoc
tameneorumlongitudononinconuenienter	tamen eorum longitudo non inconuenienter
attendatur.eoquod	attendatur . eo quod
multisrepleanturmiseriis.siquidem	multis repleantur miseriis . siquidem
culpamsecumtrahit.uniuscuisqueconceptio	culpam secum trahit . unius cuisque conceptio
.penam:	. penam :
natiuitas.uita:labores	natiuitas . uita : labores
eterumpnasfinisuero:doloresetmiserias.	et erumpnas finis uero : dolores et miserias .
Estenimsicut	Est enim sicut
luceclariusconstat.culpabilishumaneconditionisingressus.	luce clarius constat . culpabilis humane conditionis ingressus .
penalishumane	penalis humane
conuersationisprogressus.miserabilisuerohumaneresolutionis	conuersationis progressus . miserabilis uero humane resolutionis
egressus.hancmortalisuite	egressus . hanc mortalis uite
miseriam.beatusiobinteriorimentisoculo	miseriam . beatus iob interiori mentis oculo
subtiliusintuens:plangitdicens	subtilius intuens : plangit dicens
.Quarenon	. Quare non
inuuluamortuus	in uulua mortuus
sum.egressusexuterononstatimperii:cur	sum . egressus ex utero non statim perii : cur
exceptusgenibus:curlactatusuberibus	exceptus genibus : cur lactatus uberibus
:pereatdiesinquanatus	: pereat dies in qua natus
sum.etnoxin	sum . et nox in
quadictumest.conceptus	qua dictum est . conceptus
esthomo.hincetsalomonait.cuncti	est homo . hinc et salomon ait . cuncti
dieshominislaboribuseterumpnisplenisunt.	dies hominis laboribus et erumpnis pleni sunt .
necpernoctemmenterequiescit.	nec per noctem mente requiescit .
Etinecclesiasticoscriptumest	Et in ecclesiastico scriptum est
.occupatiomagnacreataestomnibushominibus.	. occupatio magna creata est omnibus hominibus .
etiugumgrauesuperfiliosadam.adie	et iugum graue super filios adam . a die
exitusdeuentrematriseorum.	exitus de uentre matris eorum .
usqueindiemsepulturein	usque in diem sepulture in
matremomniumIn	matrem omnium In
tribusautemstatushumanimiseriaprecipueuidetur	tribus autem status humani miseria precipue uidetur
consisitere.uidelicet.ignorantia.concupiscentia.	consisitere . uidelicet . ignorantia . concupiscentia .
etinpotentia.Ignorantiainquamboni.concupiscentiamali	et inpotentia . Ignorantia inquam boni . concupiscentia mali
.etimpotentiapeccatoresistendi.	. et impotentia peccato resistendi .
suntpleriquequisecularibusaffectidesideriis.non	sunt plerique qui secularibus affecti desideriis . non
solumbonaqueintelligunt.	solum bona que intelligunt .
ineffectuprosequidedignantur.uerum	in effectu pro se qui dedignantur . uerum
etiamsupinaquadametuelut	etiam supina quadam et uelut
affectatamentisignorantia.penitusexcecati:nolunt	affectata mentis ignorantia . penitus excecati : nolunt
intelligereutbene	intelligere ut bene
operentur.Dequibus	operentur . De quibus
inpsalmoscriptumest.nescieruntnequeintellexerunt	in psalmo scriptum est . ne scierunt neque intellexerunt
.intenebrisambulant	. in tenebris ambulant
.Etalibi.obscurentur	. Et alibi . obscurentur
oculieorumne	oculi eorum ne
uideant.etdorsumeorum	uideant . et dorsum eorum
semperincurua	semper in curua
.Iustumquippeest	. Iustum quippe est
utquorummentes.que	ut quorum mentes . que
peroculosrectesignificatesunt:ignorantietenebrisobscurantur.	per oculos recte significate sunt : ignorantie tenebris obscurantur .
eorumdorsumadportandapeccatorumonera:	eorum dorsum adportanda peccatorum onera :
perconsensuminiquitatisincuruetur.	per consensum iniquitatis incuruetur .
porroconcupiscentiamali.statushumanimiseriam	porro concupiscentia mali . status humani miseriam
miserabiliteraccumulat.patetenim	miserabiliter accumulat . patet enim
.quiapronisuntadmalum	. quia proni sunt ad malum
sensushominis.procliuisestin	sensus hominis . procliuis est in
uitiumcorruptamentisaffectio	uitium corrupta mentis affectio
.queextirpatauitemundicia.miseram	. que extirpata uite mundicia . miseram
animamcarnalibusillecebrisilla	animam carnalibus illecebris illa
querandocoinquinat	querando coinquinat
.etquamcelo	. et quam celo
redderedebueratperinnocentiametuitepuritatem.incessantergehenne	reddere debuerat per innocentiam et uite puritatem . incessanter gehenne
preparat:permultimodamuitiorum	preparat : per multimodam uitiorum
corruptionem.	corruptionem .
Inpotentiaueroresistendipeccato	In potentia uero resistendi peccato
adplenammiserieconsummationem:peccatis	ad plenam miserie consummationem : peccatis
exigentibusinflicta	ex igentibus inflicta
esthomini.roborespiritalisgratiedestituto.	est homini . robore spiritalis gratie destituto .
Quidenimmiserabiliusquam	Quid enim miserabilius quam
sicuulnerari.utultranonsitsanitas	sic uulnerari . ut ultra non sit sanitas
.sicincidereinlaqueum.utliberationemlocusiam	. sic incidere in laqueum . ut liberationem locus iam
nonpateat.sicprecipiciumincurrere:utadicere	non pateat . sic precipicium incurrere : ut adicere
nonpossitpersemiserhomodeinceps	non possit per se miser homo deinceps
.utresurgat:Ethoc	. ut resurgat : Et hoc
quidemmanifestum	quidem manifestum
estiustodeiiudiciofieri.utquemad	est iusto dei iudicio fieri . ut quem ad
modumtestaturapostolus.	modum testatur apostolus .
quifacitpeccatum	qui facit peccatum
:seruussitpeccati.necapeccatosecontinere	: seruus sit peccati . nec a peccato se continere
propriauirtuteualeatetiamcumuoluerit:qui	propria uirtute ualeat etiam cum uoluerit : qui
uiciiscarnalibusinherendo	uiciis carnalibus in herendo
:donumcontinentiegratisoblatum:uelut	: donum continentie gratis oblatum : uel ut
ingratusabiecit.uerumquodhumanefragilitatisoptinerenonualet	ingratus abiecit . uerum quod humane fragilitatis optinere non ualet
inpotentia	in potentia
.salubriterprouiderecurauit.sinequa	. salubriter prouidere curauit . sine qua
uirtusomnisinfirmaest:	uirtus omnis infirma est :
adiutrixgratia.tripliciigiturmiserie.	adiutrix gratia . triplici igitur miserie .
triplexmisericordieremedium.mediatrix	triplex misericordie remedium . mediatrix
istacelestisopposuit.uidelicet.ignorantieboni.	ista celestis opposuit . uidelicet . ignorantie boni .
intellectumueritatis	intellectum ueritatis
.concupiscentiemali	. concupiscentie mali
:amoremuirtutis	: amorem uirtutis
.inpotentieuero	. in potentie uero
peccatoresistendi:uirtutemdiuineprotectionis.	peccato resistendi : uirtutem diuine protectionis .
necessariumenim	necessarium enim
fuitutlumenueritatis	fuit ut lumen ueritatis
:ignorantietenebras	: ignorantie tenebras
effugaret.	effugaret .
affectusuirtutis:impetuscarnalisconcupiscentie	affectus uirtutis : impetus carnalis concupiscentie
reprimeret.in	reprimeret . in
potentiamueroresistendipeccato	potentiam uero resistendi peccato
:potentiadiuine	: potentia diuine
protectionisroboraret.	protectionis roboraret .
hocestquodaspiritusanctoqui.	hoc est quod a spiritu sancto qui .
cordafideliumsuadocetillustratione:et	corda fidelium sua docet illustratione : et
inomnemueritateminducit:inorationepetimus	in omnem ueritatem inducit : in oratione petimus
.dicentes	. dicentes
.accendelumensensibusin	. accende lumen sensibus in
fundeamoremcordibus.infirmanostri	funde amorem cordibus . infirma nostri
corporis:uirtutefirmansperpetui.recogita	corporis : uirtute firmans perpetui . recogita
igiturmiserhomoinamaritudine	igitur miser homo in amaritudine
cordis:incolatustuimiseriam.et	cordis : incolatus tui miseriam . et
quiamiserenditempusaduenit:diuinamdeuotus	quia miserendi tempus aduenit : diuinam deuotus
inploramiseram.	inplora miseram .
carnemtuamcrebramaceratione	carnem tuam crebra maceratione
castigans:spiritumsubice.etneconcupiscentieeius	castigans : spiritum subice . et ne concupiscentie eius
intedominentur.pre	in te dominentur . pre
timoredistrictiiudicii.clauis	timore districti iudicii . clauis
eampenitentieconfige.Ipsaestenimqueaduerus	eam penitentie confige . Ipsa est enim que aduerus
spiritumconcupiscit.ipsarationinonobtemperans.	spiritum concupiscit . ipsa rationi non obtemperans .
sedsensualitati	sed sensualitati
consentiens.incessanterillicitasuggerit.castigainquam	consentiens . incessanter illicita suggerit . castiga inquam
carnemtuam.etconcupiscentiaseiusintemortifica.	carnem tuam . et concupiscentias eius in te mortifica .
Quienimchristisunt:carnemsuam	Qui enim christi sunt : carnem suam
crucifixeruntcumuitiis	crucifixerunt cum uitiis
etconcupiscentiis.triplicemsicutlegitur	et concupiscentiis . triplicem sicut legitur
ineuangelio:crucemlegimus.uidelicet.crucemchristi	in euangelio : crucem legimus . uidelicet . crucem christi
.crucemlatronispenitentis.etcrucemlatronis	. crucem latronis penitentis . et crucem latronis
insultantis.	insultantis .
certecruxchristi	certe crux christi
.cruxinnocentis	. crux innocentis
est.cruxlatronispenitentis.uoluntariaest	est . crux latronis penitentis . uoluntaria est
afflictiopeccatoris	afflictio peccatoris
.inmanitatemscelerumuehementi	. in manitatem scelerum uehementi
spirituscontritione	spiritus contritione
deflentis.cruxlatronisinsultantis:penaperhennisestscelerati	deflentis . crux latronis insultantis : pena perhennis est scelerati
.inpeccandi	. in peccandi
desideriofinaliterperseuerantis	desiderio finaliter perseuerantis
.suntnonnulli	. sunt non nulli
quiuitiapenitusdetestantes.summamsectandis	qui uitia penitus detestantes . summam sectandis
uirtutibusimpenduntoperam.uisibilia	uirtutibus impendunt operam . uisibilia
despiciunt.inuisibilibustotamentisdeuotioneiugiter	despiciunt . inuisibilibus tota mentis deuotione iugiter
intendunt.nullamordacisconscientiememoria	intendunt . nulla mordacis conscientie memoria
compunguntur.ettamentantaafflictionepenitentie	compunguntur . et tamen tanta afflictione penitentie
seatterunt	se atterunt
.acsipeccatisangustentur.Etutexpressius	. ac si peccatis angustentur . Et ut ex pressius
loquarquodsencio.frequentiusaccidit.etfamiliaribusinter	loquar quod sencio . frequentius accidit . et familiaribus inter
nosexemplissepiusexperimur.uthii	nos exemplis sepius experimur . ut hii
quiperfectiorisin	qui perfectioris in
nocentieprerogatiua.inexorabilescorporumsuorumpersecutoreseffecti	nocentie prerogatiua . in exorabiles corporum suorum persecutores effecti
:subarcioriseuiteregularisausteritatecoartent	: sub arciori se uite regularis austeritate coartent
.uidereseosuigiliis.ieiuniis.et	. uideres eos uigiliis . ieiuniis . et
orationibus.tamtaspiritusalacritateperseueranter	orationibus . tamta spiritus alacritate perseueranter
insistere.utterminospossibilitatemquenaturetranscendere	insistere . ut terminos possibilitatemque nature transcendere
iudeantur.illatisdelectaricontumeliis.temporalibusangustiis	iudeantur . illatis delectari contumeliis . temporalibus angustiis
dilatari.nonenimignorantquiaartaest	dilatari . non enim ignorant quia arta est
uiaqueducitaduitam.etqui	uia que ducit ad uitam . et qui
perfectouestigiocrucifixumuoluerintimitari	perfecto uestigio crucifixum uoluerint imitari
:necesseesteosspretamundihuiusgloria.	: necesse est eos spreta mundi huius gloria .
cumuitiisetconcupiscentiiscrucifigi.talesreuera	cum uitiis et concupiscentiis crucifigi . tales reuera
crucemchristi.cruceminnocentiebaiulant	crucem christi . crucem innocentie baiulant
.quietomni	. qui et omni
modaconscientiepuritate	moda conscientie puritate
interiusdelectantur.ettamenadaugmentumpremii.	interius delectantur . et tamen ad augmentum premii .
exterius:armispenitemtietotoferuorespiritusaccinguntur.huic	exterius : armis penitemtie toto feruore spiritus accinguntur . huic
cruciquaminnocentisessediximus.iohanesprecursor	cruci quam innocentis esse diximus . iohanes precursor
dominicusinseparabiliteraffixus	dominicus in separabiliter affixus
fuerat.qui	fuerat . qui
licetproptereminentiamsanctitatis.angelico	licet propter eminentiam sanctitatis . angelico
promissusessetoraculo.conceptusmiraculo.sanctificatusin	promissus esset oraculo . conceptus miraculo . sanctificatus in
utero:tamenutpeccatoribus	utero : tamen ut peccatoribus
formampenitentieprescriberet.corpusinnocentissimumuirtutesingularisabstinentie	formam penitentie prescriberet . corpus innocentissimum uirtute singularis abstinentie
.sicattenuauit.quasiscelerum	. sic attenuauit . quasi scelerum
multorumconscius.reummortiseterneseiudicaret.qui	multorum conscius . reum mortis eterne se iudicaret . qui
preceterissanctisuiteperhennis	pre ceteris sanctis uite perhennis
premiodignus	premio dignus
exstitit.	exstitit .
sicetsanctimartirescorporasuapropterdeumuariissuppliciis	sic et sancti martires corpora sua propter deum uariis suppliciis
exponentes.adexemplumredemptorissui.quenon	exponentes . ad exemplum redemptoris sui . que non
rapuerantexsoluerunt.etperinnocentiamperuenientes	rapuerant ex soluerunt . et per innocentiam peruenientes
adpalmam	ad palmam
martyrii.acceperuntcoronamuite.quam	martyrii . acceperunt coronam uite . quam
repromisitdeusdiligentibusse	repromisit deus diligentibus se
.constatautemcruxistaex	. constat autem crux ista ex
duobuslignis.	duobus lignis .
aptesibiinuicemcompositis.quesunthumilitas.et	apte sibi inuicem compositis . que sunt humilitas . et
patientia.necesseest	patientia . necesse est
enim.utquidonocelestis	enim . ut qui dono celestis
gratieinnocentemseauicusintelligit.et	gratie innocentem se auicus intelligit . et
tamenadaugmentum	tamen ad augmentum
premii.corpussuumpenitentie	premii . corpus suum penitentie
legibusastringit:humilitatemseruetincordeetpatientiamteneat	legibus astringit : humilitatem seruet in corde et patientiam teneat
inopere.neforteperlaudem	in opere . ne forte perlaudem
bonorumoperumque	bonorum operum que
forislucent.adinanemrapiaturgloriam.	foris lucent . ad inanem rapiatur gloriam .
uelsiin	uel si in
afflictione.penitentiepatientiamnonseruauerit:	afflictione . penitentie patientiam non seruauerit :
fructumpenitentie	fructum penitentie
nonconsequens.sentiatproremuneratione	non consequens . sentiat pro remuneratione
uindictam.porrocrucempenitentisbaiulant.qui	uindictam . porro crucem penitentis baiulant . qui
peccatapreteritalacrimisredimentes.annossuosin	peccata preterita lacrimis redimentes . annos suos in
amaritudineanimesuerecogitant.etmembraqueinstinctudiabolice	amaritudine anime sue recogitant . et membra que instinctu diabolice
suggestionisexhibuerantseruireimmundicie	suggestionis exhibuerant seruire immundicie
etiniquitati	et iniquitati
.adiniquitatem.necoperantegratiadiuine	. ad iniquitatem . nec operante gratia diuine
inspirationis:exhibentseruireiusticieinsanctificationem.horum	inspirationis : exhibent seruire iusticie in sanctificationem . horum
penitentienonsolumhomines.sed	penitentie non solum homines . sed
etangeli	et angeli
congratulantur.gaudentenimangelide	congratulantur . gaudent enim angeli de
penitentiaetconuersionepeccatorum.sicut.	penitentia et conuersione peccatorum . sicut .
scriptumest.gaudiumestangelisdei	scriptum est . gaudium est angelis dei
superuno	super uno
peccatorepenitentiamagente.undeetsignis	peccatore penitentiam agente . unde et signis
exterioribuspenitentie.plurimumdelectantur.	exterioribus penitentie . plurimum delectantur .
utpoteusucilicii.	ut pote usu cilicii .
profundissuspiriis.deuotisorationibus.	profundis suspiriis . deuotis orationibus .
crebragenuumflexione.etceterisbonorumoperumexerciciis	crebra genuum flexione . et ceteris bonorum operum exerciciis
.quibuspeccatrix	. quibus peccatrix
anima:creatorisuoaquoper	anima : creatori suo a quo per
iniquitatemrecesserat	iniquitatem recesserat
coniungitur.etipsiuslargienteclementia.quiomneshomines	coniungitur . et ipsius largiente clementia . qui omnes homines
uultsaluosfieri:supernorumciuium	uult saluos fieri : supernorum ciuium
cetibussociatur	cetibus sociatur
.Queautemmaiorgaudiorumpotestessemateria.	. Que autem maior gaudiorum potest esse materia .
quamcum	quam cum
redemptorbenignissimuspeccatoremleciferouitiorumsoporedepressum.	redemptor benignissimus peccatorem lecifero uitiorum sopore depressum .
manupaternesollicitudinisexcintandoconcutit.utaduertatpeccatorumsuorum	manu paterne sollicitudinis excintando concutit . ut aduertat peccatorum suorum
uulnera.utdolorem	uulnera . ut dolorem
uulnerumsuorumsentiat.quempriuspreduritiacordis	uulnerum suorum sentiat . quem prius pre duritia cordis
nonattendebat.terrendo	non attendebat . terrendo
deniquededucitad	denique deducit ad
portasinferi.preoculisstatuenssupplicia	portas inferi . preoculis statuens supplicia
.impiisetpecctoribuspreparata.sed	. impiis et pecctoribus preparata . sed
neterroriste.reumbaratrodesperationisabsorbeat:pius	ne terror iste . reum baratro desperationis absorbeat : pius
consolatormedelamuulneribusadibens	consolator medelam uulneribus adibens
.speremissionisetindulgentie.	. spe remissionis et indulgentie .
corpenitentisexhilarandoconfortatur:Etnotandumquod	cor penitentis exhilarando confortatur : Et notandum quod
cruxpenitentisintribusprecipueconsistit.uidelicet.	crux penitentis in tribus precipue consistit . uidelicet .
incarniscastigatione.incordis	in carnis castigatione . in cordis
compunctione.etiniuriarumremissione.carniscastigatio	compunctione . et iniuriarum remissione . carnis castigatio
admodumpenitentinecessariaest.oportet	ad modum penitenti necessaria est . oportet
enimutuerepenitenstantoalicitisstudeatabstinere.quanto	enim ut uere penitens tanto alicitis studeat abstinere . quanto
seillicitameminitcommisisse.necpardebetesse	se illicita meminit commisisse . nec par debet esse
fructuspenitentieilliuis.quiabannispueritie	fructus penitentie illiuis . qui ab annis pueritie
seruauitinnocentiam	seruauit innocentiam
.etillius	. et illius
quisolutopudiciciefreno:permultauitioruminquinamentamaculauit	qui soluto pudicicie freno : per multa uitiorum inquinamenta maculauit
uitam.grataautemerit	uitam . grata autem erit
deocorporiscastigatio.siocculta.si	deo corporis castigatio . si occulta . si
discreta.sideniqueprelatiiudicio	discreta . si denique prelati iudicio
fueritapprobata.occulta	fuerit approbata . occulta
:utnesciatsinistrapropterdeum.se	: ut nesciat sinistra propter deum . se
corporaliteraffligentis.quidfaciatdexteraeius.utbonum	corporaliter affligentis . quid faciat dextera eius . ut bonum
opuseiussitinabscondito	opus eius sit inabscondito
.etpatercelestisquiuidetinabscondito	. et pater celestis qui uidet inabscondito
reddetei.sitetiam	reddet ei . sit etiam
discretacarniscastigatio.utpenitenssicuoluptatem	discreta carnis castigatio . ut penitens sic uoluptatem
carnisreprimat.uttamennecessitatem	carnis reprimat . ut tamen necessitatem
corporeefragilitatisattendat.nesiforteualidenimis	corporee fragilitatis attendat . ne si forte ualide nimis
hostissubicitur:	hostis subicitur :
ciuisnecessariusoccidatur.fortitudocorporisdomino	ciuis necessarius occidatur . fortitudo corporis domino
custodiendaest.iuxtapsalmistamqui	custodienda est . iuxta psalmistam qui
dicit.fortitudinemmeamadtecustodiam.	dicit . fortitudinem meam ad te custodiam .
utetabstinentiaillicitumcarnisrefrenetappetitum.et	ut et abstinentia illici tum carnis refrenet appetitum . et
discretiocorpusincolume	discre tio corpus incolume
seruetad	seruet ad
creatorisobsequium.neque	creatoris obsequium . neque
enimsicutscriptumest.in	enim sicut scriptum est . in
abstinendoueledendoconsistitiusticia.sed	abstinendo uel edendo consistit iusticia . sed
inequanimitatetolerandiinopiam.	in equanimitate tolerandi inopiam .
etintemperantia	et intemperantia
.nonsecorrumpendi	. non se corrumpendi
perhabimdantiam.uidimusplerosqueindiscretisieiuniis.	per habimdantiam . uidimus plerosque indiscretis ieiuniis .
supersticiosauigiliarumanticipatione	supersticiosa uigiliarum anticipatione
.sicdebilitasseuirescorporis:uttotouitesue	. sic debilitasse uires corporis : ut toto uite sue
tempore.nonsinefratrumscandalo.	tempore . non sine fratrum scandalo .
nonsineconscientiedetrimento.	non sine conscientie detrimento .
propterinfirmitatisnecessitatem	propter infirmitatis necessitatem
.cibisdelicatioribusuti	. cibis delicatioribus uti
cogerentur.Iobqueabstinentiasubditi:prelatiiudicio.	cogerentur . Iob que abstinentia subditi : prelati iudicio .
sicutprediximusdebetapprobari.celestisenimmagistermunus	sicut prediximus debet approbari . celestis enim magister munus
illudgratiusacceptabit.quodsubditus	illud gratius acceptabit . quod subditus
nonarbitrioproprieuoluntatissedimperiopresidentis:obtulerit.	non arbitrio proprie uoluntatis sed imperio presidentis : obtulerit .
cordisetiamcompunctiosuoternarioconsecrataest.habetenim	cordis etiam compunctio suo ternario consecrata est . habet enim
lacrimarumprofusionem.orisconfessionem.etoperiscorrectionem	lacrimarum profusionem . oris confessionem . et operis correctionem
.necessariumprorsusest	. necessarium prorsus est
utoculihucusque	ut oculi huc usque
pleniconcupiscentiis:eternumfletumlacrimistemporalibuspreueniant	pleni concupiscentiis : eternum fletum lacrimis temporalibus preueniant
.etquiper	. et qui per
illicita:noxiacuriositate	illicita : noxia curiositate
consueueranteuagari	consueuerant euagari
.necauanitatererumtemporaliumsepenitusauertant	. nec a uanitate rerum temporalium se penitus auertant
.necplangerecessetoculis	. nec plangere cesset oculis
.quodilliciteconcupiuitanimus	. quod illicite concupiuit animus
.sordesenimanime:lacrimecompunctionisabluunt	. sordes enim anime : lacrime compunctionis abluunt
.etinhabundantiaprofluentes.ignemgehenne.impiis	. et in habundantia profluentes . ignem gehenne . impiis
etpeccatoribusdeputatum:uelutimpetustorrentis:extingunt	et peccatoribus deputatum : uelut impetus torrentis : extingunt
.orisautemconfessiocompunctionicordisindubitatum	. oris autem confessio compunctioni cordis in dubitatum
gerittestimonium	gerit testimonium
.Inpuraenimconfessione	. In pura enim confessione
:perfectecontritionisperpenderesolemuseffectum.	: perfecte contritionis perpendere solemus effectum .
hecinquamconfessiospiritualiumestmedicinauulnerum.sinequa	hec inquam confessio spiritualium est medicina uulnerum . sine qua
nonestsalusanimarum.sicuteniminecclesiaste	non est salus animarum . sicut enim in ecclesiaste
scriptumest.Quiabsconditscelerasua:nondirigetur	scriptum est . Qui abscondit scelera sua : non dirigetur
.quiautem	. qui autem
confessusfuerit	confessus fuerit
etdimiseritea:	et dimiserit ea :
ueniamconsequetur.sedattendendum	ueniam consequetur . sed attendendum
.quiaquatuor	. quia quatuor
suntque	sunt que
uirtutemuereconfessioniseneruantetinpediunt	uirtutem uere confessionis eneruant et inpediunt
.uidelicet.pudor.ettimor.spes	. uidelicet . pudor . et timor . spes
.etdesperatio.	. et desperatio .
pudor:uirtutemuereconfessionisimpedit.dum	pudor : uirtutem uere confessionis impedit . dum
peccatorumscelerasuagrauia	peccatorum scelera sua grauia
etignominiosaesseconsiderans.	et ignominiosa esse considerans .
inseipsoconfunditur.etpreconfusionespiritus	in se ipso confunditur . et pre confusione spiritus
:eaconfiterierubescit.talibusdicitapostolus.Quem	: ea confiteri erubescit . talibus dicit apostolus . Quem
fructumergohabuististunc.in	fructum ergo habuistis tunc . in
quibusnuncerubescitis:antiquo	quibus nunc erubescitis : antiquo
etiametusitatoprouerbiodicisolet.quia	etiam et usitato prouerbio dici solet . quia
peccatauestera.nouampariuntconfusionem.	peccata uestera . nouam pariunt confusionem .
nonillaminquamconfusionem.dequascriptum	non illam inquam confusionem . de qua scriptum
est.estconfusioadducensgloriam.sedillam	est . est confusio adducens gloriam . sed illam
dequadicitur.	de qua dicitur .
estconfusioadducens.peccatum.talisenim	est confusio adducens . peccatum . talis enim
confusiopeccatumadducit.non	confusio peccatum adducit . non
adimit.quiaquodperostensionemdeleredebuerat:per	adimit . quia quod per ostensionem delere debuerat : per
occultationem.magisaugmentat.audiatquesoqui	occultationem . magis augmentat . audiat queso qui
sicconfunditur.etdiligenter	sic confunditur . et diligenter
attendatuerbumilludbeatiiob.memoria	attendat uerbum illud beati iob . memoria
dignum.etad	dignum . et ad
hiusmodiconfusionempenituseliminandam.summenecessarium.	hiusmodi confusionem penitus eliminandam . summe necessarium .
sicutinquit	sicut inquit
nubesconsumituretpertransit:	nubes consumitur et per transit :
sicquidescenditadinferosnon	sic qui descendit ad inferos non
ascendet.	ascendet .
necreuerenturultra	nec reuerentur ultra
indomumsuam.neque	in domum suam . neque
cognosceteum.amplius	cognoscet eum . amplius
locuseius.Quapropteretego	locus eius . Qua propter et ego
nonpareamori	non paream ori
meo.loquarintribulationespiritusmei	meo . loquar in tribulatione spiritus mei
.confabulaborcumamaritudineanimemee.super	. confabulabor cum amaritudine anime mee . super
heclocumsic	hec locum sic
aitbeatusgregorius	ait beatus gregorius
.orisuo	. ori suo
parcit.quiconfiterimalum	parcit . qui confiteri malum
quodfeciterubescit.	quod fecit erubescit .
Inlaboremueroosmittit:qui	In laborem uero os mittit : qui
adconfessionem	ad confessionem
osaperit	os aperit
.timoretiaminordinatius.uirtutemconfessioniseuacuat.	. timor etiam inordinatius . uirtutem confessionis euacuat .
dumpeccatorpropriefragilitatimetuens.onussatisfactionispropeccatis	dum peccator proprie fragilitati metuens . onus satisfactionis pro peccatis
suissubireformidat.	suis subire formidat .
Dehuiusmodi	De huiusmodi
inlibroiobscriptumest.	in libro iob scriptum est .
Quitiment	Qui timent
pruinam.irruetsupereosnix	pruinam . irruet super eos nix
.scitisquia	. scitis quia
nixruitde	nix ruit de
superioribus.pruinauerocongelescitinferius.per	superioribus . pruina uero congelescit inferius . per
pruinamigiturpenatemporalisettransitora.perniuem	pruinam igitur pena temporalis et transitora . per niuem
uerodesignatureterna.undeineodemlibroiobde	uero designatur eterna . unde in eodem libro iob de
reprobisscriptumest	reprobis scriptum est
.transibunt	. transibunt
abaquisniuiumadcaloremnimium	ab aquis niuium ad calorem nimium
.Etinprouerbiis	. Et in prouerbiis
.demuliere	. de muliere
forti.uidelicetecclesia.	forti . uidelicet ecclesia .
dicitur.non	dicitur . non
timebitdomuisueafrigoribusniuis.Omnesenimdomestici	timebit domui sue a frigoribus niuis . Omnes enim domestici
eiusuestitisuntduplicibus.	eius uestiti sunt duplicibus .
rectoergodictumest.Quitimentpruinamirruetsuper	recto ergo dictum est . Qui timent pruinam irruet super
eosnix.quia	eos nix . quia
quipenamtemporalemprosatisfactionepeccatorumsubiremetuunt	qui penam temporalem pro satisfactione peccatorum subire metuunt
:infuturodistrictumdeiiudiciumexcipient.quod	: in futuro districtum dei iudicium excipient . quod
euaderenonualebunt.hincetiamsalomonait.Qui	euadere non ualebunt . hinc etiam salomon ait . Qui
obseruatuentos:nonseminat.hocest	obseruat uentos : non seminat . hoc est
quipenitentietemporalis	qui penitentie temporalis
laboremsubirerefugit	laborem subire refugit
:fructusbonorum	: fructus bonorum
operuminfuturauita	operum in futura uita
percipiendos:inpresentinonmultiplicat.	percipiendos : in presenti non multiplicat .
similiter.spesuirtutemconfessionisminuit.dumpeccator	similiter . spes uirtutem confessionis minuit . dum peccator
commodumtemporaleconsequidesiderans	commodum temporale consequi desiderans
.illispenitusoccultatur.aquibus	. illis penitus occultatur . a quibus
effectumreiconcupitelatenterobtinerenititur.nesi	effectum rei concupite latenter obtinere nititur . ne si
fortepeccatumquodlatet:inconfessione	forte peccatum quod latet : in confessione
detegat:afructuspeiconcepteuacuusomninoremaneat	detegat : a fructu spei concepte uacuus omnino remaneat
.quiaquodadipiscidesideratperstudiumcupiditatis	. quia quod adipisci desiderat per studium cupiditatis
:nonestdignusassequi.meritoiniquitatislatentis	: non est dignus assequi . merito iniquitatis latentis
.Desperatio	. Desperatio
etiamuirtuticonfessionisobuiat.dum	etiam uirtuti confessionis obuiat . dum
peccatorscelerumsuorummultitudinem.magnitudinem.diuturnitatemconsiderans.	peccator scelerum suorum multitudinem . magnitudinem . diuturnitatem considerans .
deipsisapuddeumueniamseconsequiposse	de ipsis apud deum ueniam se consequi posse
desperat.Quorum	desperat . Quorum
similitudinemgessitcaynillemaledictuscumait.maior	similitudinem gessit cayn ille maledictus cum ait . maior
estinquitasmeaquamutueniammerear.Et	est inquitas mea quam ut ueniam merear . Et
detalibusalibiscriptumest.Impiuscuminprofundum	de talibus alibi scriptum est . Impius cum in profundum
uenerit:contempnit.contemptus	uenerit : contempnit . contemptus
enimdesperationemgenerat.desperatioautem:	enim desperationem generat . desperatio autem :
spemquauiuimus.etadcelestiasubleuamur:	spem qua uiuimus . et ad celestia subleuamur :
penituseliminat.Exclusisigiturhis	penitus eliminat . Exclusis igitur his
quatuorqueconfessionis	quatuor que confessionis
euacuantmeritum.iiii.alia	euacuant meritum . iiii . alia
diligentiusattendamus.	diligentius attendamus .
queinconfitentibus	que in confitentibus
perfectionisoperanturaugmentum.perfectaautemeritconfessio	perfectionis operantur augmentum . perfecta autem erit confessio
:sinuda.siintegra.	: si nuda . si integra .
sifidelissit	si fidelis sit
etordinata.nudaestconfessioqueuerborumfoliisnon	et ordinata . nuda est confessio que uerborum foliis non
palliatur.integra:queperpartesnondiuiditur	palliatur . integra : que per partes non diuiditur
.stultumestenimut	. stultum est enim ut
scripturaait.	scriptura ait .
dimidiamsperareueniam.immoinconfessionediuidere	dimidiam sperare ueniam . immo in confessione diuidere
peccata:semperestcarereuenia.fidelisautem	peccata : semper est carere uenia . fidelis autem
eritconfessio.si	erit confessio . si
isquiconfitetur.piamde	is qui confitetur . piam de
remissionepeccatorum	remissione peccatorum
fiduciamconcipiat.ordinata:siprelato	fiduciam concipiat . ordinata : si prelato
suo.nonalii.culpassuas	suo . non alii . culpas suas
humiliterexponendodeplangat.Illiuseminestadhibere	humiliter exponendo deplangat . Illius emin est adhibere
remedium.quiincurasusceperegrotum.	remedium . qui incura susceper egrotum .
Orisconfessionemsequitur	Oris confessionem sequitur
operiscorrectio.queinobseruationemandatorumdei	operis correctio . que in obseruatione mandatorum dei
consistitetperseuerantia.ut	consistit et perseuerantia . ut
peccatorcreatorisuoreconciliaridesiderans:declineta	peccator creatori suo reconciliari desiderans : declinet a
malo.etfaciatbonum.etin	malo . et faciat bonum . et in
bonoopereusquein	bono opere usque in
finemperseuerans.	finem perseuerans .
asupernoremuneratore	a superno remuneratore
salutiseterneconsequaturpremium.Qui	salutis eterne consequatur premium . Qui
enimperseuera	enim perseuera
ueritusquein	uerit usque in
finem:hicsaluuserit.cruxetiam	finem : hic saluus erit . crux etiam
penitentis.sicutprediximusconsistitin	penitentis . sicut prediximus consistit in
iniuriarumremissione.scitisquia	iniuriarum remissione . scitis quia
irrogareiniurieintusanimumcruciant.forismanum	irrogare iniurie intus animum cruciant . foris manum
aduindictamprouocant.undequiinsepeccantibusex	ad uindictam prouocant . unde qui in se peccantibus ex
cordedimittit.crucemproprieuoluntati:	corde dimittit . crucem proprie uoluntati :
uindictamproiniuriisillatisexpetenti:quodammodouiolenterimponit.	uindictam pro iniuriis illatis expetenti : quodammodo uiolenter imponit .
adhanccrucemsaluatornosinuitatdumpeccatoresipsumin	ad hanc crucem saluator nos inuitat dum peccatores ipsum in
iniquitatibussuisincessanterexacerbantes	iniquitatibus suis incessanter exacerbantes
.nonsolumpatientersustinet	. non solum patienter sustinet
.sedetiampenitentibus:ueniamremissionis.clementia	. sed etiam penitentibus : ueniam remissionis . clementia
suepietatisindulget.cuiusindulgentietriplicemgratiam.	sue pietatis indulget . cuius indulgentie triplicem gratiam .
totadeuotionerecolendam.diligentissimedebemusattendere.sicenim	tota deuotione recolendam . diligentissime debemus attendere . sic enim
plenariammisericorsetmiseratordominus	plenariam misericors et miserator dominus
penitentibuslargiturindulgentiam.ut	penitentibus largitur indulgentiam . ut
deincepsnecdampnetulciscendo.nec	deinceps nec dampnet ulciscendo . nec
confuendatinproperandonecminus	confuendat inproperando nec minus
diligat.inputando.audianthoc	diligat . inputando . audiant hoc
quesoclaustrales.	queso claustrales .
etardentius	et ardentius
imitaristudeant.	imitari studeant .
suntenim	sunt enim
quidamqui	quidam qui
siqualibetoccasionelesi	si qualibet occasione lesi
fuerint:donant	fuerint : donant
fortassisiniuriam:sedquod	fortassis iniuriam : sed quod
omninoremisisseiusisunt:frequentiusinproperarenon	omnino remisisse iusi sunt : frequentius inproperare non
uerentur.suntetaliiquietsi	uerentur . sunt et alii qui et si
postacceptasiniuriassileant.rancoremtamenincessanter	post acceptas iniurias sileant . rancorem tamen incessanter
urentemseruantinanimomanetaltamenterepositum	urentem seruant in animo manet alta mente repositum
.siquiddictumuelfactumfuerit	. si quid dictum uel factum fuerit
.undeipsisoffensionismateria.scandalioccasioprestitauideatur	. unde ipsis offensionis materia . scandali occasio prestita uideatur
.adeoutgraueseisetiamaduidendum.	. ad eo ut graues eis etiam ad uidendum .
quizeloreligionisetdiscipline:excessuseorumcorrectione	qui zelo religionis et discipline : excessus eorum correctione
dignos.uellenireprehensionenotauerint.contrahosbene	dignos . uel leni reprehensione notauerint . contra hos bene
inecclesiastico	in ecclesiastico
scriptumest.homohominiseruat	scriptum est . homo homini seruat
iram.et	iram . et
adeoqueritmedelam:	a deo querit medelam :
longeabhiisest	longe ab hiis est
diuinemiserationisbenignissimaliberalitasquesicindulgetplenarie:	diuine miserationis benignissima liberalitas que sic indulget plenarie :
utpeccatoressedpenitentes.non	ut peccatores sed penitentes . non
solumareatu	solum a reatu
preuaricationisclementer	preuaricationis clementer
absoluat.sedethabundantiore	absoluat . sed et habundantiore
dilectioniscumulo.ingratiamdulcissime	dilectionis cumulo . in gratiam dulcissime
familiaritatisadmittat.probathocpetrusapostolusconscius	familiaritatis admittat . probat hoc petrus apostolus conscius
secretorumdei.cuiposttrinamnegationem:commissa	secretorum dei . cui post trinam negationem : commissa
estuniuersalisecclesiecustodia.probat	est uniuersalis ecclesie custodia . probat
hocidemfamosissima	hoc idem famosissima
peccatrixinqua	peccatrix in qua
sicutscriptum	sicut scriptum
est.postquamhabundauitpeccatum:superhabundauitetgratia	est . postquam habundauit peccatum : super habundauit et gratia
.crucem	. crucem
latronisinsultantis	latronis insultantis
.penamperhennempeccatorisessediximus.	. penam perhennem peccatoris esse diximus .
finaliterinmaloperseuerantis.Etheccruxquatuorin	finaliter in malo perseuerantis . Et hec crux quatuor in
sebrachia	se brachia
continet.uidelicetuermemconscientie.horroremgehenne.	continet . uidelicet uermem conscientie . horrorem gehenne .
tenebrarumcaliginem	tenebrarum caliginem
.penarumacerbitatem	. penarum acerbitatem
.Deuermeconscientiescriptum	. De uerme conscientie scriptum
estineuangelio.simul	est in euangelio . simul
etinysaia.uermis	et in ysaia . uermis
eorumnonmorietur.Quodlicetplanumsitadlitteram	eorum non morietur . Quod licet planum sit adlitteram
:tamenad	: tamen ad
accusationemremordentisconscientie:recte	accusationem remordentis conscientie : recte
retorquetur.	retorquetur .
quantumadspiritalemintelligentiam.Dehorroregehenne	quantum ad spiritalem intelligentiam . De horrore gehenne
inlibroiob	in libro iob
scriptum.ubiumbramortis.etnullus	scriptum . ubi umbra mortis . et nullus
ordo.sedsempiternus.horrorinhabitans.tenebrarum	ordo . sed sempiternus . horror inhabitans . tenebrarum
caliginem.sermoexprimiteuangelicus.ubidicit	caliginem . sermo exprimit euangelicus . ubi dicit
.mittenturintenebras	. mittentur in tenebras
exteriores.penarumacerbitatem:ubisubiungit	exteriores . penarum acerbitatem : ubi subiungit
.Ibierit	. Ibi erit
fletusetstridordentium.caueamusdilectissimi	fletus et stridor dentium . caueamus dilectissimi
fratresnehuiccrucipeccatisnostris	fratres ne huic cruci peccatis nostris
exigentibuseternaliteraffigamurcarnalesconcupiscentiasuoluntariacastigationecohibentes.	exigentibus eternaliter affigamur carnales concupiscentias uoluntaria castigatione cohibentes .
temporaliterpotiusmaceremur.quamsuppliciisdeputemureternis.et	temporaliter potius maceremur . quam suppliciis deputemur eternis . et
sicrucemchristi.cruceminnocontie	si crucem christi . crucem innocontie
.utpotereietnocentesbaiularenonpossumus:	. ut pote rei et nocentes baiulare non possumus :
saltemcrucempenitentie	saltem crucem penitentie
.quenos	. que nos
abeternocruciatuliberet	ab eterno cruciatu liberet
:diebusistisprecipue.nobisassumamus.Qui	: diebus istis precipue . nobis assumamus . Qui
enimchristisunt.carnemsuamcrucifixerunt.	enim christi sunt . carnem suam crucifixe runt .
cumuiciiset	cum uiciis et
concupiscentiis.obseruandumnobisest.utchristisimus.	concupiscentiis . obseruandum nobis est . ut christi simus .
etcarnem	et carnem
nostramcum	nostram cum
uiciiset	uiciis et
concupiscentiiscrucifigamus.multienimcarnemsuamcrucifigunt.	concupiscentiis crucifigamus . multi enim carnem suam crucifigunt .
ettamenchristinonsunt.	et tamen christi non sunt .
utpoteexoperibussuisquerectauidentur:	ut pote ex operibus suis que recta uidentur :
humanamstudiosiusappetuntgloriam.sedtanquamfatueuirgines	humanam studiosius appetunt gloriam . sed tanquam fatue uirgines
obeuminuasisnonhabentes:	ob eum in uasis non habentes :
uacuamuirtutibushabent	uacuam uirtutibus habent
conscientiam.	conscientiam .
lucentquidem.sed	lucent quidem . sed
nonardent.quiperlucembonorum	non ardent . qui per lucem bonorum
operum:forissimulantuiteperfectionem.sedintus	operum : foris simulant uite perfectionem . sed intus
ignecaritatisnonaccendunturadsalutem.utigiturfructuosa	igne caritatis non accenduntur ad salutem . ut igitur fructuosa
sitcarnisnostremortificatioexterioriconuersationiconcordetinterior	sit carnis nostre mortificatio exteriori conuersationi concordet interior
mentisintentio.utsicopera	mentis intentio . ut sic opera
nostraluceant	nostra luceant
coramhominibus:quatinusetilliperomnia	coram hominibus : quatinus et illi per omnia
placeamus.quicordiumscrutatorest	placeamus . qui cordium scrutator est
intimus.Iehsuchristusdominusnoster	intimus . Iehsu christus dominus noster
.cuiusregnumetimperium.	. cuius regnum et imperium .
permanetinsecula	permanet in secula
seculorum.amensermoIngeneralicapitulo	seculorum . amen sermo In generali capitulo
Egosumpastorbonus.	Ego sum pastor bonus .
quipascoouesmeas	qui pasco oues meas
.etproouibusmeisponoanimammeam.	. et pro ouibus meis pono animam meam .
necessariumfueratfatresetpatresdilectissimi.	necessarium fuerat fatres et patres dilectissimi .
utdieipresentisexhortationem.lingue.torrenti.et	ut diei presentis exhortationem . lingue . torrenti . et
fecundopectoricommisissem.decuiusplenitudinenos	fecundo pectori commisissem . de cuius plenitudine nos
omensaccipientes.etsacrescripturedulcedinem.palatocordis	omens accipientes . et sacre scripture dulcedinem . palato cordis
degustantes.uerbis	degustantes . uerbis
diuinisquasiquibusdamcarbonibusuastatoriis	diuinis quasi quibusdam carbonibus uastatoriis
.adamorempreceptorum	. ad amorem preceptorum
dei.uehementiusaccenderemur	dei . uehementius accenderemur
.netamen	. ne tamen
caritatiuostreuideaturiniuriosum	caritati uostre uideatur iniuriosum
.sisecundummoremdiei	. si secundum morem diei
.uerbumdeinonprocedat:	. uerbum dei non procedat :
aliquiddicere.licet	aliquid dicere . licet
presumptuosusaudebo.	presumptuosus audebo .
etintabernaculodomini.nonquoduolo.sed	et in tabernaculo domini . non quod uolo . sed
quodualeo.deuotusofferam.inhoc	quod ualeo . deuotus offeram . in hoc
maximeloquendi	maxime loquendi
sumensfiduciam.	sumens fiduciam .
quiadeusmunus	quia deus munus
quantumlibetparuumnonrespuit.	quantumlibet paruum non respuit .
quodoblatum	quod oblatum
fueritboneuoluntatisaffectu.	fuerit bone uoluntatis affectu .
seduereornedelicatasauresoffendat	sed uereor ne delicatas aures offendat
sermorusticio	sermo rusticio
.etquinoua	. et qui noua
frequenterauditis:uetera	frequenter auditis : uetera
.etsiueradespiciatis.sedetisenimadmensam	. et si uera despiciatis . sedetis enim ad mensam
diuitis.etnuptiisagni	diuitis . et nuptiis agni
communicatis.eticircoquasi	communicatis . et icirco quasi
conuiuedelicatiquequeminussapida.minuspreparata:non	conuiue delicati queque minus sapida . minus preparata : non
immeritofastiditis.sedrursusattendo	immerito fastiditis . sed rursus attendo
quodintercibosdelicatiores.grossioraquequenon	quod inter cibos delicatiores . grossiora queque non
numquamdulciussapiunt.ethumanusanimusgratauicissitudine	numquam dulcius sapiunt . et humanus animus grata uicissitudine
sequandoque	se quandoque
communibusapplicat.utadpenetrandamsubtiliumprofunditatem.	communibus applicat . ut ad penetrandam subtilium profunditatem .
ardentiuspostmodumrecurrat	ardentius postmodum recurrat
.scioquidempatreskarissimi.plures	. scio quidem patres karissimi . plures
esseinteruosuerbidiuinidispensatoresydoneos.quilegem	esse inter uos uerbi diuini dispensatores ydoneos . qui legem
diuinamdigitodeiincordibuseorum	diuinam digito dei in cordibus eorum
scriptam.nonsoluminsermonefrequenterannuntiant	scriptam . non solum in sermone frequenter annuntiant
.sedetiamefficaciterinoperedemonstrant.quiatamen	. sed etiam efficaciter in opere demonstrant . quia tamen
fratumprofectibus	fratum profectibus
exiniunctoteneorofficiodeseruire	ex in iuncto teneor officio deseruire
.nonabreiudico.adedificationem	. non abre iudico . ad edificationem
simplicium.saltemcommunia.etquasiomnibus	simplicium . saltem communia . et quasi omnibus
notaproponere.Insufficentiamitaquemeamuobis	nota proponere . Insufficentiam itaque meam uobis
nonincognitam	non incognitam
:penesuos	: penes uos
excusans.ueniam	excusans . ueniam
depresumptionepostulo.quialinguamcuisilentiumscientiedefectus	de presumptione postulo . quia linguam cui silentium scientie defectus
imponitetimperat.fraterne	imponit et imperat . fraterne
caritatisaffectusad	caritatis affectus ad
loquendumresoluitetconfortat.Egosumpastorbonus	loquendum resoluit et confortat . Ego sum pastor bonus
.etcetera.Inuerbisistisfratrestriaprimo	. etcetera . In uerbis istis fratres tria primo
considerandanobisoccurrunt.bonitas	consideranda nobis occurrunt . bonitas
redemptorisnostri:cumdicitur.	redemptoris nostri : cum dicitur .
Egosumpastor	Ego sum pastor
bonus.sollicitudo	bonus . sollicitudo
etaffectuseiuserganos.cum	et affectus eius erga nos . cum
additurquipascoouesmeas.bonitatisetsollicitudiniseiusdem	additur qui pasco oues meas . bonitatis et sollicitudinis eiusdem
.inenarrabilisetfactus.cumad	. inenarrabilis et factus . cum ad
extremumconcluditur.	extremum concluditur .
etproouibusmeisponoanimammeam.Et	et pro ouibus meis pono animam meam . Et
primoquidemadbontatis	primo quidem ad bontatis
ipsiushabundantiam.mentisoculosretorquamus:et	ipsius habundantiam . mentis oculos retorquamus : et
inueniemusproculdubio.	inueniemus proculdubio .
multiplicesboneficiorumeiusconsolationes.quibusquasiquibusdam	multiplices boneficiorum eius consolationes . quibus quasi quibusdam
stimulisinamoremipsiustotomentisaffectu	stimulis in amorem ipsius toto mentis affectu
rapiamur.Intribusautemprecipuebonitatemdiuinam	rapiamur . In tribus autem precipue bonitatem diuinam
possumusattendere:	possumus attendere :
uidelicetinhominiscreatione.inipsius	uidelicet in hominis creatione . in ipsius
recreatione.etineiusdemglorificatione.Increatione	recreatione . et in eiusdem glorificatione . In creatione
quidem.quiapropterbonitatem	quidem . quia propter bonitatem
diuinamcreatusesthomo.sicuttestaturbeatusaugustus.	diuinam creatus est homo . sicut testatur beatus augustus .
inlibrode	in libro de
doctrinachristiana.ubiait:quiadeusbonus	doctrina christiana . ubi ait : quia deus bonus
est.nossumus.etinquantumsumus	est . nos sumus . et in quantum sumus
:bonisumus.Eccequiacreatusesthomo	: boni sumus . Ecce quia creatus est homo
.propterbonitatem	. propter bonitatem
diuinam:creatusestetiampropterutilitatemsuam	diuinam : creatus est etiam propter utilitatem suam
.utileestenimhominiseruiredeo	. utile est enim homini seruire deo
:utpostmodumfruatur	: ut postmodum fruatur
eo.deoenimseruireregareest.et	eo . deo enim seruire regare est . et
sicordinauitdiuinamoderatio.	sic ordinauit diuina moderatio .
utomniaquepropterhominemfactamsunt.et	ut omnia que propter hominem factam sunt . et
subipsoexistuntusibuseiusdeseruiant	sub ipso existunt usibus eius deseruiant
.utipseordinelegitimo.suo	. ut ipse ordine legitimo . suo
superiori.	superiori .
idestdeodebitumexibeatfamulatum.In	idest deo debitum exibeat famulatum . In
recreationeautemhominis:maioremcumulumdiuine	recreatione autem hominis : maiorem cumulum diuine
bonitatispostsumus	bonitatis postsumus
attendere.Quantaenimdignatio.ut	attendere . Quanta enim dignatio . ut
filiusdei	filius dei
autemsecula.factushominisfiliusinfineseculorum.	autem secula . factus hominis filius in fine seculorum .
defectusnostrecarnissintsusciperet.et	defectus nostre carnis sint susciperet . et
humanigenerismisereriemisericorditerconpatiens.hominemperditum	humani generis misererie misericorditer conpatiens . hominem perditum
adregnacelestiareuocaretur:	ad regna celestia reuocaretur :
oquamdiuesinmisericordia.	o quam diues in misericordia .
quammunificus	quam munificus
ingratia.redemptornoster.	in gratia . redemptor noster .
quidesinupatrisdescendens.	qui de sinu patris descendens .
ouemperditampropriishumerisadgregem	ouem perditam propriis humeris ad gregem
reportauit:etprimeperuaricationis	reportauit : et prime peruaricationis
reatumdiluens.	reatum diluens .
seipsumpronobispreciumredemtionisoptulit.	se ipsum pro nobis precium redemtionis optulit .
Inhominisueroglorificatione:multo	In hominis uero glorificatione : multo
magiselucet	magis elucet
diuinerespectusmisericordie.Queenimmaior	diuine respectus misericordie . Que enim maior
gracia.quamutdestructacaptiuitate.	gracia . quam ut destructa captiuitate .
seruusintretingaudiumdominisui.ethereditatemconsequatur	seruus intret in gaudium domini sui . et hereditatem consequatur
.quedeceterononpossit	. que de cetero non possit
auferri:hocestquodipsedominusait:	auferri : hoc est quod ipse dominus ait :
pateruoloutubisum:illicsitet	pater uolo ut ubi sum : illic sit et
ministermeus.Et	minister meus . Et
alibipater.quosdedistimihi:uolout	alibi pater . quos dedisti mihi : uolo ut
ubiegosumetilli	ubi ego sum et illi
sintmecumut	sint mecum ut
uideantclaritatemmeamquamdedisti	uideant claritatem meam quam dedisti
mihi.quiadilexistime.autem	mihi . quia dilexisti me . autem
constitutionemseculi.Inhacautemglorificatione	constitutionem seculi . In hac autem glorificatione
.triaquilibetelectorumdiuinomunereconsequitur:	. tria quilibet electorum diuino munere consequitur :
quibusabsortamorte	quibus absorta morte
inuictoriam:	in uictoriam :
sineterminofeliciterperfruetur.primum	sine termino feliciter perfruetur . primum
esteternasacietasindei	est eterna sacietas in dei
contemplatione.secundum:internaiocunditas	contemplatione . secundum : interna iocunditas
inconscientiepuritate.tercium:iocundaunitas.	in conscientie puritate . tercium : iocunda unitas .
insanctorumsocitate.Ethoc	in sanctorum socitate . Et hoc
quidemdebonitateredemptorisnostrisuccinctepercurrentes:necad	quidem de bonitate redemptoris nostri succincte percurrentes : nec ad
sollicitudinemetaffectumipsiuserganosconsiderationisoculos	sollicitudinem et affectum ipsius erga nos considerationis oculos
accollamus.	accollamus .
Egosuminquitpastorbonus:	Ego sum inquit pastor bonus :
quipascoouesmeas	qui pasco oues meas
.pascitdominusouessuas.idestfideles	. pascit dominus oues suas . idest fideles
populosmultipliciter.siquidempascittemporaliumsubministratione:pascit	populos multipliciter . siquidem pascit temporalium sub ministratione : pascit
diuiniuerbieruditione.pascitetiamsacramentorumparticipatione:ad	diuini uerbi eruditione . pascit etiam sacramentorum participatione : ad
extremumpasciteternasuediuinitatisuisione	extremum pascit eterna sue diuinitatis uisione
.pascittemporalium	. pascit temporalium
subministratione:sicut	subministratione : sicut
habetisinpsalmo.Quicustoditueritatem	habetis in psalmo . Qui custodit ueritatem
inseculum.facitiudiciuminiuriampatientibus	in seculum . facit iudicium iniuriam patientibus
:datescamesurientibus.escamuidelicettamcorporalem	: dat escam esurientibus . escam uidelicet tam corporalem
quamspiritalem.etalibi.Quidatescam	quam spiritalem . et alibi . Qui dat escam
iumentisipsorum:etpulliscoruoruminuocantibus	iumentis ipsorum : et pullis coruorum inuocantibus
eum.pascit	eum . pascit
diuiniuerbieruditione:sicutinaliopsalmo	diuini uerbi eruditione : sicut in alio psalmo
scriptumest.Dominusregitme.et	scriptum est . Dominus regit me . et
nichilmihideerit.inlocopascue.hoc	nichil mihi deerit . in loco pascue . hoc
estintelligentiadiuinisermonis.ibi	est intelligentia diuini sermonis . ibi
mecollocauit	me collocauit
.pascitetiamsacramentorumparticipatione:	. pascit etiam sacramentorum participatione :
etprecipuesacracorporisetsanguinissuicomunione	et precipue sacra corporis et sanguinis sui comunione
.undeipse	. unde ipse
.Egosumpanisuiuusquidecelo	. Ego sum panis uiuus qui de celo
descendi.siquismanducaueritexhoc	descendi . si quis manducauerit ex hoc
pane:uiuetineternum.adextremumpascit.	pane : uiuet in eternum . ad extremum pascit .
eternasuediuinitatisuisione.undebeatus.gregoriusait	eterna sue diuinitatis uisione . unde beatus . gregorius ait
pascuaelectorumsunt:uultus	pascua e lectorum sunt : uultus
presensdei.quidum	presens dei . qui dum
sinedefectuconspicitursinefinemenscibouitefaciatur.	sine defectu conspicitur sine fine mens cibo uite faciatur .
sequitur.etproouibusmeisponoanimam	sequitur . et pro ouibus meis pono animam
meam.Eccediuinebonitatiseffectusinenarrabilis.maioremenim	meam . Ecce diuine bonitatis effectus inenarrabilis . maiorem enim
caritatemnemohabet:	caritatem nemo habet :
quamutanimam	quam ut animam
suamponatquisproamicis	suam ponat quis pro amicis
suis.christusuerolargiorecaritatishabundantia.	suis . christus uero largiore caritatis habundantia .
etiamproinimicis.crucissuppliciumpertulit:etin	etiam pro inimicis . crucis supplicium pertulit : et in
talimortisimperiumdestruens.serpentemcallidum	tali mortis imperium destruens . serpentem callidum
quiineoescamcorporisappetiit.aculeodiuinitatis	qui in eo escam corporis appetiit . aculeo diuinitatis
suetransfixit.tres	sue transfixit . tres
autemrationabilescausaspossumusassignare.	autem rationabiles causas possumus assignare .
quareredemptor	quare redemptor
nosterprosalutehumani	noster pro salute humani
generis.calicemgustaueritpassionis:cumtamentestante	generis . calicem gustauerit passionis : cum tamen testante
scriptura.aliusmodusredemptionisnostre.	scriptura . alius modus redemptionis nostre .
eiutpote	ei ut pote
omnipotenti:fueritpossibilis.primacausafuit.hu	omnipotenti : fuerit possibilis . prima causa fuit . hu
humanigenerismiseria:	humani generis miseria :
dequaminpsalmodicitur.proptermiseriaminopum	de quam in psalmo dicitur . propter miseriam in opum
.etgemitumpauperum:necexurgam.idestmanifestabor	. et gemitum pauperum : nec exurgam . idest manifestabor
.dicitdominus.ponaminsalutari	. dicit dominus . ponam in salutari
.hocestinchristo.	. hoc est in christo .
salutemgenerishumani:etfiducialiteragamin	salutem generis humani : et fiducialiter agam in
eo.secundacausafuit	eo . secunda causa fuit
.filialisquampatriexhibuitobedentia:de	. filialis quam patri exhibuit obedentia : de
quadicitapostolus.christusfratresestobediensdeopatri	qua dicit apostolus . christus fratres est obediens deo patri
usqueadmortem:mortem	usque ad mortem : mortem
autemcrucis.Etipsefiliusad	autem crucis . Et ipse filius ad
patrem.clarificauiteinquitsuperterram:	patrem . clarificaui te inquit super terram :
opusconsummaui:quoddedistimihiutfaciam.tercia	opus consummaui : quod dedisti mihi ut faciam . tercia
causafuit:singularisdehosteuictoria.consonumenim	causa fuit : singularis de hoste uictoria . consonum enim
eratequitatidiuine	erat equitati diuine
.etsuperne	. et superne
dispositioni:utsapientiaqueattingit	dispositioni : ut sapientia que attingit
afineusqueadfinem	a fine usque ad finem
fortiter.etdisponitomniasuauiter.hostisantiquimalitiam	fortiter . et disponit omnia suauiter . hostis antiqui malitiam
.nonpotentia.sediustitia	. non potentia . sed iustitia
deuinceret.etomninoconueniensfuit.ut	deuinceret . et omnino conueniens fuit . ut
quiinlignouicerat:inlignoquoque	qui in ligno uicerat : in ligno quoque
iuctus.etinlaqeumquem	iuctus . et in laqeum quem
paraueratprecipitatus:instrumentosue	parauerat precipitatus : instrumento sue
fraudisinteriret	fraudis interiret
.nequeenimlexequiorulla.quamnecis	. neque enim lex equior ulla . quam necis
artificemarteperiresua.	artificem arte perire sua .
insuper	in super
nosinconflictutemptationum	nos in conflictu temptationum
positos.dominus	positos . dominus
suauictoriaad	sua uictoria ad
iuncendumroborauit:utexemplo	iuncendum roborauit : ut exemplo
ipsius.patientiamin	ipsius . patientiam in
tribulationibusamplectentes.cumprobatifuerimus.	tribulationibus amplectentes . cum probati fuerimus .
coronamuiteprecipiamus	coronam uite precipiamus
.nuncitaquequi	. nunc itaque qui
cumquepastorestanimarum.uideatut	cumque pastor est animarum . uideat ut
faciatomniaiuxtaexemplar	faciat omnia iuxta exemplar
.quodeiin	. quod ei in
montemonstratumest.uideatinquamnesitmercennarius.	monte monstratum est . uideat inquam ne sit mercennarius .
quilupouenientedimittitoues	qui lupo ueniente dimittit oues
etfugit:sedueripastorisfungensofficio	et fugit : sed ueri pastoris fungens officio
.curamdebitam	. curam debitam
susceptisinpendatouibus.	susceptis inpendat ouibus .
